You awake. You are lonely, so lonely. It was a thousand days ago today. All alone these thousand days. Your parents were the last. No, your father was the last. He held on for nearly a hundred days longer. Now you are the last. Alone. Adrift.

But maybe it isn't hopeless. There must still be other people in other worlds, and you think you know how to get there.

Today is the day.

Founder's Mercy
A Space Story by Thomas Insel
Release 1 / Serial number 181218 / Inform 7 build 6M62 (I6/v6.33 lib 6/12N) SD
Type ABOUT for credits or HINT for assistance.

Home (on the blanket)
The room where you've slept your entire life. The crops are outside.

There is a secured hatch in the floor.

>* walkthrough
(Noted.)

* * *

>get mask
Taken.

>u
Home
The room where you've slept your entire life. The crops are outside.

There is an open hatch in the floor.

The homespun blanket which you use as your bed is arranged on the ground.

>get blanket
Taken.

* * *

>close ceiling hatch
You close the ceiling hatch.

>port
(first opening the bulkhead door)

Pod Bay
There are four berths for transit pods. Unfortunately, all are empty.

An open door leads starboard.

There is a pile of clutter. It looks like equipment removed to free up space in the transit pods.

This is troubling. You counted. You were sure there would be one pod left. There are none.

[Your score has just gone up by one point.]

>get communications unit
Taken.

* * *

>starboard
Pod Control
This room serves as an airlock for the pod bay, and holds an old space suit and various machinery such as the atmosphere pump. There is a brass plate on the wall.

Beside the open port door, a status display glows green.

There is a secured hatch in the ceiling.

>get functional power module
(putting the emergency mask into your pocket to make room)
Taken.

No pods left ... you consider despair.

>close door
You close the bulkhead door.

* * *

>push lever
You push the hoe and the lever moves. After a moment, you feel air rush into the room.

The audio unit beeps and a synthesized voice says "Comms ready."

After a moment, it says "Launching automatic routines."

[Your score has just gone up by one point.]

>z
"We can have a pod there in about a thousand minutes."

    *** You are not alone. ***

In that game you scored 10 out of a possible 10, in 72 turns.

Would you like to RESTART, RESTORE a saved game, QUIT, UNDO the last command, or read the CREDITS?

* * *

>port
(first opening the bulkhead door)

Pod Bay
There are four berths for transit pods. Unfortunately, all are empty.

An open door leads starboard.

There is a pile of clutter. It looks like equipment removed to free up space in the transit pods.

This is troubling. You counted. You were sure there would be one pod left. There are none.

[Your score has just gone up by one point.]

>help
Your objective is simply to leave the station and find other people.

Find something you can use to communicate to the outside world.

By the way, it should be impossible to put this story into an unwinnable state, so feel free to explore and experiment.

If you are having trouble getting started, I suggest reading A Beginner's Guide to Interactive Fiction by Stephen Granade and Emily Short, available at:

  https://brasslantern.org/players/howto/beginnersguide.html

[You can type "hint" any time for contextual assistance. If you prefer not to be tempted, you can type HINTS OFF to disable hints.]

>help
Find something you can use to communicate to the outside world.

>get comms
Taken.

>help
You'll need to connect the communications unit to a working audio input/output.

>s
Pod Control
This room serves as an airlock for the pod bay, and holds an old space suit and various machinery such as the atmosphere pump. There is a brass plate on the wall.

Beside the open port door, a status display glows green.

There is a secured hatch in the ceiling.

>get functional power
(putting the emergency mask into your pocket to make room)
Taken.

No pods left ... you consider despair.

>close door
You close the bulkhead door.

* * *

>unplug cable from organ
You unplug the gray cable from the organ.

>plug cable into comms
You plug the gray cable into the emergency communications unit.

>get power from audio
(putting the faulty power module into your pocket to make room)
Taken.

>drop it
Dropped.

>put functional power into audio
You put the functional power module into the audio unit.

The audio unit beeps and a synthesized voice says "Comms unit connected."

>help
You'll need to connect the communications unit to a working antenna.

>i
You are carrying:
  an emergency communications unit
  a faulty pressure regulation module
  a hoe
  a pair of gravity boots (being worn)
  your blanket (being worn)
  a green jumpsuit (being worn)

Your jumpsuit pocket contains:
  a faulty power module
  an emergency mask
  a dusty eraser
  an unscanned instruction module
  a scanner

>look
Church
Before everyone left or died, you celebrated every sabbath here. The altar stands against one wall, and an organ and a portable audio unit stand against the other.

On the altar is The Founder's Testament.

A gray cable connects the organ to the audio unit.

You can also see an unscanned power module here.

>out
The gray cable pulls out of the emergency communications unit.

Sector 3: Forest
Trees, a house, and a church. A red pylon stretches up from the ground to the hub of the station. You can walk spinward or antispinward.

>asw
You walk a little ways to the next sector.

Sector 2: Aquaculture
A deep pond with some fish. You can walk spinward or antispinward.

>asw
You walk a little ways to the next sector.

Sector 1: Crops
You still maintain the crops here. There is a small graveyard and the barn remains from when this was the livestock sector. A pylon stretches up from the ground to the hub of the station. You can walk spinward or antispinward.

There is an open hatch in the ground.

>asw
You walk a little ways to the next sector.

Sector 6: Hydroponics
Your people preferred to grow things the old fashioned way, but in truth the majority of your fruit and vegetables came from this sector when the machines still worked. You can walk spinward or antispinward.

There is an open hatch in the ground.

>asw
You walk a little ways to the next sector.

Sector 5: Forest
The school house is nestled among the trees. A pylon stretches up from the same grove to the hub of the station. You can walk spinward or antispinward.

* * *

>asw
You walk a little ways to the next sector.

Sector 3: Forest
Trees, a house, and a church. A red pylon stretches up from the ground to the hub of the station. You can walk spinward or antispinward.

>u
Wearing the boots, you are able to climb up the pylon. As you get closer to the hub, gravity decreases, and the climb becomes easier.

Platform 3
A platform about two thirds of the way towards the hub. You can continue spinward or antispinward.

There is a red circuit breaker here.

* * *

>asw
Platform 1
A platform about two thirds of the way towards the hub. You can continue spinward or antispinward, or go up a ladder into the hub.

>u
Gravity fades as you climb.

Inside the Hub
You float weightless in the middle of a cylinder. It is colder up here, and the light is all artifical but without an obvious source. A ladder rotates around you, leading up or down or maybe out, and an airlock is to the port.

>p
(first opening the starboard airlock door)

Airlock
There are port and starboard doors and a red button.

>push red
You know from your safety training not to press the button without a backup oxygen source.

>wear mask
(first taking the emergency mask)
You put on the emergency mask.

>push red
The starboard door slams shut. You feel the air rush out of the airlock.

>p
(first opening the port airlock door)
You crawl through a narrow accessway.

Antenna Control
You float weightless at the port end of a cylinder. Through a surprisingly large window, you can see the station rotating around you, solar panels, and antennas, all backed by a spectacular field of stars.  A short lever extends from the floor, and a yellow cable waves from a small control panel.

It is very cold and dark here in the near vacuum. An airlock door leads starboard.

[Your score has just gone up by two points.]

>connect yellow to comms
You plug the yellow cable into the emergency communications unit.

>push 3
Calibrate to Delta/Plum.

>help
You'll need to connect the communications unit to a working audio input/output.

>x comms
A bulky but portable emergency communications unit from a transit pod. It can work independently if you provide audio and antenna connections.

The emergency communications unit has a yellow cable plugged into it.

>purloin audio
[Purloined.]

>purloin gray
[Purloined.]

>plug gray into comms
You plug the gray cable into the emergency communications unit.

>hint
You'll need to connect the communications unit to a working antenna.

>push 8
Calibrate to Gamma/Banana.

>push 5
Calibrate to Beta/Cherry.

>push 2
Calibration successful.

The audio unit vibrates, but in the vacuum, you can't hear what it is saying.

>hint
You can't hear in a vacuum.

>put hoe into lever
You slide the hoe into the hollow lever, forming a longer lever.

The audio unit vibrates, but in the vacuum, you can't hear what it is saying.

>put hoe into pipe
You can't see any such thing.

>put hoe into lever
(first taking the hoe)
You slide the hoe into the hollow lever, forming a longer lever.

The audio unit vibrates, but in the vacuum, you can't hear what it is saying.

>pull lever
The lever is already pulled as far as it goes.

The audio unit vibrates, but in the vacuum, you can't hear what it is saying.

>push lever
You push the hoe and the lever moves. After a moment, you feel air rush into the room.

The audio unit beeps and a synthesized voice says "Comms ready."

After a moment, it says "Launching automatic routines."

[Your score has just gone up by two points.]

>help
Just wait.

>undo
Antenna Control
[Previous turn undone.]

>undo
Antenna Control
[Previous turn undone.]

>help
You can't hear in a vacuum.

>push lever
You push the hoe and the lever moves. After a moment, you feel air rush into the room.

The audio unit beeps and a synthesized voice says "Comms ready."

After a moment, it says "Launching automatic routines."

[Your score has just gone up by two points.]

>z
Time passes.

You hear a human speaking from the audio unit: "RWSS Founder's Mercy, this is OV-2644, over...

"There's really somebody there? We thought your station had been abandoned for kilodays...

"Standby...

"We can have a pod there in about a thousand minutes."

    *** You are not alone. ***

In that game you scored 10 out of a possible 10, in 85 turns.

Would you like to RESTART, RESTORE a saved game, QUIT, UNDO the last command, or read the CREDITS?

* * *

>turn breaker on
You reach out and switch the circuit breaker on.

[Your score has just gone up by one point.]

>u
The exits are down to sector 3, spinward to platform 5, and antispinward to platform 1.

>sw
Platform 5
A mesh platform about two thirds of the way towards the hub. You can continue spinward or antispinward.

>u
The exits are down to sector 5, spinward to platform 1, and antispinward to platform 3.

>sw
Platform 1
A mesh platform about two thirds of the way towards the hub. You can continue spinward or antispinward, or go up a ladder into the hub.

>u
Gravity fades as you climb.

Inside the Hub
You float weightless in the middle of a cylinder. It is colder up here, and the light is all artifical but without an obvious source. A ladder rotates around you, leading up or down or maybe out, and an airlock is to the port.

>drop boots
(first taking the pair of gravity boots off)
You drop the pair of gravity boots and it float nearby.

>d
You feel unstable on the ladder without the gravity boots.

>l
Inside the Hub
You float weightless in the middle of a cylinder. It is colder up here, and the light is all artifical but without an obvious source. A ladder rotates around you, leading up or down or maybe out, and an airlock is to the port.

You can see a pair of gravity boots floating here.

>in
The airlock is colder still, too cold for you in only your jumpsuit.

>l
Inside the Hub
You float weightless in the middle of a cylinder. It is colder up here, and the light is all artifical but without an obvious source. A ladder rotates around you, leading up or down or maybe out, and an airlock is to the port.

You can see a pair of gravity boots floating here.

>out
You feel unstable on the ladder without the gravity boots.

>l
Inside the Hub
You float weightless in the middle of a cylinder. It is colder up here, and the light is all artifical but without an obvious source. A ladder rotates around you, leading up or down or maybe out, and an airlock is to the port.

You can see a pair of gravity boots floating here.

>wear mask
You're already wearing that!

>in
The airlock is colder still, too cold for you in only your jumpsuit.

>wear blanket
You put on the blanket.

>in
(first opening the starboard airlock door)

Airlock
There are port and starboard doors and a red button.

>push button
The starboard door slams shut. You feel the air rush out of the airlock.

>in
(first opening the port airlock door)
You crawl through a narrow accessway.

Antenna Control
You float weightless at the port end of a cylinder. It is very cold and dark here in the near vacuum. A door leads starboard.

A short lever extends from the floor.

A yellow cable waves from a small panel.

[Your score has just gone up by two points.]

>exits
The only exit is starboard to the airlock.

>gonear church
(Church)
Church
Before everyone left or died, you celebrated every sabbath here. The altar stands against one wall, and an organ and a portable audio unit stand against the other.

On the altar is The Founder's Testament.

A gray cable connects the organ to the audio unit.

* * *

>out
Sector 3: Forest
Trees, a house, and a church. A red pylon stretches up from the ground to the hub of the station. You can walk spinward or antispinward.

>exits
The exits are up to platform 3, starboard to the house, port to the church, spinward to sector 4, and antispinward to sector 2.

* * *

>about
About Founder's Mercy
This is my second released Inform project, conceived and implemented in the last months of 2018.

Thanks to Graham Nelson, Andrew Plotkin, Emily Short, and everyone else who contributed to the Inform and Glulx ecosystem. Thanks also Juhana Leinonen for the Object Response Tests extension, Erik Temple for the Real-Time Delays extension, and Sean Turner for the Plugs and Sockets extension. Exit listing code is inspired by Eric Eve's Exit Lister. Keypad code is inspired by Emily Short's Computers.

The cover art is adapted from Figure 1.1 from NASA SP-413, Space Settlements: A Design Study, edited by Richard D. Johnson and Charles Holbrow, and available from The Internet Archive at https://archive.org/details/SpaceSettlementsADesignStudy1977 .

Please send your feedback, bug reports, and requests for help to tinsel@tinsel.org. You can always find the current version of this story at http://tinsel.org/IF/ .

This work is Copyright © 2019 Thomas Insel but may be freely shared according to the terms of the Creative Commons Attribution 4.0 International license (https://creativecommons.org/licenses/by/4.0/).

>gonear red
(the red circuit breaker)
Platform 3
A platform about two thirds of the way towards the hub. You can continue spinward or antispinward.

You feel much lighter here, and you are very aware of how the station rotates, but everything is okay as long as you don't look down.

There is a red circuit breaker here.

>port
The exits are down to sector 3, spinward to platform 5, and antispinward to platform 1.

>gonear red handle
Airlock
The airlock is also a cylinder, with a closed door to the port, a closed door to the starboard, and a red handle in the wall. It is very cold here.

>port
(first opening the port airlock door)
It seems to be locked.

>unlock port airlock door
What do you want to unlock the port airlock door with?

>damn
You can't see any such thing.

>damn
That's not a verb I recognize.

>damn
That's not a verb I recognize.

>fuck
That's not a verb I recognize.

>bother
That's not a verb I recognize.

>sorry
That's not a verb I recognize.

* * *

>look
Home (on the blanket)
The room where you've slept your entire life. The crops are outside.

There is a secured hatch in the floor.

* * *

>clap eraser
I didn't understand that sentence.

>clap me
I didn't understand that sentence.

>gonear jdslfajdlfk
There seems to be no such object anywhere in the model world.

>jjkj jjkj
That's not a verb I recognize.

>clap jkjkj
I didn't understand that sentence.

* * *

>clap me
That's not a verb I recognize.

>clap
You can't see any such thing.

>clapsdsfd
That's not a verb I recognize.

* * *

>clap me
That's not a verb I recognize.

>hatch
That's not a verb I recognize.

>erase me
That noun did not make sense in this context.

>erase hatch
You can't see any such thing.

>x hatch
The floor hatch is closed.

>erase blanket
You can't see any such thing.

>actions
Actions listing on.

>erase blanket
You can't see any such thing.

* * *

>count me
That's not a verb I recognize.

>gonear pond
Sector 2: Aquaculture
A deep pond with some fish. You can walk spinward or antispinward.

>i
You are carrying:
  a scanner
  a green jumpsuit (being worn)

>put scanner in pond
That can't contain things.

>put me in pond
(first taking yourself)
You are always self-possessed.

* * *

>d
(first getting off the blanket)
(first opening the floor hatch)

Cellar
Your decompression shelter and storage space for increasingly empty shelves of canned vegetables and one more large bag of split peas.

There is an open hatch in the ceiling.

>get jar
You take a jar of pickled okra.

>x jar
(the jar of pickled okra)
You see nothing special about the jar of pickled okra.

>rtree
Airlock
    red button
Antenna Control
    window
    station
    lever
    calibration panel & RF socket, display, and keypad
    yellow cable & RF plug and RF plug
Barn
    plow
    hoe
Cellar
    yourself + green jumpsuit, jar of pickled okra, pocket, and scanner 
    shelves + canned vegetables and emergency mask 
    large bag of split peas
Church
    altar + Founder's Testament 
    organ & tan socket
    audio unit + power module & beige socket
    gray cable & USB plug and USB plug
Home
    blanket
House
    doll
Inside the Hub
Platform 1
Platform 3
    red circuit breaker
Platform 5
    pigeon droppings
    flock of pigeons
Pod Bay
    berths
    pile of clutter + RF socket, almond socket, atmosphere sensor, emergency communications unit, and unremarkable junk 
Pod Control
    space suit
    brass plate
    status display
    atmosphere pump + power module and pressure regulation module 
School House
    learning machine + instruction module and power module 
    desk + clean eraser 
    chalkboard
Sector 1: Crops
    crops
    graveyard
    pylon
Sector 2: Aquaculture
    pond
    fish
Sector 3: Forest
    pylon
    trees
Sector 4: Crops
    vegetables
Sector 5: Forest
    pylon
    trees
Sector 6: Hydroponics
    hydroponics machines
Supply Vault
    crate of machine parts
    pair of gravity boots
(Nowhere)
    green valve
    handful of split peas
    instruction module
    junk repository
    laser beam
    pressure regulation module

>restart
Are you sure you want to restart?

>yes
You awake. You are lonely, so lonely. It was a thousand days ago today. All alone these thousand days. Your parents were the last. No, your father was the last. He held on for nearly a hundred days longer. Now you are the last. Alone. Adrift.

But maybe it isn't hopeless. There must still be other people in other worlds, and you think you know how to get there.

Today is the day.

Founder's Mercy
A Space Story by Thomas Insel
Release 1 / Serial number 181215 / Inform 7 build 6M62 (I6/v6.33 lib 6/12N) SD
Type ABOUT for credits or HINT for assistance.

Home (on the blanket)
The room where you've slept your entire life. The crops are outside.

There is a secured hatch in the floor.

>rtree
Airlock
    red button
Antenna Control
    window
    station
    lever
    calibration panel & RF socket, display, and keypad
    yellow cable & RF plug and RF plug
Barn
    plow
    hoe
Cellar
    shelves + canned vegetables and emergency mask 
    large bag of split peas
Church
    altar + Founder's Testament 
    organ & tan socket
    audio unit + power module & beige socket
    gray cable & USB plug and USB plug
Home
    blanket + green jumpsuit, pocket, scanner, and yourself 
House
    doll
Inside the Hub
Platform 1
Platform 3
    red circuit breaker
Platform 5
    pigeon droppings
    flock of pigeons
Pod Bay
    berths
    pile of clutter + RF socket, almond socket, atmosphere sensor, emergency communications unit, and unremarkable junk 
Pod Control
    space suit
    brass plate
    status display
    atmosphere pump + power module and pressure regulation module 
School House
    learning machine + instruction module and power module 
    desk + clean eraser 
    chalkboard
Sector 1: Crops
    crops
    graveyard
    pylon
Sector 2: Aquaculture
    pond
    fish
Sector 3: Forest
    pylon
    trees
Sector 4: Crops
    vegetables
Sector 5: Forest
    pylon
    trees
Sector 6: Hydroponics
    hydroponics machines
Supply Vault
    crate of machine parts
    pair of gravity boots
(Nowhere)
    green valve
    handful of split peas
    instruction module
    jar of pickled okra
    junk repository
    laser beam
    pressure regulation module

* * *

>d
(first getting off the blanket)
(first opening the floor hatch)

Cellar
Your decompression shelter and storage space for increasingly empty shelves of canned vegetables and one more large bag of split peas.

There is an open hatch in the ceiling.

>get peas
You take a handful of split peas.

>g
(the handful of split peas)
You already have that.

>get bag of peas
You aren't hungry, and you have already taken a handful.

>i
You are carrying:
  a handful of split peas
  a scanner
  a green jumpsuit (being worn)

* * *

>d
(first getting off the blanket)
(first opening the floor hatch)

Cellar
Your decompression shelter and storage space for increasingly empty shelves of canned vegetables and one more large bag of split peas.

There is an open hatch in the ceiling.

>take okra
You take a jar of okra.

>i
You are carrying:
  a jar of okra
  a scanner
  a green jumpsuit (being worn)

>take vegetables
That's not where your attention belongs just now.

>x vegetables
Mostly tomatoes, green beans, carrots, and okra. Without a new source of salt or acid, too much of your recent harvest has been left to spoil.

>take canned vegetables
That's not where your attention belongs just now.

* * *

>d
(first getting off the blanket)
(first opening the floor hatch)

Cellar
Your decompression shelter and storage space for increasingly empty shelves of canned vegetables and one more large bag of split peas.

There is an open hatch in the ceiling.

>take vegetables
You take a jar of okra.

>g
You aren't hungry, and you've already taken one jar.

>x jar
(the jar of okra)
You see nothing special about the jar of okra.

>eat jar
(the jar of okra)
That's plainly inedible.

>open jar
(the jar of okra)
It isn't something you can open.

* * *

>d
(first getting off the blanket)
(first opening the floor hatch)

Cellar
Your decompression shelter and storage space for increasingly empty shelves of canned vegetables and one more large bag of split peas.

There is an open hatch in the ceiling.

>x okra
Mostly tomatoes, green beans, carrots, and okra. Without a new source of salt or acid, too much of your recent harvest has been left to spoil.

>get okra
You take a jar of okra.

>eat okra
(the jar of okra)
You aren't hungry.

>eat jar
(the jar of okra)
You aren't hungry.

>open jar
(the jar of okra)
You aren't hungry.

* * *

>dig
That's not a verb I recognize.

>x floor
The floor hatch is closed.

>x ground
You see nothing unexpected in that direction.

>look
Home (on the blanket)
The room where you've slept your entire life. The crops are outside.

There is a secured hatch in the floor.

>out
You get off the blanket.

Home
The room where you've slept your entire life. The crops are outside.

There is a secured hatch in the floor.

The homespun blanket which you use as your bed is arranged on the ground.

>x ground
You see nothing unexpected in that direction.

>x ceiling
You can't see any such thing.

>x up
You see nothing unexpected in that direction.

>in
The exits are down to the cellar and outside to sector 4.

>x ceiling
You can't see any such thing.

>look
Home
The room where you've slept your entire life. The crops are outside.

There is a secured hatch in the floor.

The homespun blanket which you use as your bed is arranged on the ground.

* * *

>erase ch
I didn't understand that sentence.

>erase chalkboard
I didn't understand that sentence.

>version
Founder's Mercy
A Space Story by Thomas Insel
Release 1 / Serial number 181216 / Inform 7 build 6M62 (I6/v6.33 lib 6/12N) SD
Type ABOUT for credits or HINT for assistance.
Identification number: //BCC61E7F-CE8E-4C25-9E9D-5550D1138D8C//
Interpreter version 0.5.2 / VM 3.1.2 / Library serial number 080126
Standard Rules version 3/120430 by Graham Nelson
Plugs and Sockets version 4/170924 by Sean Turner
Object Response Tests version 7 by Juhana Leinonen

>about
About Founder's Mercy
Founder's Mercy is my second released Inform project, conceived and implemented in the last months of 2018.

Thanks to Graham Nelson, Andrew Plotkin, Emily Short, and everyone else who contributed to the Inform and Glulx ecosystem. Thanks also Juhana Leinonen for the Object Response Tests extension, and Sean Turner for the Plugs and Sockets extension. Exit listing code is inspired by Eric Eve's Exit Lister. Keypad code is inspired by Emily Short's Computers.

The cover art is adapted from Figure 1.1 from NASA SP-413, Space Settlements: A Design Study, edited by Richard D. Johnson and Charles Holbrow, and available from The Internet Archive at https://archive.org/details/SpaceSettlementsADesignStudy1977 .

Please send your feedback, bug reports, and requests for help to tinsel@tinsel.org. You can always find the current version of this story at http://tinsel.org/IF/ .

This work is Copyright © 2019 Thomas Insel but may be freely shared according to the terms of the Creative Commons Attribution 4.0 International license (https://creativecommons.org/licenses/by/4.0/).

* * *

>feed
(yourself)
You aren't hungry.

>feed me
You aren't hungry.

>feed hatch
You can only do that to something animate.

>gonear pigeons
Platform 5
This plaform is home to a flock of pigeons. You can continue spinward or antispinward.

>feed pigeons
The flock of pigeons doesn't seem hungry.

>purloin peas
(the handful of split peas)
[Purloined.]

>put peas in pocket
You put the handful of split peas into the pocket.

>feed pigeons
The flock of pigeons doesn't seem hungry.

>feed peas to pigeons
(first taking the handful of split peas)
You scatter the split peas among the pigeons, causing a minor commotion as they peck at them.

* * *

>feed hatch
You can only do that to something animate.

>actins
That's not a verb I recognize.

>actions
Actions listing on.

>feed hatch
[feeding the floor hatch]
[feeding the floor hatch - succeeded]

* * *

>feed me
You aren't hungry.

>feed
(yourself)

* * *

>feed me
You aren't hungry.

>gonear pigeons
Platform 5
This plaform is home to a flock of pigeons. You can continue spinward or antispinward.

* * *

>gonear airlock
(the Airlock)
Airlock
The airlock is also a cylinder, with a closed door to the port, a closed door to the starboard, and a red handle in the wall. It is very cold here.

>in
(first opening the port airlock door)
It seems to be locked.

>purloin mask
[Purloined.]

* * *

>wear mask
You put on the emergency mask.

>turn handle
You turn the handle an entire rotation, and after a moment, you feel the air rush out of the airlock.

>in
(first opening the port airlock door)
You crawl through a narrow accessway.

Antenna Control
You float weightless at the port end of a cylinder. Through a surprisingly large window, you can see the station rotating around you, solar panels, and antennas, all backed by a spectacular field of stars.  A short lever extends from the floor, and a yellow cable waves from a small control panel.

It is very cold and dark here in the near vacuum. An airlock door leads starboard.

[Your score has just gone up by two points.]

>out
You make your way back along the narrow accessway.

Airlock
The airlock is also a cylinder, with an open door to the port, a closed door to the starboard, and a red handle in the wall.

>out
You crawl through a narrow accessway.

Antenna Control
You float weightless at the port end of a cylinder. Through a surprisingly large window, you can see the station rotating around you, solar panels, and antennas, all backed by a spectacular field of stars.  A short lever extends from the floor, and a yellow cable waves from a small control panel.

It is very cold and dark here in the near vacuum. An airlock door leads starboard.

>out
You make your way back along the narrow accessway.

Airlock
The airlock is also a cylinder, with an open door to the port, a closed door to the starboard, and a red handle in the floor.

>out
You crawl through a narrow accessway.

Antenna Control
You float weightless at the port end of a cylinder. Through a surprisingly large window, you can see the station rotating around you, solar panels, and antennas, all backed by a spectacular field of stars.  A short lever extends from the floor, and a yellow cable waves from a small control panel.

It is very cold and dark here in the near vacuum. An airlock door leads starboard.

>out
You make your way back along the narrow accessway.

Airlock
The airlock is also a cylinder, with an open door to the port, a closed door to the starboard, and a red handle in the wall.

>turn handle
The port door slams shut. You turn the handle an entire rotation, and after a moment, you feel the airlock pressurize.

>out
(first opening the starboard airlock door)

Inside the Hub
You float weightless in the middle of a cylinder. It is colder up here, and the light is all artifical but without an obvious source. A ladder rotates around you, leading up or down or maybe out, and an airlock is to the port.

>in
The airlock is colder still, too cold for you in only your jumpsuit.

>in
The airlock is colder still, too cold for you in only your jumpsuit.

>turn handle
You can't see any such thing.

>purloin blaket
There seems to be no such object anywhere in the model world.

* * *

>purloin blanket
[Purloined.]

>wear it
You put on the blanket.

>in
Airlock
The airlock is also a cylinder, with a closed door to the port, an open door to the starboard, and a red handle in the floor.

>x airlock
Which do you mean, the starboard airlock door or the port airlock door?

>look
Airlock
The airlock is also a cylinder, with a closed door to the port, an open door to the starboard, and a red handle in the ceiling.

>turn lever
You can't see any such thing.

>turn handle
The starboard door slams shut. You turn the handle an entire rotation, and after a moment, you feel the air rush out of the airlock.

>in
(first opening the port airlock door)
You crawl through a narrow accessway.

Antenna Control
You float weightless at the port end of a cylinder. Through a surprisingly large window, you can see the station rotating around you, solar panels, and antennas, all backed by a spectacular field of stars.  A short lever extends from the floor, and a yellow cable waves from a small control panel.

It is very cold and dark here in the near vacuum. An airlock door leads starboard.

>x window
You might be the first person to look out through this window in a generation. While you've seen the stars, the solar panels, and so on through transparent walls of the station, the view from here is different and definitely more impressive.

* * *

>gonear airlock
(the Airlock)
Airlock
The airlock is also a cylinder, with a closed door to the port, a closed door to the starboard, and a red handle in the wall. It is very cold here.

>out
x.

(first opening the starboard airlock door)

Inside the Hub
You float weightless in the middle of a cylinder. It is colder up here, and the light is all artifical but without an obvious source. A ladder rotates around you, leading up or down or maybe out, and an airlock is to the port.

>in
The airlock is colder still, too cold for you in only your jumpsuit.

* * *

>out
x.

(first opening the starboard airlock door)

Inside the Hub
You float weightless in the middle of a cylinder. It is colder up here, and the light is all artifical but without an obvious source. A ladder rotates around you, leading up or down or maybe out, and an airlock is to the port.

>showme airlock
(the Airlock)
Airlock - room
    starboard airlock door - closed door
    yourself - person
        scanner
        green jumpsuit (worn)
            pocket (part of green jumpsuit) - open container
    port airlock door - locked door
    red handle
singular-named, improper-named; lighted, visited, pressurized, frigid, unfamiliar
list grouping key: none
printed name: "Airlock"
printed plural name: none
indefinite article: none
description: "The airlock is also a cylinder, with a closed door to the port, a closed door to the starboard, and a red handle in the wall."
map region: Zero-G
destination name: none
match: Inside the Hub

* * *

>gonear airlock
(the Airlock)
Airlock
The airlock is also a cylinder, with a closed door to the port, a closed door to the starboard, and a red handle in the wall. It is very cold here.

>purloin msk
There seems to be no such object anywhere in the model world.

>wear mask
You can't see any such thing.

>purloin mask
[Purloined.]

* * *

>turn handle
You turn the handle an entire rotation, and after a moment, you feel the air rush out of the airlock.

>look
Airlock
The airlock is also a cylinder, with a closed door to the port, a closed door to the starboard, and a red handle in the wall. It is very cold here and there is no air.

* * *

>gonear breaker
Platform 3
A platform about two thirds of the way towards the hub. You can continue spinward or antispinward.

You feel much lighter here, and you are very aware of how the station rotates, but everything is okay as long as you don't look down.

There is a red circuit breaker here.

>close off breaker
That's already off.

* * *

>gonear cable
Which do you mean, the yellow cable or the gray cable?

>gonear yellow
Antenna Control
You float weightless at the port end of a cylinder. It is very cold and dark here in the near vacuum. A door leads starboard.

A short lever extends from the floor.

A yellow cable waves from a small panel.
It is plugged into a calibration panel.

[Your score has just gone up by two points.]

* * *

>gonear calibration panel
Antenna Control
You float weightless at the port end of a cylinder. It is very cold and dark here in the near vacuum. A door leads starboard.

A short lever extends from the floor.

A yellow cable waves from a small panel.

[Your score has just gone up by two points.]

>x antenna
The solar panels are the primary source of station power and support a small array of antennas.

* * *

>gonear calibration panel
Antenna Control
You float weightless at the port end of a cylinder. It is very cold and dark here in the near vacuum. A door leads starboard.

A short lever extends from the floor.

A yellow cable waves from a small panel.

[Your score has just gone up by two points.]

>x panel
Which do you mean, the solar panels or the panel?

>x calibration panel
This is clearly the antenna calibration panel. It has a display, a keypad, and a yellow RF cable.

>x display
Calibrate to Epsilon/Lime.

[Now might be a good time to consult the Official Space Relay League™ Antenna Calibration Guide™, included in your game package.]

* * *

>gonear chalkboard
School House
A broken learning machine remains in a corner, but mostly the older farmers took turns leading the class. There is a desk, and a chalkboard hangs on one wall.

On the desk is a clean eraser.

>erase chalkboard
You smudge the writing around with your hand.

>get eraser
Taken.

>erase chalkboard
(with the eraser)
You carefully erase the chalkboard.

>i
You are carrying:
  a dusty eraser
  a scanner
  a green jumpsuit (being worn)

>undo
School House
[Previous turn undone.]

>undo
School House
[Previous turn undone.]

>i
You are carrying:
  a clean eraser
  a scanner
  a green jumpsuit (being worn)

>erase chalkboard
(with the eraser)
You carefully erase the chalkboard.

* * *

>gonear command
There seems to be no such object anywhere in the model world.

>gonear eraser
School House
A broken learning machine remains in a corner, but mostly the older farmers took turns leading the class. There is a desk, and a chalkboard hangs on one wall.

On the desk is a clean eraser.

>clean board
You smudge the writing around with your hand.

>gonear pigeons
Platform 5
This plaform is home to a flock of pigeons. You can continue spinward or antispinward.

>cut pigeons
The Founder said that violence is never the answer.

>taste me
You taste nothing unexpected.

>taste eraer
You can't see any such thing.

>taste eraser
You can't see any such thing.

>taste pigeons
You could probably catch a pigeon and take it home to prepare, cook, and eat, but that would take too much time and you aren't hungry.

* * *

>gonear comms
Pod Bay
There are four berths for transit pods. Unfortunately, all are empty.

A secured door leads starboard.

There is a pile of clutter. It looks like equipment removed to free up space in the transit pods.

This is troubling. You counted. You were sure there would be one pod left. There are none.

[Your score has just gone up by two points.]

>gonear yellow
Antenna Control
You float weightless at the port end of a cylinder. It is very cold and dark here in the near vacuum. A door leads starboard.

A short lever extends from the floor.

A yellow cable waves from a small panel.

[Your score has just gone up by two points.]

>purloin comms
[Purloined.]

>l
Antenna Control
You float weightless at the port end of a cylinder. It is very cold and dark here in the near vacuum. A door leads starboard.

A short lever extends from the floor.

A yellow cable waves from a small panel.

>plug yellow into comms
You plug the yellow cable into the emergency communications unit.

No pods left ... you consider despair.

>l
Antenna Control
You float weightless at the port end of a cylinder. It is very cold and dark here in the near vacuum. A door leads starboard.

A short lever extends from the floor.

A yellow cable is plugged into the calibration panel and an emergency communications unit.

>drop panel
The calibration panel is already here.

So what if you can't escape in a pod. You will just need to bring a pod here. Time to get the communications module working.

>get cable
Taken.

>s
The yellow cable is permanently attached to the panel, so you must drop it before leaving.

>drop cable
You drop the yellow cable and it floats nearby.

>s
The yellow cable pulls out of the emergency communications unit.

(first opening the port airlock door)
It seems to be locked.

>look
Antenna Control
You float weightless at the port end of a cylinder. It is very cold and dark here in the near vacuum. A door leads starboard.

A yellow cable waves from a small panel.

A short lever extends from the floor.

>look
Antenna Control
You float weightless at the port end of a cylinder. It is very cold and dark here in the near vacuum. A door leads starboard.

A yellow cable waves from a small panel.

A short lever extends from the floor.

>actions
Actions listing on.

>get cable
[taking the yellow cable]
Taken.
[taking the yellow cable - succeeded]

>drop cable
[dropping the yellow cable]
You drop the yellow cable and it floats nearby.
[dropping the yellow cable - succeeded]

* * *

>gonear eraser
School House
A broken learning machine remains in a corner, but mostly the older farmers took turns leading the class. There is a desk, and a chalkboard hangs on one wall.

On the desk is a clean eraser.

>clap eraser
(first taking the clean eraser)
Nothing happens.

>erase board
(with the eraser)
You carefully erase the chalkboard.

>clap eraser
You fill the area with a cloud of dust, which quickly clears.

>erase board
The chalkboard is already clean.

* * *

>gonear fish
Sector 2: Aquaculture
A deep pond with some fish. You can walk spinward or antispinward.

>feed fish
The fish aren't easy to catch.

>feed peas to fish
You can't see any such thing.

>gonear pigeons
Platform 5
This plaform is home to a flock of pigeons. You can continue spinward or antispinward.

>purloin peas
(the handful of split peas)
[Purloined.]

>feed peas to pigeons
You scatter the split peas among the pigeons, causing a minor commotion as they peck at them.

>gonear blanket
Home
The room where you've slept your entire life. The crops are outside.

There is a secured hatch in the floor.

The homespun blanket which you use as your bed is arranged on the ground.

>d
(first opening the floor hatch)

Cellar
Your decompression shelter and storage space for increasingly empty shelves of canned vegetables and one more large bag of split peas.

There is an open hatch in the ceiling.

>get peas
You take a handful of split peas.

>u
Home
The room where you've slept your entire life. The crops are outside.

There is an open hatch in the floor.

The homespun blanket which you use as your bed is arranged on the ground.

>d
Cellar
Your decompression shelter and storage space for increasingly empty shelves of canned vegetables and one more large bag of split peas.

There is an open hatch in the ceiling.

>get peas
(the handful of split peas)
You already have that.

>u
Home
The room where you've slept your entire life. The crops are outside.

There is an open hatch in the floor.

The homespun blanket which you use as your bed is arranged on the ground.

>gonear pigeons
Platform 5
This plaform is home to a flock of pigeons. You can continue spinward or antispinward.

>drop peas
You drop the handful of split peas and it scatters.

* * *

>gonear fish
Sector 2: Aquaculture
A deep pond with some fish. You can walk spinward or antispinward.

>feed scanner to fish
You aren't confident you would be able to retrieve the scanner.

>scan fish
No modular technology detected.

>feed fish
You have nothing to feed the fish.

>feed scanner to fish
You aren't confident you would be able to retrieve the scanner.

>purloin peas
(the handful of split peas)
[Purloined.]

>feed fish
You aren't sure if fish eat split peas, but you scatter the handful into the water, and they seem to react a little.

>x fish
There are still a few fish swimming in the pond, but they taste horrible.

>i
You are carrying:
  a scanner
  a green jumpsuit (being worn)

* * *

>gonear fish
Sector 2: Aquaculture
A deep pond with some fish. You can walk spinward or antispinward.

>purloin peas
(the handful of split peas)
[Purloined.]

>feed fish
The fish aren't easy to catch.

>feed peas to fish
The fish don't seem interested.

>push fish
The fish aren't easy to catch.

>smell fish
The fish aren't easy to catch.

>eat fish
The fish aren't easy to catch.

>taste fish
The fish aren't easy to catch.

>throw scanner at fish
You lack the nerve when it comes to the crucial moment.

* * *

>gonear fish
Sector 2: Aquaculture
A deep pond with some fish. You can walk spinward or antispinward.

>throw scanner at fish
You aren't confident you would be able to retrieve the scanner.

>give scanner to fish
The fish don't seem interested.

>give scanner to pond
You can only do that to something animate.

>wear fish
(first taking the fish)
The fish aren't easy to catch.

>eat fish
The fish aren't easy to catch.

* * *

>give scanner to fish
The fish don't seem interested.

>show fe
You can't see any such thing.

>drop fish
The fish aren't easy to catch.

* * *

>gonear handle
Airlock
The airlock is also a cylinder, with a closed to the port, a closed to the starboard, and a red handle in the wall.

>l
Airlock
The airlock is also a cylinder, with a closed to the port, a closed to the starboard, and a red handle in the wall.

>l
Airlock
The airlock is also a cylinder, with a closed to the port, a closed to the starboard, and a red handle in the floor.

>l
Airlock
The airlock is also a cylinder, with a closed to the port, a closed to the starboard, and a red handle in the wall.

* * *

>l
Airlock
The airlock is also a cylinder, with a closed to the port, a closed to the starboard, and a red handle in the floor.

>l
Airlock
The airlock is also a cylinder, with a closed to the port, a closed to the starboard, and a red handle in the ceiling.

>l
Airlock
The airlock is also a cylinder, with a closed to the port, a closed to the starboard, and a red handle in the ceiling.

>l
Airlock
The airlock is also a cylinder, with a closed to the port, a closed to the starboard, and a red handle in the wall.

* * *

>gonear handle
Airlock
The airlock is also a cylinder, with a closed to the port, a closed to the starboard, and a red handle in the wall.

>turn handle
You know from your safety training not to turn the handle without a backup oxygen source.

* * *

>gonear hatch
Home
The room where you've slept your entire life. The crops are outside.

There is a secured hatch in the floor.

The homespun blanket which you use as your bed is arranged on the ground.

>gonear yellow
Antenna Control
You float weightless at the port end of a cylinder. Through a surprisingly large window, you can see the station rotating around you, solar panels, and antennas, all backed by a spectacular field of stars.  A short lever extends from the floor, and a yellow cable waves from a small control panel.

It is very cold and dark here in the near vacuum. An airlock door leads starboard.

[Your score has just gone up by two points.]

>x airlock
You see nothing special about the port airlock door.

>x lever
A short length of hollow steel pipe pulled out from the wall.

>pull lever
The lever is already pulled as far as it goes.

>purloin hoe
[Purloined.]

>x lever
A short length of hollow steel pipe pulled out from the wall.

>put hoe in lever
You slide the hoe into the hollow lever, forming a longer lever.

>look
Antenna Control
You float weightless at the port end of a cylinder. Through a surprisingly large window, you can see the station rotating around you, solar panels, and antennas, all backed by a spectacular field of stars.  Your hoe extends the short lever in the floor, and a yellow cable waves from a small control panel.

It is very cold and dark here in the near vacuum. An airlock door leads starboard.

* * *

>gonear yellow
Antenna Control
You float weightless at the port end of a cylinder. Through a surprisingly large window, you can see the station rotating around you, solar panels, and antennas, all backed by a spectacular field of stars.  A short lever extends from the floor, and a yellow cable waves from a small control panel.

It is very cold and dark here in the near vacuum. An airlock door leads starboard.

[Your score has just gone up by two points.]

>x station
Backed by a field of stars, you can see the wheel of the station rotating around you to the starboard — you didn't notice before but the airlock must be some sort of rotation coupling.

>x stars
The stars seem brighter up here.

>showme
Antenna Control - room
    antennas - backdrop
    port airlock door - locked door
    stars - backdrop
    solar panels - backdrop
    yourself - person
        scanner
        green jumpsuit (worn)
            pocket (part of green jumpsuit) - open container
    window
    station
    lever - open container
    calibration panel - machine
        RF socket (part of calibration panel) - RF socket
        display (part of calibration panel)
        keypad (part of calibration panel)
    yellow cable - cable
        RF plug (part of yellow cable) - RF plug
        RF plug (part of yellow cable) - RF plug

>x solar
The solar panels are the primary source of station power and support a small array of antennas.

>touch slar
You can't see any such thing.

>touch solar
There is a window in the way.

>touch antenna
There is a window in the way.

>get antenna
There is a window in the way.

>x antenna
You can see the antennas clearly from here: small telemetry antennas and the main communications dish. The dish lists, aiming at nothing in particular.

>x dish
You can see the antennas clearly from here: small telemetry antennas and the main communications dish. The dish lists, aiming at nothing in particular.

>x display
Calibrate to Epsilon/Lime.

[Now might be a good time to consult the Official Space Relay League Antenna Calibration Guide™, included in your game package.]

>gonear pigeons
Platform 5
This plaform is home to a flock of pigeons. You can continue spinward or antispinward.

* * *

>feed peas to pigeons
You scatter the split peas among the pigeons, causing a minor commotion as they peck at them.

>kiss pigeons
The flock of pigeons might not like that.

>kiss pylon
You can only do that to something animate.

* * *

>gonear inside the hub
Inside the Hub
This is your first time in this part of the station or even out of artificial gravity. You float weightless in the middle of a cylinder. It is cold up here, and the light is all artificial and without an obvious source. A ladder rotates around you, leading up or down or maybe out, and the airlock is to the port.

>port
The airlock is colder still, too cold for you in only your jumpsuit.

* * *

>gonear ladder
Platform 1
A platform about two thirds of the way towards the hub. You can continue spinward or antispinward, or go up a ladder into the hub.

>actions
Actions listing on.

>u
[going up]
Gravity fades as you climb.

Inside the Hub
You float weightless in the middle of a cylinder. It is colder up here, and the light is all artifical but without an obvious source. A ladder rotates around you, leading up or down or maybe out, and an airlock is to the port.

[going up - succeeded]

* * *

>gonear ladder
Platform 1
A platform about two thirds of the way towards the hub. You can continue spinward or antispinward, or go up a ladder into the hub.

>asw
Platform 5
This plaform is home to a flock of pigeons. You can continue spinward or antispinward.

>x pigeons
Descendents of the flock your grandparents brought here for food.

>smell
There are a lot of pigeons, so not great, but you've smelled worse.

>listen
Quiet cooing.

>i
You are carrying:
  a scanner
  a green jumpsuit (being worn)

* * *

>gonear ladder
Platform 1
A platform about two thirds of the way towards the hub. You can continue spinward or antispinward, or go up a ladder into the hub.

>u
You feel unstable on the ladder without the gravity boots.

>purloin boots
[Purloined.]

>u
You feel unstable on the ladder without the gravity boots.

>wear boots
You put on the pair of gravity boots.

>u
Gravity fades as you climb.

Inside the Hub
This is your first time in this part of the station, and your first time out of artificial gravity. You float weightless in the middle of a cylinder. It is colder up here, and the light is all artifical but without an obvious source. A ladder rotates around you, leading up or down or maybe out, and the airlock is to the port.

>look
Inside the Hub
You float weightless in the middle of a cylinder. It is colder up here, and the light is all artifical but without an obvious source. A ladder rotates around you, leading up or down or maybe out, and the airlock is to the port.

* * *

>wear boots
You put on the pair of gravity boots.

>u
Gravity fades as you climb.

Inside the Hub
You float weightless in the middle of a cylinder. It is colder up here, and the light is all artifical but without an obvious source. A ladder rotates around you, leading up or down or maybe out, and an airlock is to the port.

>d
You make sure you are heading legs first and follow the ladder.

Platform 1
A mesh platform about two thirds of the way towards the hub. You can continue spinward or antispinward, or go up a ladder into the hub.

>u
Gravity fades as you climb.

Inside the Hub
You float weightless in the middle of a cylinder. It is colder up here, and the light is all artifical but without an obvious source. A ladder rotates around you, leading up or down or maybe out, and an airlock is to the port.

>drop boots
(first taking the pair of gravity boots off)
You drop the pair of gravity boots and it floats nearby.

>d
You don't feel comfortable on the ladder without the gravity boots.

>d
You don't feel comfortable on the ladder without the gravity boots.

* * *

>u
Gravity fades as you climb.

Inside the Hub
You float weightless in the middle of a cylinder. It is colder up here, and the light is all artifical but without an obvious source. A ladder rotates around you, leading up or down or maybe out, and an airlock is to the port.

>e
You have heard of compass directions like east, but they don't make any sense here. Instead, you can go spinward, antispinward, port, and starboard. When you look spinward, port is left and starboard is right.

[You can use the abbreviations SW, ASW, P, and S. You can also go UP, DOWN, IN, and OUT where appropriate. Type EXITS if you get confused about geography.]

>p
The airlock is colder still, too cold for you in only your jumpsuit.

>purloin blanket
[Purloined.]

* * *

>wear blanket
You put on the blanket.

>p
(first opening the starboard airlock door)

Airlock
There are port and starboard doors and a red button.

>push button
You know from your safety training not to press the button without a backup oxygen source.

>drop boots
(first taking the pair of gravity boots off)
You drop the pair of gravity boots and it floats nearby.

>look
Airlock
There are port and starboard doors and a red button.

You can see a pair of gravity boots floating here.

>s
Inside the Hub
You float weightless in the middle of a cylinder. It is colder up here, and the light is all artifical but without an obvious source. A ladder rotates around you, leading up or down or maybe out, and an airlock is to the port.

>s
The exits are outside to platform 1 and port to the airlock.

>d
You don't feel comfortable on the ladder without the gravity boots.

* * *

>gonear ladder
Platform 1
A platform about two thirds of the way towards the hub. You can continue spinward or antispinward, or go up a ladder into the hub.

>x walls
The walls form the ends of the rotating cylinder that is the station, stretching from the ground to the hub. The top third is transparent, through which you can see solar panels, mirrors, and the stars.

>x stars
The sky is awash with stars.

* * *

>gonear lever
Antenna Control
You float weightless at the port end of a cylinder. It is very cold and dark here in the near vacuum. A door leads starboard.

A short lever extends from the floor.

A yellow cable waves from a small panel.

[Your score has just gone up by two points.]

>purloin comms
[Purloined.]

>x communications
(the emergency communications unit)
A bulky but portable emergency communications unit from a transit pod. It can work independently if you provide audio and antenna connections.

The emergency communications unit has nothing plugged into it.

>x communications dish
You can see the antennas clearly from here: small telemetry antennas and the main communications dish.

>x comms
A bulky but portable emergency communications unit from a transit pod. It can work independently if you provide audio and antenna connections.

The emergency communications unit has nothing plugged into it.

* * *

>gonear lever
Antenna Control
You float weightless at the port end of a cylinder. It is very cold and dark here in the near vacuum. A door leads starboard.

A short lever extends from the floor.

A yellow cable waves from a small panel.

[Your score has just gone up by two points.]

>x dish
You can see the antennas clearly from here: small telemetry antennas and the main communications dish. The dish appears to be tracking something.

* * *

>gonear lever
Antenna Control
You float weightless at the port end of a cylinder. It is very cold and dark here in the near vacuum. A door leads starboard.

A short lever extends from the floor.

A yellow cable waves from a small panel.

[Your score has just gone up by two points.]

>x disk
You can't see any such thing.

>x dish
You can see the antennas clearly from here: small telemetry antennas and the main communications dish. The dish lists, aiming at nothing in particular.

>type 3
Calibrate to Delta/Plum.

>type eight
Calibrate to Gamma/Banana.

>press 5
Calibrate to Beta/Cherry.

>enter 2
Calibration successful.

>x dish
You can see the antennas clearly from here: small telemetry antennas and the main communications dish. The dish appears to be tracking something.

>x display
Antenna calibrated.

>restart
Are you sure you want to restart?

>yes
You awake. You are lonely, so lonely. It was a thousand days ago today. All alone these thousand days. Your parents were the last. No, your father was the last. He held on for nearly a hundred days longer. Now you are the last. Alone. Adrift.

But maybe it isn't hopeless. There must still be other people in other worlds, and you think you know how to get there.

Today is the day.

The panel has no socket.

Founder's Mercy
A Space Story by Thomas Insel
Release 1 / Serial number 181213 / Inform 7 build 6M62 (I6/v6.33 lib 6/12N) SD
Type ABOUT for credits or HINT for assistance.

Home (on the blanket)
The room where you've slept your entire life. The crops are outside.

There is a secured hatch in the floor.

>gonear lever
Antenna Control
You float weightless at the port end of a cylinder. It is very cold and dark here in the near vacuum. A door leads starboard.

A short lever extends from the floor.

A yellow cable waves from a small panel.

[Your score has just gone up by two points.]

>x display
Calibrate to Epsilon/Lime.

[Now might be a good time to consult your Official Space Relay League Antenna Calibration Guide.]

* * *

>gonear lever
Antenna Control
You float weightless at the port end of a cylinder. It is very cold and dark here in the near vacuum. A door leads starboard.

A short lever extends from the floor.

A yellow cable waves from a small panel.

[Your score has just gone up by two points.]

>x stars
The sky is awash with stars.

>x station
You can't see any such thing.

>x antenna
Which do you mean, the solar panels, the panel, or the display?

>x panel
Which do you mean, the solar panels or the panel?

* * *

>gonear me
Home
The room where you've slept your entire life. The crops are outside.

There is a secured hatch in the floor.

The homespun blanket which you use as your bed is arranged on the ground.

>x me
As virtuous as ever.

>x blanket
Homespun wool.

* * *

>gonear pigeons
Platform 5
This plaform is home to a flock of pigeons. You can continue spinward or antispinward.

>push pigeons
You annoy the pigeons.

>g
The pigeons fly away.

>l
Platform 5
This plaform is white with pigeon droppings. You can continue spinward or antispinward.

>asw
Platform 3
A platform about two thirds of the way towards the hub. You can continue spinward or antispinward.

You feel much lighter here, and you are very aware of how the station rotates, but everything is okay as long as you don't look down.

There is a red circuit breaker here.

>asw
Platform 1
A platform about two thirds of the way towards the hub. You can continue spinward or antispinward, or go up a ladder into the hub.

>asw
Platform 5
This plaform is home to a flock of pigeons. You can continue spinward or antispinward.

* * *

>x pigeons
Descendents of the flock your grandparents brought here for food.

>listen
Quiet cooing.

>push pigeons
You annoy the pigeons.

>listen
Annoyed cooing.

>look
Platform 5
This plaform is home to a flock of pigeons. You can continue spinward or antispinward.

>restart
Are you sure you want to restart?

>yes
You awake. You are lonely, so lonely. It was a thousand days ago today. All alone these thousand days. Your parents were the last. No, your father was the last. He held on for nearly a hundred days longer. Now you are the last. Alone. Adrift.

But maybe it isn't hopeless. There must still be other people in other worlds, and you think you know how to get there.

Today is the day.

Founder's Mercy
A Space Story by Thomas Insel
Release 1 / Serial number 181214 / Inform 7 build 6M62 (I6/v6.33 lib 6/12N) SD
Type ABOUT for credits or HINT for assistance.

Home (on the blanket)
The room where you've slept your entire life. The crops are outside.

There is a secured hatch in the floor.

>out
You get off the blanket.

Home
The room where you've slept your entire life. The crops are outside.

There is a secured hatch in the floor.

The homespun blanket which you use as your bed is arranged on the ground.

>asw
The exits are down to the cellar and outside to sector 4.

>out
Sector 4: Crops
Your home is here among the crops. To the port and starboard, the station walls rise up to the hub above. You can walk spinward or antispinward.

>asw
You walk a little ways to the next sector.

Sector 3: Forest
Trees, a house, and a church. A red pylon stretches up from the ground to the hub of the station. You can walk spinward or antispinward.

>asw
You walk a little ways to the next sector.

Sector 2: Aquaculture
A deep pond with some fish. You can walk spinward or antispinward.

>asw
You walk a little ways to the next sector.

Sector 1: Crops
You still maintain the crops here. There is a small graveyard and the barn remains from when this was the livestock sector. A pylon stretches up from the ground to the hub of the station. You can walk spinward or antispinward.

There is a secured hatch in the ground.

>take crops
They're hardly portable.

>asw
You walk a little ways to the next sector.

Sector 6: Hydroponics
Your people preferred to grow things the old fashioned way, but in truth the majority of your fruit and vegetables came from this sector when the machines still worked. You can walk spinward or antispinward.

There is a secured hatch in the ground.

* * *

>asw
You walk a little ways to the next sector.

Sector 5: Forest
The school house is nestled among the trees. A pylon stretches up from the same grove to the hub of the station. You can walk spinward or antispinward.

You have walked the entire ring. Everything is as expected, much is not working. Now, it's time to leave: the pods are below Sector 1.

>asw
You walk a little ways to the next sector.

Sector 4: Crops
Your home is here among the crops. To the port and starboard, the station walls rise up to the hub above. You can walk spinward or antispinward.

>take crops
They're hardly portable.

* * *

>gonear pond
Sector 2: Aquaculture
A deep pond with some fish. You can walk spinward or antispinward.

>put scanner in pond
You aren't confident you would be able to retrieve the scanner.

>put scanner into pond
You aren't confident you would be able to retrieve the scanner.

>throw scanner at fish
Futile.

>give scanner to fish
You can only do that to something animate.

* * *

>gonear red
(the red circuit breaker)
Platform 3
A platform about two thirds of the way towards the hub. You can continue spinward or antispinward.

You feel much lighter here, and you are very aware of how the station rotates, but everything is okay as long as you don't look down.

There is a red circuit breaker here.

>close breaker
You reach out and switch the circuit breaker on.

It isn't something you can close.

[Your score has just gone up by one point.]

* * *

>gonear red
(the red circuit breaker)
Platform 3
A platform about two thirds of the way towards the hub. You can continue spinward or antispinward.

You feel much lighter here, and you are very aware of how the station rotates, but everything is okay as long as you don't look down.

There is a red circuit breaker here.

>gonear red handle
Airlock
The airlock is also a cylinder, with a closed door to the port, a closed door to the starboard, and a red handle in the wall.

>look
Airlock
The airlock is also a cylinder, with a closed door to the port, a closed door to the starboard, and a red handle in the wall.

>pull handle
That doesn't work, but you could probably turn the handle.

>turn handle
You know from your safety training not to turn the handle without a backup oxygen source.

>purloinmask
That's not a verb I recognize.

>purloin mask
[Purloined.]

* * *

>turn handle
You turn the handle an entire rotation, and after a moment, you feel the air rush out of the airlock.

>out
(first opening the starboard airlock door)
It seems to be locked.

>in
(first opening the port airlock door)
You crawl through a narrow accessway.

Antenna Control
You float weightless at the port end of a cylinder. Through a surprisingly large window, you can see the station rotating around you, solar panels, and antennas, all backed by a spectacular field of stars.  A short lever extends from the floor, and a yellow cable waves from a small control panel.

It is very cold and dark here in the near vacuum. An airlock door leads starboard.

[Your score has just gone up by two points.]

* * *

>gonear red handle
Airlock
The airlock is also a cylinder, with a closed door to the port, a closed door to the starboard, and a red handle in the wall.

>out
(first opening the port airlock door)
It seems to be locked.

>showme airlock
(the Airlock)
Airlock - room
    starboard airlock door - closed door
    yourself - person
        scanner
        green jumpsuit (worn)
            pocket (part of green jumpsuit) - open container
    port airlock door - locked door
    red handle
singular-named, improper-named; lighted, visited, pressurized, frigid, unfamiliar
list grouping key: none
printed name: "Airlock"
printed plural name: none
indefinite article: none
description: "The airlock is also a cylinder, with a closed door to the port, a closed door to the starboard, and a red handle in the wall."
map region: Zero-G
destination name: none
match: Inside the Hub

>actions
Actions listing on.

>out
[exiting]
[(1) going port]
(first opening the port airlock door)
[(2) opening the port airlock door - silently]
It seems to be locked.
[(2) opening the port airlock door - silently - failed the can't open what's locked rule]

[(1) going port - failed the can't go through closed doors rule]

[exiting - failed the can't go through closed doors rule]

* * *

>gonear red handle
Airlock
The airlock is also a cylinder, with a closed door to the port, a closed door to the starboard, and a red handle in the wall.

>pull handle
That doesn't work, but you could probably turn the handle.

* * *

>turn handle
You know from your safety training not to turn the handle without a backup oxygen source.

>x handle
The handle extends from the ceiling and is labeled "Cycle."

* * *

>gonear red handle
Airlock
The airlock is also a cylinder, with a closed door to the port, a closed door to the starboard, and a red handle in the wall.

>turn handle
You know from your safety training not to press the button without a backup oxygen source.

>purloin mask
[Purloined.]

* * *

>wear mask
You put on the emergency mask.

>turn handle
You feel the air rush out of the airlock.

* * *

>gonear solar panels
Antenna Control
You float weightless at the port end of a cylinder. It is very cold and dark here in the near vacuum. A door leads starboard.

A short lever extends from the floor.

A yellow cable waves from a small panel.

[Your score has just gone up by two points.]

>x solar panels
The solar panels are the primary source of station power and support a small array of antennas.

>x antenna
You can't see any such thing.

>gonear barn
(Barn)
Barn
Not fancy: livestock on one side and feed on the other, but nothing remains of either. There is a plow near the entrance.

You can see a hoe here.

>out
Sector 1: Crops
You still maintain the crops here. There is a small graveyard and the barn remains from when this was the livestock sector. A pylon stretches up from the ground to the hub of the station. You can walk spinward or antispinward.

There is a secured hatch in the ground.

>x solar panels
The solar panels are the primary source of station power and support a small array of antennas.

>x antennas
The solar panels are the primary source of station power and support a small array of antennas.

>listobj
Founder's Testament
RF plug (P)
RF plug (P)
RF socket (P)
RF socket (P)
USB plug (P)
USB plug (P)
almond socket (P)
altar (F) (S)
atmosphere pump (F) (S)
atmosphere sensor
audio unit
barn (F) (S)
beige socket (P)
berths (F) (S)
blanket
brass plate (F) (S)
bulkhead door (F)
calinration panel
canned vegetables (F) (S)
chalkboard (F) (S)
church (F) (S)
clean eraser
crate of machine parts (F) (S)
crops (F) (S)
desk (F) (S)
display (P)
doll
emergency communications unit
emergency mask
fish (F) (S)
floor hatch (F)
floor hatch (F)
floor hatch (F)
graveyard (F) (S)
gray cable
green jumpsuit
green valve (F)
ground (F) (S)
hoe
home (F) (S)
hub (F) (S)
hydroponics machines (F) (S)
instruction module
instruction module
junk repository
keypad (P)
ladder (F) (S)
large bag of split peas (F) (S)
laser beam (F) (S)
learning machine (F) (S)
lever (F)
maintenance platform (F) (S)
maintenance platform (F) (S)
mirrors (F) (S)
organ (F) (S)
pair of gravity boots
panel (F) (S)
pile of clutter (F)
plow (F) (S)
pocket (P)
pond (F) (S)
port airlock door (F) (S)
power module
power module
power module
pressure regulation module
pressure regulation module
pylon (F) (S)
pylon (F) (S)
pylon (F) (S)
pylon (F) (S)
pylons (F) (S)
red button (F) (S)
red circuit breaker (F)
scanner
school house (F) (S)
shelves (F) (S)
solar panels (F) (S)
space suit (F) (S)
starboard airlock door (F) (S)
stars (F) (S)
station walls (F) (S)
status display (F) (S)
tan socket (P)
the house (F) (S)
trees (F) (S)
trees (F) (S)
unremarkable junk (F)
vegetables (F) (S)
yellow cable
yourself

>robj
That's not a verb I recognize.

>robjects
That's not a verb I recognize.

* * *

>gonear stars
Antenna Control
You float weightless at the port end of a cylinder. It is very cold and dark here in the near vacuum. A door leads starboard.

A short lever extends from the floor.

A yellow cable waves from a small panel.

[Your score has just gone up by two points.]

>x stars
The sky is awash with stars.

>restart
Are you sure you want to restart?

>yes
You awake. You are lonely, so lonely. It was a thousand days ago today. All alone these thousand days. Your parents were the last. No, your father was the last. He held on for nearly a hundred days longer. Now you are the last. Alone. Adrift.

But maybe it isn't hopeless. There must still be other people in other worlds, and you think you know how to get there.

Today is the day.

Founder's Mercy
A Space Story by Thomas Insel
Release 1 / Serial number 181213 / Inform 7 build 6M62 (I6/v6.33 lib 6/12N) SD
Type ABOUT for credits or HINT for assistance.

Home (on the blanket)
The room where you've slept your entire life. The crops are outside.

There is a secured hatch in the floor.

>out
You get off the blanket.

Home
The room where you've slept your entire life. The crops are outside.

There is a secured hatch in the floor.

The homespun blanket which you use as your bed is arranged on the ground.

>out
Sector 4: Crops
Your home is here among the crops. To the port and starboard, the station walls rise up to the hub above. You can walk spinward or antispinward.

>x stars
The sky is awash with stars.

* * *

>gonear yellow
Antenna Control
You float weightless at the port end of a cylinder. Through a surprisingly large window, you can see the station rotating around you, solar panels, and antennas, all backed by a spectacular field of stars.  A short lever extends from the floor, and a yellow cable waves from a small control panel.

It is very cold and dark here in the near vacuum. An airlock door leads starboard.

[Your score has just gone up by two points.]

>get yellow
Taken.

>drop yellow
You release the yellow cable and it floats nearby.

>plug yellow into panel
The yellow cable is already plugged into the calibration panel.

>x display
Calibrate to Epsilon/Lime.

[Now might be a good time to consult the Official Space Relay League Antenna Calibration Guide™, included in your game package.]

* * *

>gonear yellow
Antenna Control
You float weightless at the port end of a cylinder. Through a surprisingly large window, you can see the station rotating around you, solar panels, and antennas, all backed by a spectacular field of stars.  A short lever extends from the floor, and a yellow cable waves from a small control panel.

It is very cold and dark here in the near vacuum. An airlock door leads starboard.

[Your score has just gone up by two points.]

>look out window
You might be the first person to look out through this window in a generation. While you've seen the stars, the solar panels, and so on through transparent walls of the station, the view from here is different and definitely more impressive.

>look out the window
You might be the first person to look out through this window in a generation. While you've seen the stars, the solar panels, and so on through transparent walls of the station, the view from here is different and definitely more impressive.

>look through window
You might be the first person to look out through this window in a generation. While you've seen the stars, the solar panels, and so on through transparent walls of the station, the view from here is different and definitely more impressive.

>look at window
You might be the first person to look out through this window in a generation. While you've seen the stars, the solar panels, and so on through transparent walls of the station, the view from here is different and definitely more impressive.

* * *

>gonear yellow
Antenna Control
You float weightless at the port end of a cylinder. Through a surprisingly large window, you can see the station rotating around you, solar panels, and antennas, all backed by a spectacular field of stars.  A short lever extends from the floor, and a yellow cable waves from a small control panel.

It is very cold and dark here in the near vacuum. An airlock door leads starboard.

[Your score has just gone up by two points.]

>purloin comms
[Purloined.]

>drop comms
You drop the emergency communications unit and it floats nearby.

>plug yellow into comms
You plug the yellow cable into the emergency communications unit.

>look
Antenna Control
You float weightless at the port end of a cylinder. It is very cold and dark here in the near vacuum. A door leads starboard.

A short lever extends from the floor.

You can also see an emergency communications unit and a yellow cable (plugged into an emergency communications unit) floating here.

* * *

>purloin comms
[Purloined.]

>plug cable into comms
You plug the yellow cable into the emergency communications unit.

>look
Antenna Control
You float weightless at the port end of a cylinder. It is very cold and dark here in the near vacuum. A door leads starboard.

A short lever extends from the floor.

A yellow cable waves from a small panel.

* * *

>purloin comms
[Purloined.]

>plug yellow
What do you want to plug the yellow cable into?

>comms
You plug the yellow cable into the emergency communications unit.

>look
Antenna Control
You float weightless at the port end of a cylinder. It is very cold and dark here in the near vacuum. A door leads starboard.

A short lever extends from the floor.

A yellow cable is plugged into a calibration panel and an emergency communications unit.

>showme  panel
calibration panel - machine
    RF socket (part of calibration panel) - RF socket
    display (part of calibration panel)
    keypad (part of calibration panel)
location: in Antenna Control
singular-named, improper-named; unlit, inedible, fixed in place, scenery; opaque, open, unopenable, unlocked
list grouping key: none
printed name: "calibration panel"
printed plural name: "machines"
indefinite article: none
description: "This is clearly the antenna calibration panel. It has a display, a keypad, and a yellow RF cable."
initial appearance: none
carrying capacity: 0

* * *

>gonear yellow
Antenna Control
You float weightless at the port end of a cylinder. Through a surprisingly large window, you can see the station rotating around you, solar panels, and antennas, all backed by a spectacular field of stars.  A short lever extends from the floor, and a yellow cable waves from a small control panel.

It is very cold and dark here in the near vacuum. An airlock door leads starboard.

[Your score has just gone up by two points.]

>remove jumpsuit
It is too cold here to even consider removing the green jumpsuit.

>x station
Backed by a field of stars, you can see the wheel of the station rotating around you to the starboard — you didn't notice before but the airlock must be some sort of rotation coupling.

>touch station
The station is all around you.

You feel nothing unexpected.

>x stars
The stars seem brighter up here.

* * *

>gonear yellow
Antenna Control
You float weightless at the port end of a cylinder. Through a surprisingly large window, you can see the station rotating around you, solar panels, and antennas, all backed by a spectacular field of stars.  A short lever extends from the floor, and a yellow cable waves from a small control panel.

It is very cold and dark here in the near vacuum. An airlock door leads starboard.

[Your score has just gone up by two points.]

>scan antenna
No modular technology detected.

>scan door
No modular technology detected.

>gonear red button
Airlock
There are port and starboard doors and a red button.

>scan button
No modular technology detected.

>gonear yellow
Antenna Control
You float weightless at the port end of a cylinder. Through a surprisingly large window, you can see the station rotating around you, solar panels, and antennas, all backed by a spectacular field of stars.  A short lever extends from the floor, and a yellow cable waves from a small control panel.

It is very cold and dark here in the near vacuum. An airlock door leads starboard.

>scan antennas
No modular technology detected.

>scan panels
Machine is functional. Operating at 73% efficiency.

>scan window
No modular technology detected.

>scan lever
No modular technology detected.

>scan antenna
No modular technology detected.

>scan solar
Machine is functional. Operating at 72% efficiency.

>scan lever
No modular technology detected.

>scan panel
Machine is functional.

>scan socket
No modular technology detected.

>scan cable
Cable is functional.

>scan socket
No modular technology detected.

>scan plug
No modular technology detected.

* * *

>scan antenna
No modular technology detected.

>scan solar
Machine is functional. Operating at 73% efficiency.

>scan station
The station is all around you.

>showme
Antenna Control - room
    antennas - backdrop
    port airlock door - locked door
    stars - backdrop
    solar panels - backdrop
    yourself - person
        scanner
        green jumpsuit (worn)
            pocket (part of green jumpsuit) - open container
    window
    station
    lever - open container
    calibration panel - machine
        RF socket (part of calibration panel) - RF socket
        display (part of calibration panel)
        keypad (part of calibration panel)
    yellow cable - cable
        RF plug (part of yellow cable) - RF plug
        RF plug (part of yellow cable) - RF plug

>x antennas
You can see the antennas clearly from here: small telemetry antennas and the main communications dish. The dish lists, aiming at nothing in particular.

>scan antennas
There is a window in the way.

* * *

>gonear yellow
Antenna Control
You float weightless at the port end of a cylinder. Through a surprisingly large window, you can see the station rotating around you, solar panels, and antennas, all backed by a spectacular field of stars.  A short lever extends from the floor, and a yellow cable waves from a small control panel.

It is very cold and dark here in the near vacuum. An airlock door leads starboard.

[Your score has just gone up by two points.]

>scan cable
Cable is functional.

>scan socket
Socket is functional.

>scan plug
Plug is functional.

>scan display
No modular technology detected.

>scan keypad
No modular technology detected.

* * *

>gonear yellow
Antenna Control
You float weightless at the port end of a cylinder. Through a surprisingly large window, you can see the station rotating around you, solar panels, and antennas, all backed by a spectacular field of stars.  A short lever extends from the floor, and a yellow cable waves from a small control panel.

It is very cold and dark here in the near vacuum. An airlock door leads starboard.

[Your score has just gone up by two points.]

>scan panel
Machine is functional. Antenna is not calibrated.

>push 3
Calibrate to Delta/Plum.

>push 8
Calibrate to Gamma/Banana.

* * *

>push 5
Calibrate to Beta/Cherry.

>push 2
Calibration successful.

[Your score has just gone up by one point.]

>scan panel
Machine is functional. Antenna is calibrated.

>scan keypad
Machine is functional.

>scan displa
You can't see any such thing.

>scan display
Machine is functional.

>gonear plate
Pod Control
This room serves as an airlock for the pod bay, and holds an old space suit and various machinery such as the atmosphere pump. There is a brass plate on the wall.

There is a secured hatch in the ceiling.

Beside the secured port door, a status display shows an error message.

>scan plate
No modular technology detected.

>scan display
Machine is functional.

>x display
Pod bay locked down
 1. Telemetry sensor array offline - reset breaker FM36-87/A @ hub platform
 2. Launch system cooling loop offline - open backup valve @ Sector 2
 3. Pod bay depressurized - scan and repair atmosphere pump

>x display
Pod bay locked down
 1. Telemetry sensor array offline - reset breaker FM36-87/A @ hub platform
 2. Launch system cooling loop offline - open backup valve @ Sector 2
 3. Pod bay depressurized - scan and repair atmosphere pump

>look
Pod Control
This room serves as an airlock for the pod bay, and holds an old space suit and various machinery such as the atmosphere pump. There is a brass plate on the wall.

There is a secured hatch in the ceiling.

Beside the secured port door, a status display shows an error message.

* * *

>gonear yellow
Antenna Control
You float weightless at the port end of a cylinder. Through a surprisingly large window, you can see the station rotating around you, solar panels, and antennas, all backed by a spectacular field of stars.  A short lever extends from the floor, and a yellow cable waves from a small control panel.

It is very cold and dark here in the near vacuum. An airlock door leads starboard.

[Your score has just gone up by two points.]

>showme
Antenna Control - room
    antennas - backdrop
    port airlock door - locked door
    stars - backdrop
    solar panels - backdrop
    yourself - person
        scanner
        green jumpsuit (worn)
            pocket (part of green jumpsuit) - open container
    window
    station
    lever - open container
    calibration panel - machine
        RF socket (part of calibration panel) - RF socket
        display (part of calibration panel)
        keypad (part of calibration panel)
    yellow cable - cable
        RF plug (part of yellow cable) - RF plug
        RF plug (part of yellow cable) - RF plug

>analyze stars
They are trillions of meters or more away.

>touch stars
They are trillions of meters or more away.

>taste stars
They are trillions of meters or more away.

>listen
Profound silence.

>smell
Only familiar odors.

* * *

>gonear yellow
Antenna Control
You float weightless at the port end of a cylinder. Through a surprisingly large window, you can see the station rotating around you, solar panels, and antennas, all backed by a spectacular field of stars.  A short lever extends from the floor, and a yellow cable waves from a small control panel.

It is very cold and dark here in the near vacuum. An airlock door leads starboard.

[Your score has just gone up by two points.]

>x antenna calibration panel
This is clearly the antenna calibration panel. It has a display, a keypad, and a yellow RF cable.

>x keypad
The keypad has the digits from 0 through 9.

>x cable
A two meter yellow RF cable. It is not plugged into anything.

>i
You are carrying:
  a scanner
  a green jumpsuit (being worn)

>purloin comms
[Purloined.]

>plug comms into cable
The emergency communications unit has no plug.

>plug cable into comms
You plug the yellow cable into the emergency communications unit.

* * *

>look
Antenna Control
You float weightless at the port end of a cylinder. It is very cold and dark here in the near vacuum. A door leads starboard.

A short lever extends from the floor.

A yellow cable waves from a small panel.

>drop comms
You drop the emergency communications unit and it floats nearby.

>look
Antenna Control
You float weightless at the port end of a cylinder. It is very cold and dark here in the near vacuum. A door leads starboard.

A short lever extends from the floor.

A yellow cable waves from a small panel.

You can also see an emergency communications unit floating here.

* * *

>gonear yellow
Antenna Control
You float weightless at the port end of a cylinder. Through a surprisingly large window, you can see the station rotating around you, solar panels, and antennas, all backed by a spectacular field of stars.  A short lever extends from the floor, and a yellow cable waves from a small control panel.

It is very cold and dark here in the near vacuum. An airlock door leads starboard.

[Your score has just gone up by two points.]

>x antennas
You can see the antennas clearly from here: small telemetry antennas and the main communications dish. The dish lists, aiming at nothing in particular.

>x lever
A short length of hollow steel pipe pulled out from the wall.

>purloin hoe
[Purloined.]

>put hoe in pipe
You can't put something inside itself.

>put hoe in lever
You slide the hoe into the hollow lever, forming a longer lever.

[Your score has just gone up by one point.]

>pull lever
The lever is already pulled as far as it goes.

>push lever
You push the hoe and the lever moves. After a moment, you feel air rush into the room.

>look
Antenna Control
You float weightless at the port end of a cylinder. Through a surprisingly large window, you can see the station rotating around you, solar panels, and antennas, all backed by a spectacular field of stars.  Your hoe extends the short lever in the floor, and a yellow cable waves from a small control panel.

It is very cold and dark here. An airlock door leads starboard.

* * *

>gonear yellow
Antenna Control
You float weightless at the port end of a cylinder. Through a surprisingly large window, you can see the station rotating around you, solar panels, and antennas, all backed by a spectacular field of stars.  A short lever extends from the floor, and a yellow cable waves from a small control panel.

It is very cold and dark here in the near vacuum. An airlock door leads starboard.

[Your score has just gone up by two points.]

>x panel
This is clearly the antenna calibration panel. It has a display, a keypad, and a yellow RF cable.

>x solar panel
The solar panels are the primary source of station power and support a small array of antennas.

>drop panel
The calibration panel is already here.

>x antenna calibration panel
I only understood you as far as wanting to examine the antennas.

* * *

>gonear yellow
Antenna Control
You float weightless at the port end of a cylinder. Through a surprisingly large window, you can see the station rotating around you, solar panels, and antennas, all backed by a spectacular field of stars.  A short lever extends from the floor, and a yellow cable waves from a small control panel.

It is very cold and dark here in the near vacuum. An airlock door leads starboard.

[Your score has just gone up by two points.]

>x stars
The stars seem brighter up here.

>starboard
(first opening the port airlock door)
It seems to be locked.

* * *

>gonear yellow cable
Antenna Control
You float weightless at the port end of a cylinder. It is very cold and dark here in the near vacuum. A door leads starboard.

A short lever extends from the floor.

You can also see a yellow cable (plugged into a calibration panel) floating here.

[Your score has just gone up by two points.]

>i
You are carrying:
  a scanner
  a green jumpsuit (being worn)

>purloin audio
[Purloined.]

>plug audio into yellow cable
The audio unit has no plug.

>purloin comms
[Purloined.]

>plug yellow cable into comms
You plug the yellow cable into the emergency communications unit.

>look
Antenna Control
You float weightless at the port end of a cylinder. It is very cold and dark here in the near vacuum. A door leads starboard.

A short lever extends from the floor.

A yellow cable waves from a small panel.

* * *

>gonear yellow cable
Antenna Control
You float weightless at the port end of a cylinder. It is very cold and dark here in the near vacuum. A door leads starboard.

A short lever extends from the floor.

You can also see a yellow cable (plugged into a calibration panel) floating here.

[Your score has just gone up by two points.]

>x cable
A two meter yellow RF cable. It is plugged into a calibration panel.

>look
Antenna Control
You float weightless at the port end of a cylinder. It is very cold and dark here in the near vacuum. A door leads starboard.

A short lever extends from the floor.

You can also see a yellow cable (plugged into a calibration panel) floating here.

>get cabl
You can't see any such thing.

>get cable
Taken.

>unplug cable from panel
The yellow cable is permanently attached to the panel.

>i
You are carrying:
  a yellow cable (plugged into a calibration panel)
  a scanner
  a green jumpsuit (being worn)

>l
Antenna Control
You float weightless at the port end of a cylinder. It is very cold and dark here in the near vacuum. A door leads starboard.

A short lever extends from the floor.

>drop cable
You drop the yellow cable and it floats nearby.

>look
Antenna Control
You float weightless at the port end of a cylinder. It is very cold and dark here in the near vacuum. A door leads starboard.

A short lever extends from the floor.

You can also see a yellow cable (plugged into a calibration panel) floating here.

>purloin comms
[Purloined.]

* * *

>plug cable into comms
You plug the yellow cable into the emergency communications unit.

>look
Antenna Control
You float weightless at the port end of a cylinder. It is very cold and dark here in the near vacuum. A door leads starboard.

A short lever extends from the floor.

You can also see a yellow cable (plugged into a calibration panel and an emergency communications unit) floating here.

>undo
Antenna Control
[Previous turn undone.]

>plug cable into panel
The yellow cable is already plugged into the calibration panel.

>l
Antenna Control
You float weightless at the port end of a cylinder. It is very cold and dark here in the near vacuum. A door leads starboard.

A short lever extends from the floor.

You can also see a yellow cable (plugged into a calibration panel) floating here.

* * *

>hint
Your objective is simply to leave the station and find other people.

You can start by looking around and leaving your initial location.

By the way, it should be impossible to put this story into an unwinnable state, so feel free to explore and experiment.

If you are having trouble getting started, I suggest reading A Beginner's Guide to Interactive Fiction by Stephen Granade and Emily Short, available at:

  https://brasslantern.org/players/howto/beginnersguide.html

[You can type HINT any time for contextual assistance. If you prefer not to be tempted, you can type HINTS OFF to disable hints.]

>about
About Founder's Mercy
This is my second released Inform project, conceived and implemented in the last months of 2018.

Thanks to Graham Nelson, Andrew Plotkin, Emily Short, and everyone else who contributed to the Inform and Glulx ecosystem. Thanks also Juhana Leinonen for the Object Response Tests extension, Erik Temple for the Real-Time Delays extension, and Sean Turner for the Plugs and Sockets extension. Exit listing code is inspired by Eric Eve's Exit Lister. Keypad code is inspired by Emily Short's Computers.

The cover art is adapted from Figure 1.1 from NASA SP-413, Space Settlements: A Design Study, edited by Richard D. Johnson and Charles Holbrow, and available from The Internet Archive at https://archive.org/details/SpaceSettlementsADesignStudy1977 .

Please send your feedback, bug reports, and requests for help to tinsel@tinsel.org. You can always find the current version of this story at http://tinsel.org/IF/ .

This work is Copyright © 2019 Thomas Insel but may be freely shared according to the terms of the Creative Commons Attribution 4.0 International license (https://creativecommons.org/licenses/by/4.0/).

* * *

>n
You have heard of compass directions like north, but they don't make any sense here. Instead, you can go spinward, antispinward, port, and starboard. When you look spinward, port is left and starboard is right.

[You can use the abbreviations SW, ASW, P, and S. You can also go UP, DOWN, IN, or OUT where appropriate. Type EXITS if you get confused about geography.]

>n
You have heard of compass directions like north, but they don't make any sense here. Instead, you can go spinward, antispinward, port, and starboard. When you look spinward, port is left and starboard is right.

* * *

>out
You get off the blanket.

Home
The room where you've slept your entire life. The crops are outside.

There is a secured hatch in the floor.

A homespun blanket is arranged neatly on the ground. It is your bed.

>asw
The exits are down to the cellar and outside to sector 4.

* * *

>church
Church
Before everyone left or died, you celebrated every sabbath here. The altar stands against one wall, and an organ and a portable audio unit stand against the other.

On the altar is The Founder's Testament.

A gray cable connects the organ to the audio unit.

>read testament
The Founder's Testament tells the story of how your people left Old Earth and how the lucky few settled in the L4 colonies, free from the corrupting temptations of society: drugs, sensation recordings, social media, and the like. You know the story by heart, and have already derived whatever comfort you can from this book.

>g
You have already derived whatever comfort you can from this book.

* * *

>out
You get off the blanket.

Home
The room where you've slept your entire life. The crops are outside.

There is a secured hatch in the floor.

A homespun blanket is arranged neatly on the ground. It is your bed.

>out
Sector 4: Crops
Your home is here among the crops. To the port and starboard, the station walls rise up to the hub above. You can walk spinward or antispinward.

>get crops
It is not — may never be — harvest time.

>look
Sector 4: Crops
Your home is here among the crops. To the port and starboard, the station walls rise up to the hub above. You can walk spinward or antispinward.

>gonear yellow
Antenna Control
You float weightless at the port end of a cylinder. It is very cold and dark here in the near vacuum. A door leads starboard.

A short lever extends from the floor.

A yellow cable waves from a small panel.

[Your score has just gone up by two points.]

>showme
Antenna Control - room
    antennas - backdrop
    port airlock door - locked door
    stars - backdrop
    mirrors - backdrop
    solar panels - backdrop
    yourself - person
        scanner
        green jumpsuit (worn)
            pocket (part of green jumpsuit) - open container
    lever - open container
    calibration panel - machine
        RF socket (part of calibration panel) - RF socket
        display (part of calibration panel)
        keypad (part of calibration panel)
    yellow cable - cable
        RF plug (part of yellow cable) - RF plug
        RF plug (part of yellow cable) - RF plug

>purloin comms
[Purloined.]

* * *

>plug cable into comms
You plug the yellow cable into the emergency communications unit.

>look
Antenna Control
You float weightless at the port end of a cylinder. It is very cold and dark here in the near vacuum. A door leads starboard.

A short lever extends from the floor.

A yellow cable is plugged into the calibration panel and an emergency communications unit.

>out
The yellow cable pulls out of the emergency communications unit.

(first opening the port airlock door)
It seems to be locked.

>restart
Are you sure you want to restart?

* * *

>out
Sector 4: Crops
Your home is here among the crops. To the port and starboard, the station walls rise up to the hub above. You can walk spinward or antispinward.

>starts
That's not a verb I recognize.

>x stars
The sky is awash with stars.

* * *

>out
Sector 4: Crops
Your home is here among the crops. To the port and starboard, the station walls rise up to the hub above. You can walk spinward or antispinward.

>scan antenna
Machine is functional. Operating at 73% efficiency.

>g
Machine is functional. Operating at 72% efficiency.

>scan panel
Machine is functional. Operating at 71% efficiency.

>g
Machine is functional. Operating at 71% efficiency.

>gonear yellow
Antenna Control
You float weightless at the port end of a cylinder. Through a surprisingly large window, you can see the station rotating around you, solar panels, and antennas, all backed by a spectacular field of stars.  A short lever extends from the floor, and a yellow cable waves from a small control panel.

It is very cold and dark here in the near vacuum. An airlock door leads starboard.

[Your score has just gone up by two points.]

>scan solar panel
Machine is functional. Operating at 73% efficiency.

* * *

>sw
You walk a little ways to the next sector.

Sector 1: Crops
You still maintain the crops here. There is a small graveyard and the barn remains from when this was the livestock sector. A pylon stretches up from the ground to the hub of the station. You can walk spinward or antispinward.

There is a secured hatch in the ground.

>in
Barn
Not fancy: livestock on one side and feed on the other, but nothing remains of either. There is a plow near the entrance.

You can see a hoe here.

>x hoe
A straight-handled draw hoe. You have worked the fields by hand for a long time, so it is well worn.

>g
A straight-handled draw hoe. You have worked the fields by hand for a long time, so it is well worn.

>x plow
Some of the old stories mentioned oxen, but you plowed with a team of goats until the animals began to die. Then with less grain and no meat to sell, the community couldn't make its debt payments and people started leaving.

>g
A steel walking plow.

* * *

>out
Sector 4: Crops
Your home is here among the crops. To the port and starboard, the station walls rise up to the hub above. You can walk spinward or antispinward.

>take crops
It is not - may never be - harvest time.

>eat crops
You aren't hungry.

* * *

>out
Sector 4: Crops
Your home is here among the crops. To the port and starboard, the station walls rise up to the hub above. You can walk spinward or antispinward.

>x antennas
Various antennas for various purposes.

>x panels
The solar panels are the primary source of station power and support a small array of antennas.

>scan antennas
No modular technology detected.

>touch antennasa
You can't see any such thing.

>touch antennas
You feel nothing unexpected.

* * *

>out
You get off the blanket.

Home
The room where you've slept your entire life. The crops are outside.

There is a secured hatch in the floor.

A homespun blanket is arranged neatly on the ground. It is your bed.

>x blanket
Homespun wool.

* * *

>pit
That's not a verb I recognize.

>out
You get off the blanket.

Home
The room where you've slept your entire life. The crops are outside.

There is a secured hatch in the floor.

The homespun blanket which you use as your bed is arranged on the ground.

* * *

>asw
You walk a little ways to the next sector.

Sector 1: Crops
You still maintain the crops here. There is a small graveyard and the barn remains from when this was the livestock sector. A pylon stretches up from the ground to the hub of the station. You can walk spinward or antispinward.

There is a secured hatch in the ground.

>in
Barn
Not fancy: livestock on one side and feed on the other, but nothing remains of either. There is a plow near the entrance.

You can see a hoe here.

>x barn
You can't see any such thing.

>x plow
Some of the old stories mentioned oxen, but you plowed with a team of goats until the animals started dying. So there was less grain and no meat to sell, before long no income, and then people started leaving.

* * *

>purloin hoe
[Purloined.]

>put hoe in pocket
It's a large pocket, but not large enough to hold a hoe.

>put scanner in pocket
You put the scanner into the pocket.

* * *

>purloin peas
(the handful of split peas)
[Purloined.]

>gonear pigeons
Platform 5
This plaform is home to a flock of pigeons. You can continue spinward or antispinward.

>feed pigeons
You scatter the split peas among the pigeons, causing a minor commotion as they peck at them.

>undo
Platform 5
[Previous turn undone.]

>put peas in pocket
You put the handful of split peas into the pocket.

>feed pigeons
(first taking the handful of split peas)
You scatter the split peas among the pigeons, causing a minor commotion as they peck at them.

* * *

>rlist
That's not a verb I recognize.

>rtree
Airlock
    red handle
Antenna Control
    window
    station
    lever
    calibration panel & RF socket, display, and keypad
    yellow cable & RF plug and RF plug
Barn
    plow
    hoe
Cellar
    shelves + canned vegetables and emergency mask 
    large bag of split peas
Church
    altar + Founder's Testament 
    organ & tan socket
    audio unit*  + power module & beige socket
    gray cable & USB plug and USB plug
Home
    blanket + green jumpsuit, pocket, scanner, and yourself 
House
    doll
Inside the Hub
Platform 1
Platform 3
    red circuit breaker
Platform 5
    pigeon droppings
    flock of pigeons
Pod Bay
    berths
    pile of clutter + RF socket, almond socket, atmosphere sensor, emergency communications unit, and unremarkable junk 
Pod Control
    space suit
    brass plate
    status display
    atmosphere pump + power module and pressure regulation module 
School House
    learning machine + instruction module and power module 
    desk + clean eraser 
    chalkboard
Sector 1: Crops
    crops
    graveyard
    pylon
Sector 2: Aquaculture
    pond
    fish
Sector 3: Forest
    pylon
    trees
Sector 4: Crops
    vegetables
Sector 5: Forest
    pylon
    trees
Sector 6: Hydroponics
    hydroponics machines
Supply Vault
    crate of machine parts
    pair of gravity boots
(Nowhere)
    green valve
    handful of split peas
    instruction module
    jar of pickled okra
    junk repository
    laser beam
    pressure regulation module
(Backdrops)
    antennas
    antennas
    ground
    hub
    maintenance platform
    maintenance platform
    mirrors
    pylon
    pylons
    solar panels
    stars
    station walls

* * *

>rtree
Airlock
    red handle
Antenna Control
    window
    station
    lever
    calibration panel & RF socket, display, keypad 
    yellow cable & RF plug, RF plug 
Barn
    plow
    hoe
Cellar
    shelves + canned vegetables, emergency mask*  
    large bag of split peas
Church
    altar + Founder's Testament  
    organ & tan socket 
    audio unit*  + power module  & beige socket 
    gray cable & USB plug, USB plug 
Home
    blanket + green jumpsuit, pocket, scanner, yourself*  
House
    doll
Inside the Hub
Platform 1
Platform 3
    red circuit breaker
Platform 5
    pigeon droppings
    flock of pigeons
Pod Bay
    berths
    pile of clutter + RF socket, almond socket, atmosphere sensor, emergency communications unit, unremarkable junk  
Pod Control
    space suit
    brass plate
    status display
    atmosphere pump + power module, pressure regulation module  
School House
    learning machine + instruction module, power module  
    desk + clean eraser  
    chalkboard
Sector 1: Crops
    crops
    graveyard
    pylon
Sector 2: Aquaculture
    pond
    fish
Sector 3: Forest
    pylon
    trees
Sector 4: Crops
    vegetables
Sector 5: Forest
    pylon
    trees
Sector 6: Hydroponics
    hydroponics machines
Supply Vault
    crate of machine parts
    pair of gravity boots
(Nowhere)
    green valve
    handful of split peas
    instruction module
    jar of pickled okra
    junk repository
    laser beam
    pressure regulation module
(Backdrops)
    antennas
    antennas
    ground
    hub
    maintenance platform
    maintenance platform
    mirrors
    pylon
    pylons
    solar panels
    stars
    station walls

>gonear red button
Airlock
There are port and starboard doors and a red button.

>look
Airlock
There are port and starboard doors and a red button.

>open port
(the port airlock door)
It seems to be locked.

>look
Airlock
There are port and starboard doors and a red button.

>open starboard
(the starboard airlock door)
You open the starboard airlock door.

>look
Airlock
There are port and starboard doors and a red button.

>actions
Actions listing on.

>turn button
[turning the red button]
It is fixed in place.
[turning the red button - failed the can't turn what's fixed in place rule]

* * *

>showme audio unit
audio unit - machine
    beige socket (part of audio unit) - USB socket
    power module - power module
location: in Church
singular-named, improper-named; unlit, inedible, portable, bulky; opaque, open, unopenable, unlocked
list grouping key: none
printed name: "audio unit"
printed plural name: "machines"
indefinite article: none
description: "The audio unit incorporates a speaker, a microphone, and a socket you would use to connect it to another device."
initial appearance: none
carrying capacity: 1
state: "not-functional"

>rtree
Airlock
    red handle
Antenna Control
    window
    station
    lever
    calibration panel & RF socket, display, and keypad
    yellow cable & RF plug and RF plug
Barn
    plow
    hoe
Cellar
    shelves + canned vegetables and emergency mask 
    large bag of split peas
Church
    altar + Founder's Testament 
    organ & tan socket
    audio unit*  + power module & beige socket
    gray cable & USB plug and USB plug
Home
    blanket + green jumpsuit, pocket, scanner, and yourself 
House
    doll
Inside the Hub
Platform 1
Platform 3
    red circuit breaker
Platform 5
    pigeon droppings
    flock of pigeons
Pod Bay
    berths
    pile of clutter + RF socket, almond socket, atmosphere sensor, emergency communications unit, and unremarkable junk 
Pod Control
    space suit
    brass plate
    status display
    atmosphere pump + power module and pressure regulation module 
School House
    learning machine + instruction module and power module 
    desk + clean eraser 
    chalkboard
Sector 1: Crops
    crops
    graveyard
    pylon
Sector 2: Aquaculture
    pond
    fish
Sector 3: Forest
    pylon
    trees
Sector 4: Crops
    vegetables
Sector 5: Forest
    pylon
    trees
Sector 6: Hydroponics
    hydroponics machines
Supply Vault
    crate of machine parts
    pair of gravity boots
(Nowhere)
    green valve
    handful of split peas
    instruction module
    jar of pickled okra
    junk repository
    laser beam
    pressure regulation module
(Backdrops)
    antennas
    antennas
    ground
    hub
    maintenance platform
    maintenance platform
    mirrors
    pylon
    pylons
    solar panels
    stars
    station walls

* * *

>s
The exits are down to the cellar and outside to sector 4.

>out
You get off the blanket.

Home
The room where you've slept your entire life. The crops are outside.

There is a secured hatch in the floor.

The homespun blanket which you use as your bed is arranged on the ground.

>s
The exits are down to the cellar and outside to sector 4.

>n
You have heard of compass directions like north, but they don't make any sense here. Instead, you can go spinward, antispinward, port, and starboard. When you look spinward, port is left and starboard is right.

[You can use the abbreviations SW, ASW, P, and S. You can also go UP, DOWN, IN, or OUT where appropriate. Type EXITS if you get confused about geography.]

>sw
The exits are down to the cellar and outside to sector 4.

>out
Sector 4: Crops
Your home is here among the crops. To the port and starboard, the station walls rise up to the hub above. You can walk spinward or antispinward.

* * *

>sw
You walk a little ways to the next sector.

Sector 5: Forest
The school house is nestled among the trees. A pylon stretches up from the same grove to the hub of the station. You can walk spinward or antispinward.

>s
You are blocked by the station wall. The exits are inside to the school house, spinward to sector 6, and antispinward to sector 4.

>sw
You walk a little ways to the next sector.

Sector 6: Hydroponics
Your people preferred to grow things the old fashioned way, but in truth the majority of your fruit and vegetables came from this sector when the machines still worked. You can walk spinward or antispinward.

There is a secured hatch in the ground.

* * *

>sw
You walk a little ways to the next sector.

Sector 1: Crops
You still maintain the crops here. There is a small graveyard and the barn remains from when this was the livestock sector. A pylon stretches up from the ground to the hub of the station. You can walk spinward or antispinward.

There is a secured hatch in the ground.

>sw
You walk a little ways to the next sector.

Sector 2: Aquaculture
A deep pond with some fish. You can walk spinward or antispinward.

>sw
You walk a little ways to the next sector.

Sector 3: Forest
Trees, a house, and a church. A red pylon stretches up from the ground to the hub of the station. You can walk spinward or antispinward.

You have walked the entire ring. Everything is as expected, much is not working. Now, it's time to leave: the pods are below Sector 1.

>s
House
Two families lived here, but not recently.

Someone has left a doll on the well swept floor.

* * *

>p
Sector 3: Forest
Trees, a house, and a church. A red pylon stretches up from the ground to the hub of the station. You can walk spinward or antispinward.

>p
Church
Before everyone left or died, you celebrated every sabbath here. The altar stands against one wall, and an organ and a portable audio unit stand against the other.

On the altar is The Founder's Testament.

A gray cable connects the organ to the audio unit.

* * *

>say yes
[To communicate in this story, type CHARACTER, MESSAGE where CHARACTER is someone or something and MESSAGE is what you want to say.]

>yes
That was a rhetorical question.

* * *

>showme work
chalkboard - thing
location: in School House
singular-named, improper-named; unlit, inedible, fixed in place, scenery
list grouping key: none
printed name: "chalkboard"
printed plural name: none
indefinite article: none
description: "The board is covered in your old arithmetic work."
initial appearance: none
chalkboard condition: written

>showme
Home - room
    floor hatch - floor hatch
    blanket - supporter
        yourself - person
            scanner
            green jumpsuit (worn)
                pocket (part of green jumpsuit) - open container

>showme jumpsuit
(the green jumpsuit)
green jumpsuit - thing
    pocket (part of green jumpsuit) - open container
location: worn by yourself on the blanket in Home
singular-named, improper-named; unlit, inedible, portable, wearable, handled
list grouping key: none
printed name: "green jumpsuit"
printed plural name: none
indefinite article: none
description: "You have worn modest jumpsuits like this since you were small. Originally, the colors had meanings: forest green for farmers, navy blue for technicians, and so on, but that distinction died even before the population."
initial appearance: none

>x pocket
The pocket is empty.

>get pocket
That seems to be a part of the green jumpsuit.

>i
You are carrying:
  a scanner
  a green jumpsuit (being worn)

* * *

>sing
You sing a hymn about virtue.

>pray
You sing a hymn praising the Founder.

>g
You sing a hymn about your exile from Old Earth.

>g
You sing a hymn praising the Founder.

>g
You sing a hymn about hard work.

>g
You sing a hymn about penitence.

>g
You sing a hymn about your exile from Old Earth.

>g
You sing a hymn about virtue.

* * *

>think
You've been alone for a thousand days — plenty of time for thinking. Now is the time for action.

>out
You get off the blanket.

Home
The room where you've slept your entire life. The crops are outside.

There is a secured hatch in the floor.

The homespun blanket which you use as your bed is arranged on the ground.

* * *

>think
You've been alone for a thousand days — plenty of time for thinking. Now is the time for action.

>use hatch
Please try specific a more specific verb.

>gonear lever
Antenna Control
You float weightless at the port end of a cylinder. Through a surprisingly large window, you can see the station rotating around you, solar panels, and antennas, all backed by a spectacular field of stars.  A short lever extends from the floor, and a yellow cable waves from a small control panel.

It is very cold and dark here in the near vacuum. An airlock door leads starboard.

[Your score has just gone up by two points.]

>purloin hoe
[Purloined.]

>attach hoe to lever
Yes, but how?

>put hoe into lever
You slide the hoe into the hollow lever, forming a longer lever.

[Your score has just gone up by one point.]

>purloin comms
[Purloined.]

>tie yellow to comms
You would achieve nothing by this.

>attach yellow to comms
You plug the yellow cable into the emergency communications unit.

>undo
Antenna Control
[Previous turn undone.]

>fasten yellow to comms
You would achieve nothing by this.

>cut yellow
The Founder said that violence is never the answer.

>nouns
At the moment, "it" means the yellow cable, "him" is unset, "her" is unset, and "them" is unset.

>l
Antenna Control
You float weightless at the port end of a cylinder. Through a surprisingly large window, you can see the station rotating around you, solar panels, and antennas, all backed by a spectacular field of stars.  Your hoe extends the short lever in the floor, and a yellow cable waves from a small control panel.

It is very cold and dark here in the near vacuum. An airlock door leads starboard.

>gonear red
(the red circuit breaker)
Platform 3
A platform about two thirds of the way towards the hub. You can continue spinward or antispinward.

You feel much lighter here, and you are very aware of how the station rotates, but everything is okay as long as you don't look down.

There is a red circuit breaker here.

>close breaker
It isn't something you can close.

* * *

>touch hatch
You feel nothing unexpected.

* * *

>version
Founder's Mercy
A Space Story by Thomas Insel
Release 1 / Serial number 181217 / Inform 7 build 6M62 (I6/v6.33 lib 6/12N) SD
Type ABOUT for credits or HINT for assistance.
Identification number: //BCC61E7F-CE8E-4C25-9E9D-5550D1138D8C//
Interpreter version 0.5.2 / VM 3.1.2 / Library serial number 080126
Standard Rules version 3/120430 by Graham Nelson
Plugs and Sockets version 4/170924 by Sean Turner
Object Response Tests version 7 by Juhana Leinonen
Real-Time Delays version 1/100607 by Erik Temple

>look
Home (on the blanket)
The room where you've slept your entire life. The crops are outside.

There is a secured hatch in the floor.

>about
About Founder's Mercy
This is my second released Inform project, conceived and implemented in the last months of 2018.

Thanks to Graham Nelson, Andrew Plotkin, Emily Short, and everyone else who contributed to the Inform and Glulx ecosystem. Thanks also Juhana Leinonen for the Object Response Tests extension, and Sean Turner for the Plugs and Sockets extension. Exit listing code is inspired by Eric Eve's Exit Lister. Keypad code is inspired by Emily Short's Computers.

The cover art is adapted from Figure 1.1 from NASA SP-413, Space Settlements: A Design Study, edited by Richard D. Johnson and Charles Holbrow, and available from The Internet Archive at https://archive.org/details/SpaceSettlementsADesignStudy1977 .

Please send your feedback, bug reports, and requests for help to tinsel@tinsel.org. You can always find the current version of this story at http://tinsel.org/IF/ .

This work is Copyright © 2019 Thomas Insel but may be freely shared according to the terms of the Creative Commons Attribution 4.0 International license (https://creativecommons.org/licenses/by/4.0/).

* * *

>x ceiling
You can't see any such thing.

>gonear handle
Airlock
There are port and starboard doors and a red handle.

>x handle
The handle extends from the wall and is labeled "Cycle."

>x ceiling
You can't see any such thing.

* * *

>x hatch
FIRST.

>d
(first getting off the blanket)
(first opening the floor hatch)

Cellar
Your decompression shelter and storage space for increasingly empty shelves of canned vegetables and one more large bag of split peas.

There is an open hatch in the ceiling.

* * *

>get peas
You take a handful of split peas.

>get vegetables
You take a jar of okra.

>i
You are carrying:
  a jar of okra
  a handful of split peas
  a scanner
  a green jumpsuit (being worn)

>out
But you aren't in anything at the moment.

>u
Home
The room where you've slept your entire life. The crops are outside.

There is an open hatch in the floor.

The homespun blanket which you use as your bed is arranged on the ground.

>out
Sector 4: Crops
Your home is here among the crops. To the port and starboard, the station walls rise up to the hub above. You can walk spinward or antispinward.

* * *

>asw
You walk a little ways to the next sector.

Sector 3: Forest
Trees, a house, and a church. A red pylon stretches up from the ground to the hub of the station. You can walk spinward or antispinward.

>x jar
You see nothing special about the jar of okra.

* * *

>x hatch
FIRST.

>x me
As virtuous as ever.

>x me
As virtuous as ever.

>showme me
yourself - person
    scanner
    green jumpsuit (worn)
        pocket (part of green jumpsuit) - open container
location: on the blanket in Home
singular-named, proper-named; unlit, inedible, portable; female
list grouping key: none
printed name: "yourself"
printed plural name: "people"
indefinite article: none
description: "As good-looking as ever."
initial appearance: none
carrying capacity: 5

>x hatch
The floor hatch is closed.

>showme hatch
floor hatch - floor hatch
location: in Home
singular-named, improper-named; unlit, inedible, fixed in place; closed, openable, unlocked
list grouping key: none
printed name: "floor hatch"
printed plural name: "floor hatches"
indefinite article: none
description: "The floor hatch is closed."
initial appearance: "There is a secured hatch in the floor."
other side: Cellar

>d
(first getting off the blanket)
(first opening the floor hatch)

Cellar
Your decompression shelter and storage space for increasingly empty shelves of canned vegetables and one more large bag of split peas.

There is an open hatch in the ceiling.

>showme
Cellar - room
    ceiling hatch - floor hatch
    yourself - person
        scanner
        green jumpsuit (worn)
            pocket (part of green jumpsuit) - open container
    shelves - supporter
        canned vegetables
        emergency mask
    large bag of split peas

>showme scanner
scanner - thing
location: carried by yourself in Cellar
singular-named, improper-named; unlit, inedible, portable, handled, machinelike, addressable; list grouping key: none
printed name: "scanner"
printed plural name: none
indefinite article: none
description: "The handheld voice-activated scanner you use when working on the station's machines."
initial appearance: none

>showme mask
emergency mask - thing
location: on the shelves in Cellar
singular-named, improper-named; unlit, inedible, portable, wearable, machinelike
list grouping key: none
printed name: "emergency mask"
printed plural name: none
indefinite article: none
description: "You wore this mask when there were regular decompression drills."
initial appearance: none

>showme vegetables
Which do you mean, the vegetables or the canned vegetables?

>canned
canned vegetables - thing
location: on the shelves in Cellar
plural-named, improper-named; unlit, inedible, fixed in place, scenery
list grouping key: none
printed name: "canned vegetables"
printed plural name: none
indefinite article: none
description: "Mostly tomatoes, green beans, carrots, and okra. Without a new source of salt or acid, too much of your recent harvest has been left to spoil."
initial appearance: none

>get vegetables
You take a jar of pickled okra.

>showme jar
(the jar of pickled okra)
jar of pickled okra - thing
location: carried by yourself in Cellar
singular-named, improper-named; unlit, inedible, portable, handled
list grouping key: none
printed name: "jar of pickled okra"
printed plural name: none
indefinite article: none
description: none
initial appearance: "It's a jar of pickled okra."

>restart
Are you sure you want to restart?

>yes
You awake. You are lonely, so lonely. It was a thousand days ago today. All alone these thousand days. Your parents were the last. No, your father was the last. He held on for nearly a hundred days longer. Now you are the last. Alone. Adrift.

But maybe it isn't hopeless. There must still be other people in other worlds, and you think you know how to get there.

Today is the day.

Founder's Mercy
A Space Story by Thomas Insel
Release 1 / Serial number 181218 / Inform 7 build 6M62 (I6/v6.33 lib 6/12N) SD
Type ABOUT for credits or HINT for assistance.

Home (on the blanket)
The room where you've slept your entire life. The crops are outside.

There is a secured hatch in the floor.

>showme mask
emergency mask - thing
location: on the shelves in Cellar
singular-named, improper-named; unlit, inedible, portable, wearable, machinelike
list grouping key: none
printed name: "emergency mask"
printed plural name: none
indefinite article: none
description: "You wore this mask when there were regular decompression drills."
initial appearance: none

* * *

>x me
As virtuous as ever.

>gonear plate
Pod Control
This room serves as an airlock for the pod bay, and holds an old space suit and various machinery such as the atmosphere pump. There is a brass plate on the wall.

There is a secured hatch in the ceiling.

Beside the secured port door, a status display shows an error message.

>x plate
    RWSS Founder's Mercy ๛
    Laid down 2138, Launched 2141.
    "May His mercy shine upon us."

>gonear yellow
Antenna Control
You float weightless at the port end of a cylinder. Through a surprisingly large window, you can see the station rotating around you, solar panels, and antennas, all backed by a spectacular field of stars.  A short lever extends from the floor, and a yellow cable waves from a small control panel.

It is very cold and dark here in the near vacuum. An airlock door leads starboard.

[Your score has just gone up by two points.]

>xyzzy
You say that word out loud. Your mother would never have approved. Even with no one to listen, it feels a little wrong.

* * *

>xyzzy
Once was enough.

>x widow
You can't see any such thing.

>x window
WINDOW.

>look
Antenna Control
You float weightless at the port end of a cylinder. Through a surprisingly large window, you can see the station rotating around you, solar panels, and antennas, all backed by a spectacular field of stars.  A short lever extends from the floor, and a yellow cable waves from a small control panel.

It is very cold and dark here in the near vacuum. An airlock door leads starboard.

>look through window
WINDOW.

>look out window
I only understood you as far as wanting to look outside.

* * *

>x yellow cable
You can't see any such thing.

>gonear yellow
Antenna Control
You float weightless at the port end of a cylinder. It is very cold and dark here in the near vacuum. A door leads starboard.

A short lever extends from the floor.

A yellow cable waves from a small panel.

You can also see a yellow cable floating here.

[Your score has just gone up by two points.]

>x yellow
A two meter yellow RF cable. It is not plugged into anything.

* * *

>yes
[To communicate in this story, type CHARACTER, MESSAGE where CHARACTER is someone or something and MESSAGE is what you want to say.]

>no
[To communicate in this story, type CHARACTER, MESSAGE where CHARACTER is someone or something and MESSAGE is what you want to say.]

>y
That was a rhetorical question.

>sorry
That's not a verb I recognize.

>gonear eraser
School House
A broken learning machine remains in a corner, but mostly the older farmers took turns leading the class. There is a desk, and a chalkboard hangs on one wall.

On the desk is a clean eraser.

>hit eraser
(first taking the clean eraser)
Nothing happens.

>clap eraser
That's not a verb I recognize.