You awake. You are lonely, so lonely. It was a thousand days ago today. All alone these thousand days. Your parents were the last. No, your father was the last. He held on for nearly a hundred days longer. Now you are the last. Alone. Adrift.

But maybe it isn't hopeless. There must still be other people in other worlds, and you think you know how to get there.

Today is the day.

Founder's Mercy
A Space Story by Thomas Insel
Release 1 / Serial number 181209 / Inform 7 build 6M62 (I6/v6.33 lib 6/12N) SD
Type "about" for credits or "hint" for assistance.

Home (on the blanket)
The room where you've slept your entire life. The crops are outside.

There is a secured hatch in the floor.

>* minimal walkthrough
(Noted.)

>d
(first getting off the blanket)
(first opening the floor hatch)

Cellar
Your decompression shelter and storage space for increasingly empty shelves of canned vegetables and one more large bag of split peas.

There is an open hatch in the ceiling.

>get mask
Taken.

>u
Home
The room where you've slept your entire life. The crops are outside.

There is an open hatch in the floor.

You can also see a blanket here.

>get blanket
Taken.

>out
Sector 4: Crops
Your home is here among the crops. You can walk spinward or antispinward.

>sw
You walk a little ways to the next sector.

Sector 5: Forest
The school house is nestled among the trees. A pylon stretches up from the same grove to the hub of the station. You can walk spinward or antispinward.

>in
School House
A broken learning machine remains in a corner, but mostly the older farmers took turns leading the class. There is a desk, and a chalkboard hangs on one wall.

On the desk is a clean eraser.

>get eraser
(putting the scanner into your pocket to make room)
Taken.

>erase board
(with the eraser)
You carefully erase the chalkboard.

>get power from machine
(putting the emergency mask into your pocket to make room)
Taken.

>out
Sector 5: Forest
The school house is nestled among the trees. A pylon stretches up from the same grove to the hub of the station. You can walk spinward or antispinward.

>sw
You walk a little ways to the next sector.

Sector 6: Hydroponics
Your people preferred to grow things the old fashioned way, but in truth the majority of your fruit and vegetables came from this sector when the machines still worked. You can walk spinward or antispinward.

There is a secured hatch in the ground.

>d
(first opening the floor hatch)

Supply Vault
This room is dim, quiet, and stuffy. There is still one crate of machine parts left.

There is an open hatch in the ceiling.

You can also see a pair of gravity boots here.

>search crate
You find a pressure regulation module.
(putting the dusty eraser into your pocket to make room)

>g
You find an instruction module.
(putting the power module into your pocket to make room)

>get boots
(putting the pressure regulation module into your pocket to make room)
Taken.

>hit eraser
(first taking the dusty eraser)
(putting the instruction module into your pocket to make room)
You fill the vault with a cloud of dust which scatters the laser beam that you can now see scanning across the hatch.

>u
You maneuver around the laser beam and pull yourself up through the ceiling hatch.

Sector 6: Hydroponics
Your people preferred to grow things the old fashioned way, but in truth the majority of your fruit and vegetables came from this sector when the machines still worked. You can walk spinward or antispinward.

There is an open hatch in the ground.

[Your score has just gone up by one point.]

>wear boots
You put on the pair of gravity boots.

>wear mask
(first taking the emergency mask)
You put on the emergency mask.

>asw
You walk a little ways to the next sector.

Sector 5: Forest
The school house is nestled among the trees. A pylon stretches up from the same grove to the hub of the station. You can walk spinward or antispinward.

>asw
You walk a little ways to the next sector.

Sector 4: Crops
Your home is here among the crops. You can walk spinward or antispinward.

>asw
You walk a little ways to the next sector.

Sector 3: Forest
Trees, a house, and a church. A red pylon stretches up from the ground to the hub of the station. You can walk spinward or antispinward.

>up
Wearing the boots, you are able to climb up the pylon. As you get closer to the hub, gravity decreases, and the climb becomes easier.

Platform 3
A mesh platform about two thirds of the way towards the hub. You can continue spinward or antispinward.

You feel much lighter here, and you are very aware of how the station rotates, but everything is okay as long as you don't look down.

There is a red circuit breaker here.

>turn breaker on
You reach out and switch the circuit breaker on.

[Your score has just gone up by one point.]

>d
You climb down the pylon.

Sector 3: Forest
Trees, a house, and a church. A red pylon stretches up from the ground to the hub of the station. You can walk spinward or antispinward.

>asw
You walk a little ways to the next sector.

Sector 2: Aquaculture
A deep pond with some fish. You can walk spinward or antispinward.

>enter pond
You set your belongings aside. With the air from the emergency mask, you breathe comfortably as you step into the pond. At the bottom, you find a valve and open it, then swim to the surface, climb out, and recover everything you were carrying.

[Your score has just gone up by two points.]

>remove mask
You take off the emergency mask.

>wear blanket
You put on the blanket.

>asw
You walk a little ways to the next sector.

Sector 1: Crops
You still maintain the crops here. There is a small graveyard and the barn remains from when this was the livestock sector. A pylon stretches up from the ground to the hub of the station. You can walk spinward or antispinward.

There is a secured hatch in the ground.

You have walked the entire ring. Everything is as expected, much is not working. Now, it's time to leave: the pods are below Sector 1.

>d
(first opening the floor hatch)

Pod Control
This room serves as an airlock for the pod bay, and holds an old space suit and various machinery such as the atmosphere pump. There is a brass plate on the wall.

There is an open hatch in the ceiling.

Beside the secured port door, a status display shows an error message.

>get all from pump
power module: Taken.
pressure regulation module: (putting the dusty eraser into your pocket to make room)
Taken.

>scan regulator
Module is faulty.

>scan unscanned regulator
Module is functional.

>put functional regulator in pump
(first taking the functional pressure regulation module)
(putting the emergency mask into your pocket to make room)
You put the functional pressure regulation module into the atmosphere pump.

>scan power module
Module is faulty.

>scan unscanned power module
Module is functional.

>put functional power module in pump
(first taking the functional power module)
You put the functional power module into the atmosphere pump.

The atmosphere pump begins to hum.

It is time to say goodbye to the station. You are ready to leave in a pod.

[Your score has just gone up by one point.]

>close ceiling hatch
You close the ceiling hatch.

>port
(first opening the bulkhead door)

Pod Bay
There are four berths for transit pods. Unfortunately, all are empty.

An open door leads starboard.

There is a pile of clutter. It looks like equipment removed to free up space in the transit pods.

This is troubling. You counted. You were sure there would be one pod left. There are none.

[Your score has just gone up by two points.]

>get communications unit
Taken.

>starboard
Pod Control
This room serves as an airlock for the pod bay, and holds an old space suit and various machinery such as the atmosphere pump. There is a brass plate on the wall.

Beside the open port door, a status display glows green.

There is a secured hatch in the ceiling.

>get functional power module
(putting the faulty power module into your pocket to make room)
Taken.

No pods left ... you consider despair.

>close door
You close the bulkhead door.

>u
(first opening the ceiling hatch)

Sector 1: Crops
You still maintain the crops here. There is a small graveyard and the barn remains from when this was the livestock sector. A pylon stretches up from the ground to the hub of the station. You can walk spinward or antispinward.

There is an open hatch in the ground.

So what if you can't escape in a pod. You will just need to bring a pod here. Time to get the communications module working.

>sw
You walk a little ways to the next sector.

Sector 2: Aquaculture
A deep pond with some fish. You can walk spinward or antispinward.

>sw
You walk a little ways to the next sector.

Sector 3: Forest
Trees, a house, and a church. A red pylon stretches up from the ground to the hub of the station. You can walk spinward or antispinward.

>go church
Church
Before everyone left or died, you celebrated every sabbath here. The altar stands against one wall, and an organ and a portable audio unit stand against the other.

On the altar is The Founder's Testament.

A gray cable connects the organ to the audio unit.

>unplug cable from organ
You unplug the gray cable from the organ.

>plug cable into comms unit
You plug the gray cable into the emergency communications unit.

>get power module from audio
(putting the faulty pressure regulation module into your pocket to make room)
Taken.

>put functional power into audio
You put the functional power module into the audio unit.

The audio unit beeps and a synthesized voice says "No antenna connection."

>get cable and audio
gray cable: Taken.
audio unit: (putting the unscanned power module into your pocket to make room)
Taken.

>out
Sector 3: Forest
Trees, a house, and a church. A red pylon stretches up from the ground to the hub of the station. You can walk spinward or antispinward.

>u
Wearing the boots, you are able to climb up the pylon. As you get closer to the hub, gravity decreases, and the climb becomes easier.

Platform 3
A mesh platform about two thirds of the way towards the hub. You can continue spinward or antispinward.

There is a red circuit breaker here.

>asw
Platform 1
A mesh platform about two thirds of the way towards the hub. You can continue spinward or antispinward, or go up a ladder into the hub.

>u
Gravity fades as you climb.

Inside the Hub
You float weightless in the middle of a cylinder. It is colder up here, and the light is all artifical but without an obvious source. A ladder rotates around you, leading up or down or maybe out, and you can continue port or starboard inside the hub.

>port
Port End
You float weightless at the port end of a cylinder. It is very cold and dark here.

A yellow cable waves from a small panel.

>plug yellow into comms
You plug the yellow cable into the emergency communications unit.

The audio unit beeps and a synthesized voice says "Comms ready."

After a moment, it says "Launching automatic routines."

[Your score has just gone up by two points.]

>z
Time passes.

You hear a human speaking from the audio unit: "RWSS Founder's Mercy, this is OV-4165, over...

"There's really somebody there? We thought your station had been abandoned for kilodays...

"Standby...

"We can have a pod there in about a thousand minutes."

    *** You are not alone. ***

In that game you scored 9 out of a possible 9, in 61 turns.

Would you like to RESTART, RESTORE a saved game, QUIT, or UNDO the last command?

>undo
Port End
[Previous turn undone.]

>i
You are carrying:
  an audio unit
  a gray cable (plugged into an emergency communications unit and an audio unit)
  an emergency communications unit
  a pair of gravity boots (being worn)
  a blanket (being worn)
  a green jumpsuit (being worn)

Your jumpsuit pocket contains:
  an unscanned power module
  a faulty pressure regulation module
  a faulty power module
  an emergency mask
  a dusty eraser
  an unscanned instruction module
  a scanner

You hear a human speaking from the audio unit: "RWSS Founder's Mercy, this is OV-4272, over...

"There's really somebody there? We thought your station had been abandoned for kilodays...

"Standby...

"We can have a pod there in about a thousand minutes."

    *** You are not alone. ***

In that game you scored 9 out of a possible 9, in 61 turns.

Would you like to RESTART, RESTORE a saved game, QUIT, or UNDO the last command?

>undo
Port End
[Previous turn undone.]

>undo
Port End
[Previous turn undone.]

>i
You are carrying:
  an audio unit
  a gray cable (plugged into an emergency communications unit and an audio unit)
  an emergency communications unit
  a pair of gravity boots (being worn)
  a blanket (being worn)
  a green jumpsuit (being worn)

Your jumpsuit pocket contains:
  an unscanned power module
  a faulty pressure regulation module
  a faulty power module
  an emergency mask
  a dusty eraser
  an unscanned instruction module
  a scanner

>actions
Actions listing on.

>put audio in pockt
You can't see any such thing.

>put audio in pocket
[inserting the audio unit into the pocket]
You put the audio unit into the pocket.
[inserting the audio unit into the pocket - succeeded]

* * *

>erase board
(with the eraser)
You carefully erase the chalkboard.

>i
You are carrying:
  a dusty eraser
  an emergency mask
  a scanner
  a green jumpsuit (being worn)

Your jumpsuit pocket contains:
  a blanket

>showme blanket
blanket - supporter
location: in the pocket , which is part of the green jumpsuit worn by yourself in School House
singular-named, improper-named; unlit, inedible, portable, wearable, handled, bulky; enterable
list grouping key: none
printed name: "blanket"
printed plural name: "supporters"
indefinite article: none
description: "Homespun wool."
initial appearance: none
carrying capacity: 100

* * *

>* scratch
(Noted.)

>d
(first opening the floor hatch)

Cellar
Your decompression shelter and space for some increasingly empty shelves of canned vegetables.

There is an open hatch in the ceiling.

>get mask
Taken.

>x mask
You wore this mask when there were regular decompression drills.

>u
Home
The room where you've slept your entire life. You can go out to your crops.

There is an open hatch in the floor.

>out
Sector 4: Crops
Your home is here among the crops. You can walk spinward or antispinward.

* * *

>in
School House
A broken learning machine remains in a corner, but mostly the older farmers took turns leading the class. There is a desk, and a chalkboard hangs on one wall.

On the desk is a clean eraser.

>get eraser
Taken.

>x machine
This last learning machine broke when you were maybe three thousand days old. It contains a power module and an instruction module.

>get power from machine
(putting the scanner into your pocket to make room)
Taken.

>x machine
This last learning machine broke when you were maybe three thousand days old. It contains an instruction module as well as space for one more module.

* * *

>* scratch
(Noted.)

>x crops
You can't see any such thing.

>out
Sector 4: Crops
Your home is here among the crops. You can walk spinward or antispinward.

>ne
You have heard of compass directions like northeast, but they don't make any sense here. Instead, you can go spinward, antispinward, port, and starboard. When you look spinward, port is left and starboard is right.

[You can use the abbreviations "sw", "asw", "p", and "s". You can also go "up", "down", "in", and "out" where appropriate. Type "exits" if you get confused about geography.]

>sw
You walk a little ways to the next sector.

Sector 5: Forest
The school house is nestled among the trees. A pylon stretches up from the same grove to the hub of the station. You can walk spinward or antispinward.

>in
School
A broken learning machine remains in a corner, but mostly the older farmers took turns leading the class. There is a desk, and a chalkboard hangs on one wall.

On the desk is a clean eraser.

>out
Sector 5: Forest
The school house is nestled among the trees. A pylon stretches up from the same grove to the hub of the station. You can walk spinward or antispinward.

* * *

>sw
You walk a little ways to the next sector.

Sector 6: Hydroponics
Your people preferred to grow things the old fashioned way, but in truth the majority of your fruit and vegetables came from this sector when the machines still worked. You can walk spinward or antispinward.

There is a secured hatch in the ground.

>sw
You walk a little ways to the next sector.

Sector 1: Crops
You still maintain the crops here. There is a small graveyard and the barn remains from when this was the livestock sector. A pylon stretches up from the ground to the hub of the station. You can walk spinward or antispinward.

There is a secured hatch in the ground.

>x crops
You are proud of the grain and legumes.

>x barn
A single story barn.

>in
Barn
Not fancy: livestock on one side and feed on the other, but nothing remains of either. There is a plow near the entrance.

>x plow
A steel walking plow.

>push plow
This plow is too heavy to move around without purpose.

>push plow north
You have heard of compass directions like north, but they don't make any sense here. Instead, you can go spinward, antispinward, port, and starboard. When you look spinward, port is left and starboard is right.

>x Mjkjskdf
You can't see any such thing.

>scanner, scan Mmmsdf
Search error: cannot find Mmmsdf.
[You can ask the scanner for a list of commands by typing "scanner, help" and give it voice commands by typing phrases such as "scanner, scan SOMETHING" or "scanner, open SOMETHING" where SOMETHING is a visible object.]

>purloin boots
[Purloined.]

>wear boots
You put on the pair of gravity boots.

>look
Barn
Not fancy: livestock on one side and feed on the other, but nothing remains of either. There is a plow near the entrance.

>out
Sector 1: Crops
You still maintain the crops here. There is a small graveyard and the barn remains from when this was the livestock sector. A pylon stretches up from the ground to the hub of the station. You can walk spinward or antispinward.

There is a secured hatch in the ground.

>sw
You walk a little ways to the next sector.

Sector 2: Aquaculture
A deep pond is used as part of the water filtration system and for raising fish. You can walk spinward or antispinward.

>sw
You walk a little ways to the next sector.

Sector 3: Forest
Trees, a house, and a church. A red pylon stretches up from the ground to the hub of the station. You can walk spinward or antispinward.

You have walked the entire ring. Everything is as expected, much is not working. Now, it's time to leave: the pods are below Sector 1.

>climb tree
Trees aren't magnetized, so the boots won't help.

* * *

>about
About Founder's Mercy
Founder's Mercy is my second released Inform project, conceived and implemented in November of 2018.

Thanks to Graham Nelson, Andrew Plotkin, Emily Short, and everyone else who contributed to the Inform and Glulx ecosystem. Thanks also Juhana Leinonen for the Object Response Tests extension, and Sean Turner for the Plugs and Sockets extension. Exit listing code is inspired by Eric Eve's Exit Lister. The cover art is adapted from Figure 1.1 from NASA SP-413, Space Settlements: A Design Study, edited by Richard D. Johnson and Charles Holbrow, and available from The Internet Archive at https://archive.org/details/SpaceSettlementsADesignStudy1977 .

Please send your feedback, bug reports, and requests for help to tinsel@tinsel.org. You can always find the current version of this story at http://tinsel.org/IF/ .

This work is Copyright  2018 Thomas Insel but may be freely shared according to the terms of the Creative Commons Attribution 4.0 International license (https://creativecommons.org/licenses/by/4.0/).

>d
(first opening the floor hatch)

Cellar
Your decompression shelter and space for some increasingly empty shelves of canned vegetables.

There is an open hatch in the ceiling.

>u
Home
The room where you've slept your entire life. You can go out towards the crops.

There is an open hatch in the floor.

>exits
The exits are down to the cellar and outside to sector 4.

>exits off
I only understood you as far as wanting to exits.

>s
You can't go that way. The exits are down to the cellar and outside to sector 4.

* * *

>act
That's not a verb I recognize.

>jskdjfks
That's not a verb I recognize.

* * *

>actions
Actions listing on.

>look down
[examining down]
You see nothing unexpected in that direction.

[examining down - succeeded]

>look up
[examining up]
You see nothing unexpected in that direction.

[examining up - succeeded]

* * *

>actions
Actions listing on.

>out
[exiting]
[(1) going outside]

Sector 4: Crops
Your home is here among the crops. You can walk spinward or antispinward.

[(1) going outside - succeeded]

[exiting - succeeded]

>asw
[going antispinward]
You walk a little ways to the next sector.

Sector 3: Forest
Trees, a house, and a church. A red pylon stretches up from the ground to the hub of the station. You can walk spinward or antispinward.

[going antispinward - succeeded]

>u
[going up]
[(1) climbing the pylon]
The red pylon is designated for climbing, but you can't get a grip.
[(1) climbing the pylon - failed]

[going up - failed]

>purloin books
There seems to be no such object anywhere in the model world.

>purloin boots
[Purloined.]

>wear boots
[wearing the pair of gravity boots]
You put on the pair of gravity boots.
[wearing the pair of gravity boots - succeeded]

>u
[going up]
[(1) climbing the pylon]
It isn't easy, but with the boots, you make a long climb towards the hub.

[(2) looking]
Platform 3
A mesh platform about two thirds of the way towards the hub. You can continue spinward or antispinward.

You feel much lighter here, and you are very aware of how the station rotates, but everything is okay as long as you don't look down.

There is a red circuit breaker here.

[(2) looking - succeeded]

[(1) climbing the pylon - failed]

[going up - failed]

* * *

>actions
Actions listing on.

>remove jumpsuit
[taking off the green jumpsuit]
Your nudity is pure and innocent, but still a little cold and uncomfortable.
[taking off the green jumpsuit - succeeded]

* * *

>ask fnord
[To communicate in this story, type "CHARACTER, MESSAGE" where CHARACTER is someone or something and MESSAGE is what you want to say.]

>look at me
As virtuous as ever.

>yes
That was a rhetorical question.

>no
That was a rhetorical question.

* * *

>ask me for jkjk
[To communicate in this story, type "CHARACTER, MESSAGE" where CHARACTER is someone or something and MESSAGE is what you want to say.]

>ask me for shirt
[To communicate in this story, type "CHARACTER, MESSAGE" where CHARACTER is someone or something and MESSAGE is what you want to say.]

>ask me for scanner
[To communicate in this story, type "CHARACTER, MESSAGE" where CHARACTER is someone or something and MESSAGE is what you want to say.]

>me, scanner
That's not a verb I recognize.

* * *

>ask scanner about me
[To communicate in this story, type "CHARACTER, MESSAGE" where CHARACTER is someone or something and MESSAGE is what you want to say.]

>g
[To communicate in this story, type "CHARACTER, MESSAGE" where CHARACTER is someone or something and MESSAGE is what you want to say.]

>g
[To communicate in this story, type "CHARACTER, MESSAGE" where CHARACTER is someone or something and MESSAGE is what you want to say.]

>tell scanner about me
[To communicate in this story, type "CHARACTER, MESSAGE" where CHARACTER is someone or something and MESSAGE is what you want to say.]

>g
[To communicate in this story, type "CHARACTER, MESSAGE" where CHARACTER is someone or something and MESSAGE is what you want to say.]

>scanner, me
Syntax error: command not in vocabulary.

[You can ask the scanner for a list of commands by typing "scanner, help" and give it voice commands by typing phrases such as "scanner, scan SOMETHING" or "scanner, open SOMETHING" where SOMETHING is a visible object.]

>scanner, help
Recognized commands are "help", "open", and "scan".

[You can ask the scanner for a list of commands by typing "scanner, help" and give it voice commands by typing phrases such as "scanner, scan SOMETHING" or "scanner, open SOMETHING" where SOMETHING is a visible object.]

>talk to scanner
That's not a verb I recognize.

>say open hatch
[To communicate in this story, type "CHARACTER, MESSAGE" where CHARACTER is someone or something and MESSAGE is what you want to say.]

* * *

>climb down
(first opening the floor hatch)

Cellar
Your decompression shelter and space for some increasingly empty shelves of canned vegetables.

There is an open hatch in the ceiling.

You must name something more substantial.

>climb up
Home
The room where you've slept your entire life. You can go out towards the crops.

There is an open hatch in the floor.

You must name something more substantial.

>g
You can't go that way. The obvious exits are down (to cellar) and outside.

You must name something more substantial.

>g
You can't go that way. The obvious exits are down (to cellar) and outside.

You must name something more substantial.

* * *

>climb up
You can't go that way. The obvious exits are down and outside.

>climb dow
You can't see any such thing.

>climb dowb
You can't see any such thing.

>climb down
You must name something more substantial.

>actions
Actions listing on.

>climb down
[climbing down]
You must name something more substantial.
[climbing down - failed the basic accessibility rule]

* * *

>climb up
You can't go that way. The obvious exits are down and outside.

>d
(first opening the floor hatch)

Cellar
Your decompression shelter and space for some increasingly empty shelves of canned vegetables.

There is an open hatch in the ceiling.

>climb u
Home
The room where you've slept your entire life. You can go out towards the crops.

There is an open hatch in the floor.

* * *

>d
(first opening the floor hatch)

Cellar
Your decompression shelter and storage space for increasingly empty shelves of canned vegetables and one more large bag of split peas.

There is an open hatch in the ceiling.

>climb shelves
There is no chance they would support your weight.

>i
You are carrying:
  a scanner
  a green jumpsuit (being worn)

>put scanner on shelf
You put the scanner on the shelves.

>search shelf
Almost a hundred jars of canned vegetables are on the makeshift shelves that line the wall. So is your emergency mask.

On the shelves is a scanner.

>x shelves
Almost a hundred jars of canned vegetables are on the makeshift shelves that line the wall. So is your emergency mask.

On the shelves is a scanner.

>clear
(the green jumpsuit)
Nothing obvious happens.

I beg your pardon?

I beg your pardon?

>actions
Actions listing on.

>clear shelf
[pushing the shelves]
They are fixed in place.
[pushing the shelves - failed the can't push what's fixed in place rule]

>push shelves
[pushing the shelves]
They are fixed in place.
[pushing the shelves - failed the can't push what's fixed in place rule]

>pull shelves
[pulling the shelves]
They are fixed in place.
[pulling the shelves - failed the can't pull what's fixed in place rule]

>rtree
[listing the tree]
Barn
    the plow
Cellar
    yourself + green jumpsuit and pocket 
    the shelves + canned vegetables, emergency mask, and scanner 
Center Platform
    the red circuit breaker
Church
    the altar + Founder's Testament 
    the organ & tan socket
    the audio unit + power module & beige socket
    the gray cable & usb plug and usb plug
Home
House
    the doll
Pod Bay
    the berths
    the emergency communications unit & almond socket
Pod Control
    the space suit
    the brass plate
    the status display
    the atmosphere pump + power module and pressure regulation module 
School
    the learning machine + instruction module and power module 
    the desk + clean eraser 
    the chalkboard
Sector 1: Crops
    the pylon
    the crops
    the graveyard
Sector 2: Aquaculture
    the pond
    the fish
Sector 3: Forest
    the pylon
    the trees
Sector 4: Crops
    the vegetables
Sector 5: Forest
    the pylon
    the trees
Sector 6: Hydroponics
    the hydroponics machines
Supply Vault
    the crate of machine parts
    the pair of gravity boots
[listing the tree - succeeded]

* * *

>d
(first opening the floor hatch)

Cellar
Your decompression shelter and storage space for increasingly empty shelves of canned vegetables and one more large bag of split peas.

There is an open hatch in the ceiling.

>drop here
You can't see any such thing.

>drop cellar
You can't see any such thing.

>drop me
You lack the dexterity.

>exits
The only exit is up to your home.

>drop home
You can't see any such thing.

>drop door
You can't see any such thing.

>drop hatch
The ceiling hatch is already here.

>drop peas
That's not where your attention belongs just now.

>x shelf
Almost a hundred jars of canned vegetables are on the makeshift shelves that line the wall. So is your emergency mask.

>climb shelf
There is no chance they would support your weight.

>x mask
You wore this mask when there were regular decompression drills.

>get mask
Taken.

>i
You are carrying:
  an emergency mask
  a scanner
  a green jumpsuit (being worn)

>put mask on shelf
You put the emergency mask on the shelves.

>look
Cellar
Your decompression shelter and storage space for increasingly empty shelves of canned vegetables and one more large bag of split peas.

There is an open hatch in the ceiling.

On the shelves is an emergency mask.

>i
You are carrying:
  a scanner
  a green jumpsuit (being worn)

>x shelves
Almost a hundred jars of canned vegetables are on the makeshift shelves that line the wall.

On the shelves is an emergency mask.

>out
But you aren't in anything at the moment.

>u
Home
The room where you've slept your entire life. You can go out to your crops.

There is an open hatch in the floor.

>sw
You can't go spinward, but you can go down to the cellar or outside to sector 4.

>out
Sector 4: Crops
Your home is here among the crops. You can walk spinward or antispinward.

* * *

>d
(first opening the floor hatch)

Cellar
Your decompression shelter and storage space for increasingly empty shelves of canned vegetables and one more large bag of split peas.

There is an open hatch in the ceiling.

>get bags
You can't see any such thing.

>get bag
You aren't hungry.

>push bag
That's not where your attention belongs just now.

>look
Cellar
Your decompression shelter and storage space for increasingly empty shelves of canned vegetables and one more large bag of split peas.

There is an open hatch in the ceiling.

>look
Cellar
Your decompression shelter and storage space for increasingly empty shelves of canned vegetables and one more large bag of split peas.

There is an open hatch in the ceiling.

>x shelf
Almost a hundred jars of canned vegetables are on the makeshift shelves that line the wall. So is your emergency mask.

>x mask
You wore this mask when there were regular decompression drills.

>analyze bag
That's not where your attention belongs just now.

>analyze
What do you want to analyze?

>bag
That's not where your attention belongs just now.

* * *

>d
(first opening the floor hatch)

Cellar
Your decompression shelter and storage space for increasingly empty shelves of canned vegetables and one more large bag of split peas.

There is an open hatch in the ceiling.

>get mask
Taken.

>wear mask
You put on the emergency mask.

>scan
You can't talk to the scanner while wearing the mask.

>drop scanner
Dropped.

>scan
You can't talk to the scanner while wearing the mask.

>u
Home
The room where you've slept your entire life. You can go out towards the crops.

There is an open hatch in the floor.

>scan
You can't talk to the scanner while wearing the mask.

>scanner, help
Recognized commands are "help", "open", and "scan".

[You can ask the scanner for a list of commands by typing "scanner, help" and give it voice commands by typing phrases such as "scanner, scan SOMETHING" or "scanner, open SOMETHING" where SOMETHING is a visible object.]

* * *

>wear mask
You put on the emergency mask.

>sing
You can't sing with the mask on.

>scan
You can't talk to the scanner while wearing the mask.

* * *

>d
(first opening the floor hatch)

Cellar
Your decompression shelter and storage space for increasingly empty shelves of canned vegetables and one more large bag of split peas.

There is an open hatch in the ceiling.

>gonear yellow
Inside the Hub
You float weightless in the middle of a cylinder. A ladder rotates around you, leading up or down or maybe out.

A yellow cable flaps from a small panel.

>d
*** Couldn't remove: the value yourself was not present in the list {ladder, panel} ***

*** Run-time problem P50: Attempt to use list item which does not exist.

"L" = list of things: {ladder, panel}
You feel that you shouldn't leave the panel behind in case it floats off.

* * *

>d
(first opening the floor hatch)

Cellar
Your decompression shelter and storage space for increasingly empty shelves of canned vegetables and one more large bag of split peas.

There is an open hatch in the ceiling.

>l
Cellar
Your decompression shelter and space for some increasingly empty shelves of canned vegetables.

There is an open hatch in the ceiling.

>u
Home
The room where you've slept your entire life. You can go out towards the crops.

There is an open hatch in the floor.

* * *

>d
(first opening the floor hatch)

Cellar
Your decompression shelter and storage space for increasingly empty shelves of canned vegetables and one more large bag of split peas.

There is an open hatch in the ceiling.

>look
Cellar
Your decompression shelter and space for some increasingly empty shelves of canned vegetables.

There is an open hatch in the ceiling.

>u
Home
The room where you've slept your entire life. You can go out towards the crops.

There is an open hatch in the floor.

>sw
You can't go that way. The exits are down to the cellar and outside to sector 4.

>out
Sector 4: Crops
Your home is here among the crops. You can walk spinward or antispinward.

* * *

>d
(first opening the floor hatch)

Cellar
Your decompression shelter and storage space for increasingly empty shelves of canned vegetables and one more large bag of split peas.

There is an open hatch in the ceiling.

>taste hatch
You taste nothing unexpected.

>taste vegetables
You aren't hungry.

>port
You can't go that way. The only obvious exit is up (to home).

>port
You can't go that way. The only obvious exit is up (to home).

>drop all
scanner: Dropped.

>wear scanner
(first taking the scanner)
You can't wear that!

>i
You are carrying:
  a scanner
  a green jumpsuit (being worn)

>use scanner
That's not a verb I recognize.

* * *

>d
(first opening the floor hatch)

Cellar
Your decompression shelter and storage space for increasingly empty shelves of canned vegetables and one more large bag of split peas.

There is an open hatch in the ceiling.

>u
Home
The room where you've slept your entire life. You can go out towards the crops.

There is an open hatch in the floor.

>d
Cellar
Your decompression shelter and space for some increasingly empty shelves of canned vegetables.

There is an open hatch in the ceiling.

>close hatch
You close the ceiling hatch.

>u
(first opening the ceiling hatch)

Home
The room where you've slept your entire life. You can go out towards the crops.

There is an open hatch in the floor.

>look
Home
The room where you've slept your entire life. You can go out towards the crops.

There is an open hatch in the floor.

* * *

>d
Cellar
Your decompression shelter and space for some increasingly empty shelves of canned vegetables.

There is an open hatch in the ceiling.

>e
You have heard of compass directions like east, but they don't make any sense here. Instead, you can go spinward, antispinward, port, and starboard. When you look spinward, port is left and starboard is right.

[You can use the abbreviations "sw", "asw", "p", and "s". You can also go "up", "down", "in", and "out" where appropriate. Type "exits" if you get confused about geography.]

>goto church
That's not a verb I recognize.

>gonear church
(Church)
Church
Before everyone left or died, you celebrated every sabbath here. The altar stands against one wall, and an organ and a portable audio unit stand against the other.

On the altar is The Founder's Testament.

A gray cable connects the organ to the audio unit.

>get cable
Taken.

>out
The gray cable disconnects from the organ.
The gray cable disconnects from the audio unit.

Sector 3: Forest
Trees, a house, and a church. A red pylon stretches up from the ground to the hub of the station. You can walk spinward or antispinward.

>undo
Church
[Previous turn undone.]

>i
You are carrying:
  a gray cable (plugged into the organ and an audio unit)
  a scanner
  a green jumpsuit (being worn)

>in
The only exit is outside to sector 3.

>i
You are carrying:
  a gray cable (plugged into the organ and an audio unit)
  a scanner
  a green jumpsuit (being worn)

>out
The gray cable disconnects from the organ.
The gray cable disconnects from the audio unit.

Sector 3: Forest
Trees, a house, and a church. A red pylon stretches up from the ground to the hub of the station. You can walk spinward or antispinward.

* * *

>exits
The exits are down to the cellar and outside to sector 4.

>out
Sector 4: Crops
Your home is here among the crops. You can walk spinward or antispinward.

* * *

>d
(first opening the floor hatch)

Cellar
Your decompression shelter and storage space for increasingly empty shelves of canned vegetables and one more large bag of split peas.

There is an open hatch in the ceiling.

>x bag
Legumes are your best remaining source of protein.

>open bag
You aren't hungry.

>get bag
You aren't hungry.

* * *

>d
(first opening the floor hatch)

Cellar
Your decompression shelter and storage space for increasingly empty shelves of canned vegetables and one more large bag of split peas.

There is an open hatch in the ceiling.

>x me
As virtuous as ever.

* * *

>d
(first opening the floor hatch)

Cellar
Your decompression shelter and storage space for increasingly empty shelves of canned vegetables and one more large bag of split peas.

There is an open hatch in the ceiling.

>x peas
Legumes are your best remaining source of protein.

>get peas
You aren't hungry.

* * *

>x peas
Legumes are your best remaining source of protein.

>x shelves
Almost a hundred jars of canned vegetables are on the makeshift shelves that line the wall. So is your emergency mask.

>get all
There are none at all available!

>look
Cellar
Your decompression shelter and storage space for increasingly empty shelves of canned vegetables and one more large bag of split peas.

There is an open hatch in the ceiling.

>get all from shelf
There are none at all available!

>x shelf
Almost a hundred jars of canned vegetables are on the makeshift shelves that line the wall. So is your emergency mask.

* * *

>d
(first opening the floor hatch)

Cellar
Your decompression shelter and storage space for increasingly empty shelves of canned vegetables and one more large bag of split peas.

There is an open hatch in the ceiling.

>x shelves
Almost a hundred jars of canned vegetables are on the makeshift shelves that line the wall. So is your emergency mask.

>search shelves
Almost a hundred jars of canned vegetables are on the makeshift shelves that line the wall. So is your emergency mask.

>analyze shelves
examining the shelves:
Almost a hundred jars of canned vegetables are on the makeshift shelves that line the wall. So is your emergency mask.

looking under the shelves:
You find nothing of interest.

searching the shelves:
Almost a hundred jars of canned vegetables are on the makeshift shelves that line the wall. So is your emergency mask.

listening to the shelves:
You hear nothing unexpected.

smelling the shelves:
You smell nothing unexpected.

attacking the shelves:
The Founder said that violence is never the answer.

buying the shelves:
Nothing is on sale.

climbing the shelves:
There is not chance they would support your weight.

pulling the shelves:
They are fixed in place.

pushing the shelves:
They are fixed in place.

turning the shelves:
They are fixed in place.

pushing the shelves to up:
The shelves cannot be pushed from place to place.

opening the shelves:
They aren't something you can open.

entering the shelves:
They're not something you can enter.

getting off the shelves:
But you aren't on the shelves at the moment.

closing the shelves:
They aren't something you can close.

taking the shelves:
They're hardly portable.

switching on the shelves:
They aren't something you can switch.

switching off the shelves:
They aren't something you can switch.

wearing the shelves:
(first taking the shelves)
They're hardly portable.

taking off the shelves:
You aren't wearing the shelves.

touching the shelves:
You feel nothing unexpected.

rubbing the shelves:
You rub the shelves.

waving the shelves:
But you aren't holding those.

squeezing the shelves:
You achieve nothing by this.

burning the shelves:
There is no open flame on the station.

cutting the shelves:
The Founder said that violence is never the answer.

tying the shelves to yourself:
You would achieve nothing by this.

swinging the shelves:
There's nothing sensible to swing here.

tasting the shelves:
You taste nothing unexpected.

drinking the shelves:
There's nothing suitable to drink here.

eating the shelves:
They're plainly inedible.

dropping the shelves:
The shelves are already here.

>climb shelves
There is not chance they would support your weight.

* * *

>d
(first opening the floor hatch)

Cellar
Your decompression shelter and storage space for increasingly empty shelves of canned vegetables and one more large bag of split peas.

There is an open hatch in the ceiling.

>x vegetables
Mostly tomatoes, green beans, carrots, and okra. Without a new source of salt or acid, too much of your recent harvest has been left to spoil.

>open cans
You can't see any such thing.

>open vegetables
You aren't hungry.

>open jars
You aren't hungry.

>open bottles
You can't see any such thing.

* * *

>dro hatch
That's not a verb I recognize.

>drop hatch
floor hatch is already here.

* * *

>drop hatch
The floor hatch is already here.

>gonear comms
Pod Bay
There are four berths for transit pods. Sadly, all are empty.

A secured hatch leads starboard.

Someone left an emergency communications unit on the floor.

This is troubling. You counted. You were sure there would be one pod left. There are none.

[Your score has just gone up by two points.]

>drop hatch
The wall hatch is already here.

>brief
Founder's Mercy is now in its "brief" printing mode, which gives long descriptions of places never before visited and short descriptions otherwise.

>look
Pod Bay
There are four berths for transit pods. Sadly, all are empty.

A secured hatch leads starboard.

Someone left an emergency communications unit on the floor.

>n
You have heard of compass directions like north, but they don't make any sense here. Instead, you can go spinward, antispinward, port, and starboard. When you look spinward, port is left and starboard is right.

[You can use the abbreviations "sw", "asw", "p", and "s". You can also go "up", "down", "in", and "out" where appropriate. Type "exits" if you get confused about geography.]

No pods left ... you consider despair.

>e
You have heard of compass directions like east, but they don't make any sense here. Instead, you can go spinward, antispinward, port, and starboard. When you look spinward, port is left and starboard is right.

>w
You have heard of compass directions like west, but they don't make any sense here. Instead, you can go spinward, antispinward, port, and starboard. When you look spinward, port is left and starboard is right.

So what if you can't escape in a pod. You will just need to bring a pod here. Time to get the communications module working.

>gonear red
(the red circuit breaker)
Center Platform
It's a mesh platform a little below the hub. You feel much lighter here, and you are very aware of how the station rotates, but everything is okay as long as you don't look down.

You can just reach a red circuit breaker on the hub.

>d
You slide down the pylon.

Sector 3: Forest
Trees, a house, and a church. A red pylon stretches up from the ground to the hub of the station. You can walk spinward or antispinward.

>sw
You walk a little ways to the next sector.

Sector 4: Crops
Your home is here among the crops. You can walk spinward or antispinward.

>in
Home
There is a secured hatch in the floor.

>look
Home
The room where you've slept your entire life. You can go out towards the crops.

There is a secured hatch in the floor.

>verbose
Founder's Mercy is now in its "verbose" mode, which always gives long descriptions of locations (even if you've been there before).

>rtree
Barn
    the plow
Cellar
    the shelves + canned vegetables and emergency mask 
Center Platform
    the red circuit breaker
Church
    the altar + Founder's Testament 
    the organ & tan socket
    the audio unit + power module & beige socket
    the gray cable & usb plug and usb plug
Home
    yourself + green jumpsuit, pocket, and scanner 
House
    the doll
Pod Bay
    the berths
    the emergency communications unit & almond socket
Pod Control
    the space suit
    the brass plate
    the status display
    the atmosphere pump + power module and pressure regulation module 
School
    the learning machine + instruction module and power module 
    the desk + clean eraser 
    the chalkboard
Sector 1: Crops
    the pylon
    the crops
    the graveyard
Sector 2: Aquaculture
    the pond
    the fish
Sector 3: Forest
    the pylon
    the trees
Sector 4: Crops
    the vegetables
Sector 5: Forest
    the pylon
    the trees
Sector 6: Hydroponics
    the hydroponics machines
Supply Vault
    the crate of machine parts
    the pair of gravity boots
(Nowhere)
    the green circuit breaker
    the instruction module
    the junk repository
    the laser beam
    the light-meter
    the pressure regulation module

* * *

>drop scanner
Dropped.

>look
Home
The room where you've slept your entire life. You can go out towards the crops.

There is a secured hatch in the floor.

You can also see a scanner here.

>get scanner
Taken.

>gonear adder
There seems to be no such object anywhere in the model world.

>gonear ladder
Platform 1
A mesh platform about two thirds of the way towards the hub. You can continue spinward or antispinward, or go up a ladder into the hub.

I beg your pardon?

>u
Inside the Hub
You are weightless, so instead of up and down, you think of the ladder as leading "out."

>drop scanner
Dropped.

>look
Inside the Hub
You are weightless, so instead of up and down, you think of the ladder as leading "out."

You can see a scanner floating here.

>d
You struggle a little to make sure you are heading legs first and follow the ladder.

Platform 1
A mesh platform about two thirds of the way towards the hub. You can continue spinward or antispinward, or go up a ladder into the hub.

>u
Inside the Hub
You are weightless, so instead of up and down, you think of the ladder as leading "out."

You can see a scanner here.

>l
Inside the Hub
You are weightless, so instead of up and down, you think of the ladder as leading "out."

You can see a scanner floating here.

* * *

>drop scanner
Dropped.

>scanner, help
You must be carrying the scanner to use it.

>d
(first opening the floor hatch)

Cellar
Your decompression shelter and space for some increasingly empty shelves of canned vegetables.

There is an open hatch in the ceiling.

>scanner, help
You seem to want to talk to someone, but I can't see whom.

>u
Home
The room where you've slept your entire life. You can go out towards the crops.

There is an open hatch in the floor.

You can also see a scanner here.

>scanner, help
Recognized commands are "help", "open", and "scan".

[You can ask the scanner for a list of commands by typing "scanner, help" and give it voice commands by typing phrases such as "scanner, scan SOMETHING" or "scanner, open SOMETHING" where SOMETHING is a visible object.]

>d
Cellar
Your decompression shelter and space for some increasingly empty shelves of canned vegetables.

There is an open hatch in the ceiling.

>scan
That makes no sense without a scanner.

* * *

>scanner, help
You must be carrying the scanner to use it.

>get scanner
Taken.

>scanner, help
Alway fail.

>drop scanner
Dropped.

>d
(first opening the floor hatch)

Cellar
Your decompression shelter and space for some increasingly empty shelves of canned vegetables.

There is an open hatch in the ceiling.

* * *

>exits
The exits are down to the cellar and outside to sector 4.

>about
About Founder's Mercy
Founder's Mercy is my second released Inform project, conceived and implemented in November of 2018.

Thanks to Graham Nelson, Andrew Plotkin, Emily Short, and everyone else who contributed to the Inform and Glulx ecosystem. Thanks also to Eric Eve for the Exit Lister extension, Juhana Leinonen for the Object Response Tests extension, and Sean Turner for the Plugs and Sockets extension. The cover art is adapted from Figure 1.1 from NASA SP-413, Space Settlements: A Design Study, edited by Richard D. Johnson and Charles Holbrow, and available from The Internet Archive at https://archive.org/details/SpaceSettlementsADesignStudy1977 .

Please send your feedback, bug reports, and requests for help to tinsel@tinsel.org. You can always find the current version of this story at http://tinsel.org/IF/ .

This work is Copyright  2018 Thomas Insel but may be freely shared according to the terms of the Creative Commons Attribution 4.0 International license (https://creativecommons.org/licenses/by/4.0/).

>version
Founder's Mercy
A Space Story by Thomas Insel
Release 1 / Serial number 181201 / Inform 7 build 6M62 (I6/v6.33 lib 6/12N) SD
Type "about" for credits or "hint" for assistance.
Identification number: //BCC61E7F-CE8E-4C25-9E9D-5550D1138D8C//
Interpreter version 0.5.2 / VM 3.1.2 / Library serial number 080126
Standard Rules version 3/120430 by Graham Nelson
Unicode Character Names by Graham Nelson
Simple Exit Lister version 1 by Thomas Insel
Plugs and Sockets version 4/170924 by Sean Turner
Object Response Tests version 7 by Juhana Leinonen

* * *

>exits
The exits are down to the cellar and outside to sector 4.

>d
(first opening the floor hatch)

Cellar
Your decompression shelter and space for some increasingly empty shelves of canned vegetables.

There is an open hatch in the ceiling.

>exits
The only exit is up to your home.

>u
Home
The room where you've slept your entire life. You can go out towards the crops.

There is an open hatch in the floor.

>out
Sector 4: Crops
Your home is here among the crops. You can walk spinward or antispinward.

>exits
The exits are inside to your home, spinward to sector 5, and antispinward to sector 3.

>s
You can't go that way. The exits are inside to your home, spinward to sector 5, and antispinward to sector 3.

* * *

>exits
The exits are inside to your home, spinward to sector 5, and antispinward to sector 3.

>showme home
(the home)
home - building
location: in Sector 4: Crops
singular-named, improper-named; unlit, inedible, fixed in place, scenery; open, unopenable, unlocked, apparent
list grouping key: none
printed name: "home"
printed plural name: "buildings"
indefinite article: none
description: "You were told it was built to look like a log cabin on Old Earth."
initial appearance: none
other side: Home

>showme church
(Church)
Church - room
    altar - supporter
        Founder's Testament
    organ - machine
        tan socket (part of organ) - usb socket
    audio unit - machine
        beige socket (part of audio unit) - usb socket
        power module - power module
    gray cable
        usb plug (part of gray cable) - usb plug
        usb plug (part of gray cable) - usb plug
singular-named, proper-named; lighted, unvisited, familiar, apparent
list grouping key: none
printed name: "Church"
printed plural name: none
indefinite article: none
description: "Before everyone left or died, you celebrated every sabbath here. The altar stands against one wall, and an organ and an audio unit stand against the other."
destination name: none

* * *

>out
Sector 4: Crops
Your home is here among the crops. You can walk spinward or antispinward.

>exits
The obvious exits are inside (to your home), spinward (to sector 5), and antispinward (to sector 3).

>in
Home
The room where you've slept your entire life. You can go out towards the crops.

There is a secured hatch in the floor.

>d
(first opening the floor hatch)

Cellar
Your decompression shelter and space for some increasingly empty shelves of canned vegetables.

There is an open hatch in the ceiling.

>exits
The only obvious exit is up (home).

* * *

>exits
The obvious exits are inside (to your home), spinward (to sector 5), and antispinward (to sector 3).

>sw
You walk a little ways to the next sector.

Sector 5: Forest
The school house is nestled among the trees. A pylon stretches up from the same grove to the hub of the station. You can walk spinward or antispinward.

>exits
The obvious exits are inside (to the school house), spinward (to sector 6), and antispinward (to sector 4).

>rooms
Center Platform - the center platform
Sector 1: Crops - sector 1
Barn - the barn
Pod Control - pod control
the pod bay - 
Sector 2: Aquaculture - sector 2
Sector 3: Forest - sector 3
Church - the church
House - the house
Sector 4: Crops - sector 4
Home - your home
Cellar - the cellar
Sector 5: Forest - sector 5
School House - the school house
Sector 6: Hydroponics - sector 6
the supply vault -

* * *

>exits
The exits are down to the cellar and outside to sector 4.

>s
You can't go that way. The exits are down to the cellar and outside to sector 4.

>n
You have heard of compass directions like north, but they don't make any sense here. Instead, you can go spinward, antispinward, port, and starboard. When you look spinward, port is left and starboard is right.

[You can use the abbreviations "sw", "asw", "p", and "s". You can also go "up", "down", "in", and "out" where appropriate. Type "exits" if you get confused about geography.]

>s
You can't go that way. The exits are down to the cellar and outside to sector 4.

>s
You can't go that way. The exits are down to the cellar and outside to sector 4.

* * *

>exits
The exits are down to the cellar and outside to sector 4.

>up
You can't go that way. The obvious exits are down (cellar) and outside (sector 4).

>out
Sector 4: Crops
Your home is here among the crops. You can walk spinward or antispinward.

>asw
You walk a little ways to the next sector.

Sector 3: Forest
Trees, a house, and a church. A red pylon stretches up from the ground to the hub of the station. You can walk spinward or antispinward.

>exits
The obvious exits are starboard (house), port (church), spinward (sector 4), and antispinward (sector 2).

>sw
You walk a little ways to the next sector.

Sector 4: Crops
Your home is here among the crops. You can walk spinward or antispinward.

>sw
You walk a little ways to the next sector.

Sector 5: Forest
The school house is nestled among the trees. A pylon stretches up from the same grove to the hub of the station. You can walk spinward or antispinward.

>sw
You walk a little ways to the next sector.

Sector 6: Hydroponics
Your people preferred to grow things the old fashioned way, but in truth the majority of your fruit and vegetables came from this sector when the machines still worked. You can walk spinward or antispinward.

There is a secured hatch in the ground.

>exits
The obvious exits are down (supply vault), spinward (sector 1), and antispinward (sector 5).

* * *

>get blanket
Taken.

>drop blanket
You arrange the blanket on the ground.

>l
Home
The room where you've slept your entire life. The crops are outside.

There is a secured hatch in the floor.

You can also see a blanket here.

* * *

>get blanket
Taken.

>wear blanket
You put on the blanket.

>i
You are carrying:
  a blanket (being worn)
  a scanner
  a green jumpsuit (being worn)

>put scanner on blanket
You put the scanner on the blanket.

>i
You are carrying:
  a blanket (being worn)
    a scanner
  a green jumpsuit (being worn)

>look
Home
The room where you've slept your entire life. The crops are outside.

There is a secured hatch in the floor.

>drop blanket
(first taking the blanket off)
Dropped.

>get on blanket
You get onto the blanket.

On the blanket you can see a scanner.

>look
Home (on the blanket)
The room where you've slept your entire life. The crops are outside.

There is a secured hatch in the floor.

On the blanket you can see a scanner.

>showme blanket
blanket - supporter
    yourself - person
        green jumpsuit (worn)
            pocket (part of green jumpsuit) - open container
    scanner
location: in Home
singular-named, improper-named; unlit, inedible, portable, wearable, handled; enterable
list grouping key: none
printed name: "blanket"
printed plural name: "supporters"
indefinite article: none
description: none
initial appearance: none
carrying capacity: 100

* * *

>get on blanket
You get onto the blanket.

>get blanket
(first getting off the blanket)
Taken.

>undo
Home
[Previous turn undone.]

>drop scanner
Dropped.

>look
Home (on the blanket)
The room where you've slept your entire life. The crops are outside.

There is a secured hatch in the floor.

On the blanket you can see a scanner.

>get up
You get off the blanket.

Home
The room where you've slept your entire life. The crops are outside.

There is a secured hatch in the floor.

You can also see a blanket (on which is a scanner) here.

>undo
Home
[Previous turn undone.]

>get blanket
(first getting off the blanket)
(first taking the scanner)
Taken.

>look
Home
The room where you've slept your entire life. The crops are outside.

There is a secured hatch in the floor.

* * *

>get on blanket
You get onto the blanket.

>get up
You get off the blanket.

Home
The room where you've slept your entire life. The crops are outside.

There is a secured hatch in the floor.

You can also see a blanket here.

>get on blanket
You get onto the blanket.

>take blanket
(first taking yourself)
You are always self-possessed.

* * *

>get on blanket
You get onto the blanket.

>take blanket
You would have to get off the blanket first.

>get off blanket
You get off the blanket.

Home
The room where you've slept your entire life. The crops are outside.

There is a secured hatch in the floor.

You can also see a blanket here.

>i
You are carrying:
  a scanner
  a green jumpsuit (being worn)

>put scanner on blanket
You put the scanner on the blanket.

>take blanket
Taken.

>undo
Home
[Previous turn undone.]

>actions
Actions listing on.

>take blanket
[taking the blanket]
Taken.
[taking the blanket - succeeded]

* * *

>get on blanket
You get onto the blanket.

>wear blanket
(first taking the blanket)
You would have to get off the blanket first.

>get off blanket
You get off the blanket.

Home
The room where you've slept your entire life. The crops are outside.

There is a secured hatch in the floor.

You can also see a blanket here.

>wear blanket
(first taking the blanket)
You put on the blanket.

>put blanket on ground
You can't see any such thing.

>drop blanket
(first taking the blanket off)
Dropped.

>undo
Home
[Previous turn undone.]

* * *

>get up
You get off the blanket.

Home
The room where you've slept your entire life. The crops are outside.

There is a secured hatch in the floor.

You can also see a blanket here.

>get blanket
Taken.

>put blanket in pocket
It's a large pocket, but not large enough to hold a blanket.

You put the blanket into the pocket.

* * *

>get up
You get off the blanket.

Home
The room where you've slept your entire life. The crops are outside.

There is a secured hatch in the floor.

You can also see a blanket here.

>x blanket
You can't see any such thing.

>restart
Are you sure you want to restart?

>yes
You awake. You are lonely, so lonely. It was a thousand days ago today. All alone these thousand days. Your parents were the last. No, your father was the last. He held on for nearly a hundred days longer. No, you are the last. Alone. Adrift.

But maybe it isn't hopeless. There must still be other people in other worlds, and you think you know how to get there.

Today is the day.

Founder's Mercy
A Space Story by Thomas Insel
Release 1 / Serial number 181209 / Inform 7 build 6M62 (I6/v6.33 lib 6/12N) SD
Type "about" for credits or "hint" for assistance.

Home
The room where you've slept your entire life. The crops are outside.

There is a secured hatch in the floor.

You can also see a blanket here.

>wear blanket
(first taking the blanket)
You put on the blanket.

>put scanner in blanket
That can't contain things.

>put scanner on blanket
You can only do that if you drop the blanket first.

* * *

>gonear  pile
Pod Bay
There are four berths for transit pods. Unfortunately, all are empty.

A secured door leads starboard.

There is a pile of clutter. It looks like equipment removed to free up space in the transit pods.

This is troubling. You counted. You were sure there would be one pod left. There are none.

[Your score has just gone up by two points.]

>open pile
It isn't something you can open.

>close pile
It isn't something you can close.

* * *

>gonear actor
There seems to be no such object anywhere in the model world.

>ask scanner about me
[To communicate in this story, type "CHARACTER, MESSAGE" where CHARACTER is someone or something and MESSAGE is what you want to say.]

>talk about e
That's not a verb I recognize.

>talk about edsfd
That's not a verb I recognize.

>say jjksdf
[To communicate in this story, type "CHARACTER, MESSAGE" where CHARACTER is someone or something and MESSAGE is what you want to say.]

* * *

>gonear audio
Church
Before everyone left or died, you celebrated every sabbath here. The altar stands against one wall, and an organ and a portable audio unit stand against the other.

On the altar is The Founder's Testament.

A gray cable connects the organ to the audio unit.

>take audio
Taken.

>i
You are carrying:
  an audio unit
  a scanner
  a green jumpsuit (being worn)

>s
(starboard)The audio unit pulls out from the gray cable.

(outside)
Sector 3: Forest
Trees, a house, and a church. A red pylon stretches up from the ground to the hub of the station. You can walk spinward or antispinward.

>gonear audio
Sector 3: Forest
Trees, a house, and a church. A red pylon stretches up from the ground to the hub of the station. You can walk spinward or antispinward.

>search audio
You can't see inside, since the audio unit is closed.

>x audio
The audio unit incorporates a speaker, a microphone, and a socket you would use to connect it to another device.

The audio unit has nothing plugged into it.

>x cable
You can't see any such thing.

>lok
That's not a verb I recognize.

>look
Sector 3: Forest
Trees, a house, and a church. A red pylon stretches up from the ground to the hub of the station. You can walk spinward or antispinward.

>look
Sector 3: Forest
Trees, a house, and a church. A red pylon stretches up from the ground to the hub of the station. You can walk spinward or antispinward.

>x organ
You can't see any such thing.

>i
You are carrying:
  an audio unit
  a scanner
  a green jumpsuit (being worn)

>restart
Are you sure you want to restart?

>yes
You awake. You are lonely, so lonely. It was a thousand days ago today. All alone these thousand days. Your parents were the last. No, your father was the last. He held on for nearly a hundred days longer. No, you are the last. Alone. Adrift.

But maybe it isn't hopeless. There must still be other people in other worlds, and you think you know how to get there.

Today is the day.

Founder's Mercy
A Space Story by Thomas Insel
Release 1 / Serial number 181204 / Inform 7 build 6M62 (I6/v6.33 lib 6/12N) SD
Type "about" for credits or "hint" for assistance.

Home
The room where you've slept your entire life. You can go out towards the crops.

There is a secured hatch in the floor.

>gonear audio
Church
Before everyone left or died, you celebrated every sabbath here. The altar stands against one wall, and an organ and a portable audio unit stand against the other.

On the altar is The Founder's Testament.

A gray cable connects the organ to the audio unit.

* * *

>take audio
Taken.

>u
(up)The audio unit pulls out from the gray cable.

The only exit is outside to sector 3.

* * *

>gonear board
School House
A broken learning machine remains in a corner, but mostly the older farmers took turns leading the class. There is a desk, and a chalkboard hangs on one wall.

On the desk is a clean eraser.

>clean board
You smudge the writing around with your hand.

>clean eraser
You rub the clean eraser.

>x eraser
A clean eraser.

>clean board with eraser
(first taking the clean eraser)
You carefully erase the chalkboard.

>i
You are carrying:
  a dusty eraser
  a scanner
  a green jumpsuit (being worn)

>clean eraser
You rub the dusty eraser.

* * *

>gonear boots
Supply Vault
This room is dim, quiet, and stuffy. There is still one crate of machine parts left.

There is a secured hatch in the ceiling.

You can also see a pair of gravity boots here.

>gonear eraser
School House
A broken learning machine remains in a corner, but mostly the older farmers took turns leading the class. There is a desk, and a chalkboard hangs on one wall.

On the desk is a clean eraser.

>erase board with eraser
(first taking the clean eraser)
You carefully erase the chalkboard.

>gonear crate
Supply Vault
This room is dim, quiet, and stuffy. There is still one crate of machine parts left.

There is a secured hatch in the ceiling.

You can also see a pair of gravity boots here.

>get boots
Taken.

I beg your pardon?

>u
An alarm sounds, and a synthesized voice says "Laser scan detects unauthorized materiel removal."

The hatch seems to be locked.

>open hatch
An alarm sounds, and a synthesized voice says "Laser scan detects unauthorized materiel removal."

The hatch seems to be locked.

>hit eraser
You fill the vault with a cloud of dust which scatters the laser beam that you can now see scanning across the hatch.

>open hatch
You maneuver around the laser beam and open the ceiling hatch.

>u
You maneuver around the laser beam and pull yourself up through the ceiling hatch.

Sector 6: Hydroponics
Your people preferred to grow things the old fashioned way, but in truth the majority of your fruit and vegetables came from this sector when the machines still worked. You can walk spinward or antispinward.

There is an open hatch in the ground.

[Your score has just gone up by one point.]

>undo
Supply Vault
[Previous turn undone.]

>close hatch
You close the ceiling hatch.

>z
Time passes.

>z
Time passes.

The cloud of dust dissipates.

>hit eraser
You fill the vault with a cloud of dust which scatters the laser beam that you can now see scanning across the hatch.

>u
(first opening the ceiling hatch)
You maneuver around the laser beam and open the ceiling hatch.

Sector 6: Hydroponics
Your people preferred to grow things the old fashioned way, but in truth the majority of your fruit and vegetables came from this sector when the machines still worked. You can walk spinward or antispinward.

There is an open hatch in the ground.

[Your score has just gone up by one point.]

>undo
Supply Vault
[Previous turn undone.]

>actions
Actions listing on.

>u
[going up]
(first opening the ceiling hatch)
[(1) opening the ceiling hatch - silently]
You maneuver around the laser beam and open the ceiling hatch.
[(1) opening the ceiling hatch - silently - succeeded]

Sector 6: Hydroponics
Your people preferred to grow things the old fashioned way, but in truth the majority of your fruit and vegetables came from this sector when the machines still worked. You can walk spinward or antispinward.

There is an open hatch in the ground.

[going up - succeeded]

[Your score has just gone up by one point.]

* * *

>gonear boots
Supply Vault
This room is dim, quiet, and stuffy. There is still one crate of machine parts left.

There is a secured hatch in the ceiling.

You can also see a pair of gravity boots here.

>open hatch
You open the ceiling hatch.

>get boots
Taken.

>open hatch
That's already open.

>gonear eraser
School House
A broken learning machine remains in a corner, but mostly the older farmers took turns leading the class. There is a desk, and a chalkboard hangs on one wall.

On the desk is a clean eraser.

>get eraser
Taken.

>erase board
(with the eraser)
You carefully erase the chalkboard.

>gonear crate
Supply Vault
This room is dim, quiet, and stuffy. There is still one crate of machine parts left.

There is an open hatch in the ceiling.

>hit eraser
You fill the vault with a cloud of dust which scatters the laser beam that you can now see scanning across the hatch.

>open hatch
You maneuver around the laser beam.

That's already open.

>g
You maneuver around the laser beam.

That's already open.

>g
You maneuver around the laser beam.

That's already open.

* * *

>get boots
Taken.

>u
An alarm sounds, the hatch slams shut, and a synthesized voice says "Laser scan detects unauthorized materiel removal."

The hatch seems to be locked.

>undo
Supply Vault
[Previous turn undone.]

>x hatch
The ceiling hatch is open.

>get boots
You already have that.

>open hatch
An alarm sounds, the hatch slams shut, and a synthesized voice says "Laser scan detects unauthorized materiel removal."

The hatch seems to be locked.

* * *

>open hatch
You open the ceiling hatch.

>undo
Supply Vault
[Previous turn undone.]

>get boots
Taken.

>u
An alarm sounds, and a synthesized voice says "Laser scan detects unauthorized materiel removal."

The hatch seems to be locked.

>undo
Supply Vault
[Previous turn undone.]

>open hatch
An alarm sounds, and a synthesized voice says "Laser scan detects unauthorized materiel removal."

The hatch seems to be locked.

>drop boots
Dropped.

>open hatch
You open the ceiling hatch.

* * *

>gonear eraser
School House
A broken learning machine remains in a corner, but mostly the older farmers took turns leading the class. There is a desk, and a chalkboard hangs on one wall.

On the desk is a clean eraser.

>get it
That's hardly portable.

>get eraser
Taken.

* * *

>gonear crate
Supply Vault
This room is dim, quiet, and stuffy. There is still one crate of machine parts left.

There is an open hatch in the ceiling.

>u
An alarm sounds, the hatch slams shut, and a synthesized voice says "Laser scan detects unauthorized materiel removal."

The hatch seems to be locked.

>hit eraser
You fill the vault with a cloud of dust which scatters the laser beam that you can now see scanning across the hatch.

>open hatch
You maneuver around the laser beam.

You open the ceiling hatch.

>g
That's already open.

* * *

>gonear boots
Supply Vault
This room is dim, quiet, and stuffy. There is still one crate of machine parts left.

There is a secured hatch in the ceiling.

You can also see a pair of gravity boots here.

>x laser
You can't see any such thing.

>showme laser
laser beam - thing
location: out of play
singular-named, improper-named; unlit, inedible, fixed in place, scenery; clean
list grouping key: none
printed name: "laser beam"
printed plural name: none
indefinite article: none
description: "The cloud of dust scatters the laser beam just enough that you can see it scan across the north passageway at seemingly random angles."
initial appearance: none

>get boots
Taken.

* * *

>u
An alarm sounds, and a synthesized voice says "Laser scan detects unauthorized materiel removal."

The hatch seems to be locked.

>showme laser
laser beam - thing
location: out of play
singular-named, improper-named; unlit, inedible, fixed in place, scenery; clean, alarmed
list grouping key: none
printed name: "laser beam"
printed plural name: none
indefinite article: none
description: "The cloud of dust scatters the laser beam just enough that you can see it scan across the north passageway at seemingly random angles."
initial appearance: none

* * *

>gonear breaker
Which do you mean, the green circuit breaker or the red circuit breaker?

>red
Platform 3
It's a mesh platform about two thirds of the way towards the hub. You feel much lighter here, and you are very aware of how the station rotates, but everything is okay as long as you don't look down.

There is a red circuit breaker here.

>d
You slide down the pylon.

Sector 3: Forest
Trees, a house, and a church. A red pylon stretches up from the ground to the hub of the station. You can walk spinward or antispinward.

>u
The red pylon is designated for climbing, but you can't get a grip.

>x ground
You can't see any such thing.

>x hubg
You can't see any such thing.

>x hub
The station rotates around the hub, which extends out to hold solar panels on the port and mirrors on the starboard side. On the inside, there is a maintenance platform about two thirds of the way up the pylons.

>x pylon
Made of smooth metal, anodized red, it connects the ground to the hub of the station many meters above.

* * *

>gonear cable
Church
Before everyone left or died, you celebrated every sabbath here. The altar stands against one wall, and an organ and a portable audio unit stand against the other.

On the altar is The Founder's Testament.

A gray cable connects the organ to the audio unit.

* * *

>in
(inside)The audio unit pulls out from the gray cable.

The only exit is outside to sector 3.

>undo
Church
[Previous turn undone.]

>s
(starboard)The audio unit pulls out from the gray cable.

(outside)
Sector 3: Forest
Trees, a house, and a church. A red pylon stretches up from the ground to the hub of the station. You can walk spinward or antispinward.

>undo
Church
[Previous turn undone.]

>port
(port)The audio unit pulls out from the gray cable.

The only exit is outside to sector 3.

>get audio
You already have that.

>drop audio
Dropped.

* * *

>gonear cable
Church
Before everyone left or died, you celebrated every sabbath here. The altar stands against one wall, and an organ and a portable audio unit stand against the other.

On the altar is The Founder's Testament.

A gray cable connects the organ to the audio unit.

>x cable
A one meter USB 7.2 cable with a Type-F plug at each end.

It is plugged into the organ and an audio unit.

* * *

>gonear church
(Church)
Church
Before everyone left or died, you celebrated every sabbath here. The altar stands against one wall, and an organ and a portable audio unit stand against the other.

On the altar is The Founder's Testament.

A gray cable connects the organ to the audio unit.

* * *

>get cable
Taken.

>in
The only exit is outside to sector 3.

>out
The gray cable pulls out from the organ.
The gray cable pulls out from the audio unit.

Sector 3: Forest
Trees, a house, and a church. A red pylon stretches up from the ground to the hub of the station. You can walk spinward or antispinward.

* * *

>get cable
Taken.

>out
(the usb plug in the gray cable)2. The gray cable pulls out from the organ (the tan socket).
(the usb plug in the gray cable)2. The gray cable pulls out from the audio unit (the beige socket).

Sector 3: Forest
Trees, a house, and a church. A red pylon stretches up from the ground to the hub of the station. You can walk spinward or antispinward.

>undo
Church
[Previous turn undone.]

>drop cable
Dropped.

>look
Church
Before everyone left or died, you celebrated every sabbath here. The altar stands against one wall, and an organ and a portable audio unit stand against the other.

On the altar is The Founder's Testament.

You can also see a gray cable (plugged into the organ and an audio unit) here.

>get audio
Taken.

>out
(the beige socket in the audio unit)1. The audio unit pulls out from the gray cable (the usb plug).

Sector 3: Forest
Trees, a house, and a church. A red pylon stretches up from the ground to the hub of the station. You can walk spinward or antispinward.

* * *

>undo
Church
[Previous turn undone.]

>in
The only exit is outside to sector 3.

>get cable
You already have that.

>out
(the usb plug)The gray cable pulls out from the organ.
(the usb plug)The gray cable pulls out from the audio unit.

Sector 3: Forest
Trees, a house, and a church. A red pylon stretches up from the ground to the hub of the station. You can walk spinward or antispinward.

>undo
Church
[Previous turn undone.]

* * *

>drop cable
Dropped.

>get audio
Taken.

>out
(the beige socket)The audio unit pulls out from the gray cable.

Sector 3: Forest
Trees, a house, and a church. A red pylon stretches up from the ground to the hub of the station. You can walk spinward or antispinward.

>look
Sector 3: Forest
Trees, a house, and a church. A red pylon stretches up from the ground to the hub of the station. You can walk spinward or antispinward.

>i
You are carrying:
  an audio unit
  a scanner
  a green jumpsuit (being worn)

>i
You are carrying:
  an audio unit
  a scanner
  a green jumpsuit (being worn)

>in
You can enter the church or the house.

>i
You are carrying:
  an audio unit
  a scanner
  a green jumpsuit (being worn)

>look
Sector 3: Forest
Trees, a house, and a church. A red pylon stretches up from the ground to the hub of the station. You can walk spinward or antispinward.

* * *

>gonear church
(Church)
Church
Before everyone left or died, you celebrated every sabbath here. The altar stands against one wall, and an organ and a portable audio unit stand against the other.

On the altar is The Founder's Testament.

A gray cable connects the organ to the audio unit.

>look
Church
Before everyone left or died, you celebrated every sabbath here. The altar stands against one wall, and an organ and an audio unit stand against the other.

On the altar is The Founder's Testament.

A gray cable connects the organ and the audio unit.

* * *

>gonear church
(Church)
Church
Before everyone left or died, you celebrated every sabbath here. The altar stands against one wall, and an organ and a portable audio unit stand against the other.

On the altar is The Founder's Testament.

A gray cable connects the organ to the audio unit.

>out
Sector 3: Forest
Trees, a house, and a church. A red pylon stretches up from the ground to the hub of the station. You can walk spinward or antispinward.

>church
Say go the church.

>look
Sector 3: Forest
Trees, a house, and a church. A red pylon stretches up from the ground to the hub of the station. You can walk spinward or antispinward.

* * *

>out
Sector 3: Forest
Trees, a house, and a church. A red pylon stretches up from the ground to the hub of the station. You can walk spinward or antispinward.

>in
You can enter the church or the house.

>church
Church
Before everyone left or died, you celebrated every sabbath here. The altar stands against one wall, and an organ and a portable audio unit stand against the other.

On the altar is The Founder's Testament.

A gray cable connects the organ to the audio unit.

>go church
Church
Before everyone left or died, you celebrated every sabbath here. The altar stands against one wall, and an organ and a portable audio unit stand against the other.

On the altar is The Founder's Testament.

A gray cable connects the organ to the audio unit.

>get cable
Taken.

* * *

>church
Church
Before everyone left or died, you celebrated every sabbath here. The altar stands against one wall, and an organ and a portable audio unit stand against the other.

On the altar is The Founder's Testament.

A gray cable connects the organ to the audio unit.

>out
Sector 3: Forest
Trees, a house, and a church. A red pylon stretches up from the ground to the hub of the station. You can walk spinward or antispinward.

>house
House
Two families lived here, but not recently.

Someone has left a doll on the well swept floor.

>out
Sector 3: Forest
Trees, a house, and a church. A red pylon stretches up from the ground to the hub of the station. You can walk spinward or antispinward.

>sw
You walk a little ways to the next sector.

Sector 4: Crops
Your home is here among the crops. You can walk spinward or antispinward.

* * *

>sw
You walk a little ways to the next sector.

Sector 5: Forest
The school house is nestled among the trees. A pylon stretches up from the same grove to the hub of the station. You can walk spinward or antispinward.

>house
School House
A broken learning machine remains in a corner, but mostly the older farmers took turns leading the class. There is a desk, and a chalkboard hangs on one wall.

On the desk is a clean eraser.

>in
The only exit is outside to sector 5.

>school
That's not a verb I recognize.

>out
Sector 5: Forest
The school house is nestled among the trees. A pylon stretches up from the same grove to the hub of the station. You can walk spinward or antispinward.

>school
School House
A broken learning machine remains in a corner, but mostly the older farmers took turns leading the class. There is a desk, and a chalkboard hangs on one wall.

On the desk is a clean eraser.

>out
Sector 5: Forest
The school house is nestled among the trees. A pylon stretches up from the same grove to the hub of the station. You can walk spinward or antispinward.

* * *

>sw
You walk a little ways to the next sector.

Sector 1: Crops
You still maintain the crops here. There is a small graveyard and the barn remains from when this was the livestock sector. A pylon stretches up from the ground to the hub of the station. You can walk spinward or antispinward.

There is a secured hatch in the ground.

>barn
Barn
Not fancy: livestock on one side and feed on the other, but nothing remains of either. There is a plow near the entrance.

>out
Sector 1: Crops
You still maintain the crops here. There is a small graveyard and the barn remains from when this was the livestock sector. A pylon stretches up from the ground to the hub of the station. You can walk spinward or antispinward.

There is a secured hatch in the ground.

>sw
You walk a little ways to the next sector.

Sector 2: Aquaculture
A deep pond is used as part of the water filtration system and for raising fish. You can walk spinward or antispinward.

You have walked the entire ring. Everything is as expected, much is not working. Now, it's time to leave: the pods are below Sector 1.

>sw
You walk a little ways to the next sector.

Sector 3: Forest
Trees, a house, and a church. A red pylon stretches up from the ground to the hub of the station. You can walk spinward or antispinward.

>sw
You walk a little ways to the next sector.

Sector 4: Crops
Your home is here among the crops. You can walk spinward or antispinward.

>home
Home
The room where you've slept your entire life. You can go out towards the crops.

There is a secured hatch in the floor.

>out
Sector 4: Crops
Your home is here among the crops. You can walk spinward or antispinward.

>crops
That's not a verb I recognize.

* * *

>gonear church
(Church)
Church
Before everyone left or died, you celebrated every sabbath here. The altar stands against one wall, and an organ and a portable audio unit stand against the other.

On the altar is The Founder's Testament.

A gray cable connects the organ to the audio unit.

>x cable
A one meter USB 7.2 cable with a Type-F plug at each end.

It is not plugged into anything.

* * *

>gonear church
(Church)
Church
Before everyone left or died, you celebrated every sabbath here. The altar stands against one wall, and an organ and a portable audio unit stand against the other.

On the altar is The Founder's Testament.

A gray cable connects the organ to the audio unit.

>x church
You can't see any such thing.

>get cable
Taken.

>out
2. The gray cable pulls out from the organ.
2. The gray cable pulls out from the audio unit.

Sector 3: Forest
Trees, a house, and a church. A red pylon stretches up from the ground to the hub of the station. You can walk spinward or antispinward.

>undo
Church
[Previous turn undone.]

>drop all
gray cable: Dropped.
scanner: Dropped.

>get audio
Taken.

>out
1. The gray cable pulls out from the audio unit.

Sector 3: Forest
Trees, a house, and a church. A red pylon stretches up from the ground to the hub of the station. You can walk spinward or antispinward.

>undo
Church
[Previous turn undone.]

* * *

>gonear comms
Pod Bay
There are four berths for transit pods. Unfortunately, all are empty.

A secured hatch leads starboard.

An atmosphere sensor is attached to the wall.

Someone left an emergency communications unit on the floor.

This is troubling. You counted. You were sure there would be one pod left. There are none.

[Your score has just gone up by two points.]

>x comms
A portable emergency communications unit. Normally, its sockets would be for audio and antenna connections in a pod, but you will need to find another way.

The emergency communications unit has nothing plugged into it.

>scan comms
Machine functional. No Audio connection.

* * *

>x comms
A portable emergency communications unit. Normally, its sockets would be for audio and antenna connections in a pod, but you will need to find another way.

The emergency communications unit has nothing plugged into it.

>x socket
Which do you mean, the almond socket or the RF socket?

>RF
It is a female RF connector of the emergency communications unit. It has nothing plugged into it.

>x usb
It is a female USB connector of the emergency communications unit. It has nothing plugged into it.

No pods left ... you consider despair.

>x usb socket
It is a female USB connector of the emergency communications unit. It has nothing plugged into it.

>get comms
Taken.

So what if you can't escape in a pod. You will just need to bring a pod here. Time to get the communications module working.

>gonear yellow
Inside the Hub
You float weightless in the middle of a cylinder. A ladder rotates around you, leading up or down or maybe out.

A yellow cable waves from a small panel.

>x cable
A yellow RF cable.

It is plugged into a panel.

>plug cable into comms
You plug the yellow cable into the emergency communications unit.

>x cable
A yellow RF cable.

It is plugged into a panel and the emergency communications unit.

>unplug cable from panel
The yellow cable is permanently attached to the panel.

>x comms
A portable emergency communications unit. Normally, its sockets would be for audio and antenna connections in a pod, but you will need to find another way.

The emergency communications unit has a yellow cable plugged into it.

>gonear gray
Church
Before everyone left or died, you celebrated every sabbath here. The altar stands against one wall, and an organ and a portable audio unit stand against the other.

On the altar is The Founder's Testament.

A gray cable connects the organ to the audio unit.

>get gray
Taken.

>unplug gray from organ
You unplug the gray cable from the organ.

>get audio
(putting the scanner into your pocket to make room)
Taken.

>gonear yellow
Inside the Hub
You float weightless in the middle of a cylinder. A ladder rotates around you, leading up or down or maybe out.

A yellow cable waves from a small panel.

>look
Inside the Hub
You float weightless in the middle of a cylinder. A ladder rotates around you, leading up or down or maybe out.

A yellow cable waves from a small panel.

>i
You are carrying:
  an audio unit
  a gray cable (plugged into an audio unit)
  the emergency communications unit
  a green jumpsuit (being worn)

Your jumpsuit pocket contains:
  a scanner

>plug gray into comms
You plug the gray cable into the emergency communications unit.

>x comms
A portable emergency communications unit. Normally, its sockets would be for audio and antenna connections in a pod, but you will need to find another way.

The emergency communications unit has a gray cable and a yellow cable plugged into it.

* * *

>gonear comms
Pod Bay
There are four berths for transit pods. Unfortunately, all are empty.

A secured hatch leads starboard.

An atmosphere sensor is attached to the wall.

Someone left an emergency communications unit on the floor.

This is troubling. You counted. You were sure there would be one pod left. There are none.

[Your score has just gone up by two points.]

>x coms
You can't see any such thing.

>x comms
A bulky but portable emergency communications unit. Maybe someone removed it from a pod to make space. It can work independently if you provide audio and antenna connections.

The emergency communications unit has nothing plugged into it.

>get sensor
That's fixed in place.

>scan sensor
No modular technology detected.

No pods left ... you consider despair.

* * *

>x comms
A bulky but portable emergency communications unit. Maybe someone removed it from a pod to make space. It can work independently if you provide audio and antenna connections.

The emergency communications unit has nothing plugged into it.

>x socket
Which do you mean, the almond socket or the RF socket?

>almond
It is a female standard connector of the emergency communications unit. It has nothing plugged into it.

>x rf socket
It is a female standard connector of the emergency communications unit. It has nothing plugged into it.

No pods left ... you consider despair.

* * *

>gonear crate
Supply Vault
This room is dim, quiet, and stuffy. There is still one crate of machine parts left.

There is a secured hatch in the ceiling.

You can also see a pair of gravity boots here.

>search crate
You find instruction module and pressure regulation module.

* * *

>gonear crate
Supply Vault
This room is dim, quiet, and stuffy. There is still one crate of machine parts left.

There is a secured hatch in the ceiling.

You can also see a pair of gravity boots here.

>u
(first opening the ceiling hatch)

Sector 6: Hydroponics
Your people preferred to grow things the old fashioned way, but in truth the majority of your fruit and vegetables came from this sector when the machines still worked. You can walk spinward or antispinward.

There is an open hatch in the ground.

>d
Supply Vault
This room is dim, quiet, and stuffy. There is still one crate of machine parts left.

There is an open hatch in the ceiling.

You can also see a pair of gravity boots here.

>get boots
Taken.

* * *

>u
An alarm sounds, the hatch slams shut, and a synthesized voice says "Laser scan detects unauthorized materiel removal."

The hatch seems to be locked.

>gonear eraser
School House
A broken learning machine remains in a corner, but mostly the older farmers took turns leading the class. There is a desk, and a chalkboard hangs on one wall.

On the desk is a clean eraser.

>erase board
You smudge the writing around with your hand.

>gonear crate
Supply Vault
This room is dim, quiet, and stuffy. There is still one crate of machine parts left.

There is a secured hatch in the ceiling.

>x crate
These remaining parts never seem to fit anywhere useful, but Founder only knows what's in there.

>search crate
You find a pressure regulation module.

>i
You are carrying:
  a pressure regulation module
  a pair of gravity boots
  a scanner
  a green jumpsuit (being worn)

>u
An alarm sounds, and a synthesized voice says "Laser scan detects unauthorized materiel removal."

The hatch seems to be locked.

>hit eraser
You can't see any such thing.

>gonear eraser
School House
A broken learning machine remains in a corner, but mostly the older farmers took turns leading the class. There is a desk, and a chalkboard hangs on one wall.

On the desk is a clean eraser.

>get eraser
(putting the scanner into your pocket to make room)
Taken.

* * *

>erase board
(with the eraser)
You carefully erase the chalkboard.

>gonear crate
Supply Vault
This room is dim, quiet, and stuffy. There is still one crate of machine parts left.

There is a secured hatch in the ceiling.

>u
An alarm sounds, and a synthesized voice says "Laser scan detects unauthorized materiel removal."

The hatch seems to be locked.

>hit eraser
You fill the vault with a cloud of dust which scatters the laser beam that you can now see scanning across the hatch.

* * *

>open hatch
You maneuver around the laser beam and open the ceiling hatch.

>open hatch
That's already open.

>z
Time passes.

* * *

>z
Time passes.

The cloud of dust dissipates.

>u
An alarm sounds, the hatch slams shut, and a synthesized voice says "Laser scan detects unauthorized materiel removal."

The hatch seems to be locked.

* * *

>undo
Supply Vault
[Previous turn undone.]

>open hatch
You maneuver around the laser beam and open the ceiling hatch.

* * *

>gonear crate
Supply Vault
This room is dim, quiet, and stuffy. There is still one crate of machine parts left.

There is a secured hatch in the ceiling.

You can also see a pair of gravity boots here.

>x crate
These remaining parts never seem to fit anywhere useful, but Founder only knows what's in there.

>search crate
You find an instruction module and a pressure regulation module.

>undo
Supply Vault
[Previous turn undone.]

>put scanner in crate
You add the scanner to the machine parts in the crate.

>search crate
You find a scanner, an instruction module, and a pressure regulation module.

>look
Supply Vault
This room is dim, quiet, and stuffy. There is still one crate of machine parts left.

There is a secured hatch in the ceiling.

You can also see a pair of gravity boots here.

>i
You are carrying:
  a pressure regulation module
  an instruction module
  a scanner
  a green jumpsuit (being worn)

>purloin all modules
[Purloined.]
[Purloined.]
[Purloined.]
[Purloined.]
[Purloined.]
[Purloined.]
[Purloined.]

>put all modules in crate
instruction module: You add the instruction module to the machine parts in the crate.
power module: You add the power module to the machine parts in the crate.
power module: You add the power module to the machine parts in the crate.
pressure regulation module: You add the pressure regulation module to the machine parts in the crate.
power module: You add the power module to the machine parts in the crate.
pressure regulation module: You add the pressure regulation module to the machine parts in the crate.
instruction module: You add the instruction module to the machine parts in the crate.

>i
You are carrying:
  a scanner
  a green jumpsuit (being worn)

>search crate
You find an instruction module, a pressure regulation module, a power module, a pressure regulation module, a power module, a power module, and an instruction module.
(putting the scanner into your pocket to make room)
(putting the instruction module into your pocket to make room)
(putting the pressure regulation module into your pocket to make room)
(putting the power module into your pocket to make room)
(putting the pressure regulation module into your pocket to make room)

>look
Supply Vault
This room is dim, quiet, and stuffy. There is still one crate of machine parts left.

There is a secured hatch in the ceiling.

You can also see a pair of gravity boots here.

>i
You are carrying:
  an instruction module
  two power modules
  a green jumpsuit (being worn)

Your jumpsuit pocket contains:
  two pressure regulation modules
  a power module
  an instruction module
  a scanner

* * *

>gonear displa
There seems to be no such object anywhere in the model world.

>gonear display
Pod Control
This room serves as an airlock for the pod bay, and holds an old space suit and various machinery such as the atmosphere pump. There is a brass plate on the wall.

There is a secured hatch in the ceiling.

Beside the secured port hatch, a status display shows an error message.

>x display
Pod bay locked down
 1. Telemetry sensor array offline - reset breaker FM36-87/A @ hub platform
 2. Launch system cooling loop offline - reset breaker FM29-63/A @ Sector 2
 3. Pod control atmosphere pump offline - scan and repair

>x pump
The atmosphere pump is a smooth featureless machine. It contains a power module and a pressure regulation module.

>u
(first opening the ceiling hatch)

Sector 1: Crops
You still maintain the crops here. There is a small graveyard and the barn remains from when this was the livestock sector. A pylon stretches up from the ground to the hub of the station. You can walk spinward or antispinward.

There is an open hatch in the ground.

>get all modules
You can't see any such thing.

>purloin all modules
[Purloined.]
[Purloined.]
[Purloined.]
[Purloined.]
[Purloined.]
[Purloined.]
[Purloined.]

>d
Pod Control
This room serves as an airlock for the pod bay, and holds an old space suit and various machinery such as the atmosphere pump. There is a brass plate on the wall.

There is an open hatch in the ceiling.

Beside the secured port hatch, a status display shows an error message.

>x display
Pod bay locked down
 1. Telemetry sensor array offline - reset breaker FM36-87/A @ hub platform
 2. Launch system cooling loop offline - reset breaker FM29-63/A @ Sector 2
 3. Pod control atmosphere pump offline - scan and repair

>i
You are carrying:
  two pressure regulation modules
  two instruction modules
  three power modules
  a scanner
  a green jumpsuit (being worn)

>x pump
The atmosphere pump is a smooth featureless machine. There are spaces for two modules.

>i
You are carrying:
  two pressure regulation modules
  two instruction modules
  three power modules
  a scanner
  a green jumpsuit (being worn)

>scan regulation
Module is functional.

>put functional regulation in pump
You put the functional pressure regulation module into the atmosphere pump.

>scan power
Module is functional.

>put functional power in pump
You put the functional power module into the atmosphere pump.

The atmosphere pump begins to hum.

[Your score has just gone up by one point.]

>x display
Pod bay locked down
 1. Telemetry sensor array offline - reset breaker FM36-87/A @ hub platform
 2. Launch system cooling loop offline - reset breaker FM29-63/A @ Sector 2
 3. Secure pod control hatch

>close hatch
Which do you mean, the ceiling hatch or the wall hatch?

>ceiling
You close the ceiling hatch.

>x display
Pod bay locked down
 1. Telemetry sensor array offline - reset breaker FM36-87/A @ hub platform
 2. Launch system cooling loop offline - reset breaker FM29-63/A @ Sector 2

>s
You can't go starboard, but you can go up to sector 1 or port to the pod bay.

>p
(first opening the wall hatch)
It seems to be locked.

>look
Pod Control
This room serves as an airlock for the pod bay, and holds an old space suit and various machinery such as the atmosphere pump. There is a brass plate on the wall.

There is a secured hatch in the ceiling.

Beside the secured port hatch, a status display shows an error message.

* * *

>gonear display
Pod Control
This room serves as an airlock for the pod bay, and holds an old space suit and various machinery such as the atmosphere pump. There is a brass plate on the wall.

There is a secured hatch in the ceiling.

Beside the secured port hatch, a status display shows an error message.

>goneare comms
That's not a verb I recognize.

>gonear comms
Pod Bay
There are four berths for transit pods. Sadly, all are empty.

A secured hatch leads starboard.

Someone left an emergency communications unit on the floor.

This is troubling. You counted. You were sure there would be one pod left. There are none.

[Your score has just gone up by two points.]

>actions
Actions listing on.

>look
[looking]
Pod Bay
There are four berths for transit pods. Unexpectedly, all are empty.

A secured hatch leads starboard.

Someone left an emergency communications unit on the floor.

[looking - succeeded]

>examine
What do you want to examine?

>me
[examining yourself]
As virtuous as ever.
[examining yourself - failed]

>climb hatch
[climbing the wall hatch]
Little is to be achieved by that.
[climbing the wall hatch - failed the block climbing rule]

No pods left ... you consider despair.

>gonear home
(Home)
[(1) looking]
Home
The room where you've slept your entire life. You can go out towards the crops.

There is a secured hatch in the floor.

[(1) looking - succeeded]

>climb down
[climbing down]
You must name something more substantial.
[climbing down - failed the basic accessibility rule]

So what if you can't escape in a pod. You will just need to bring a pod here. Time to get the communications module working.

>climb down
[climbing down]
You must name something more substantial.
[climbing down - failed the basic accessibility rule]

>u
[going up]
You can't go that way. The obvious exits are down and outside.
[going up - failed]

>d
[going down]
(first opening the floor hatch)
[(1) opening the floor hatch - silently]
[(1) opening the floor hatch - silently - succeeded]

Cellar
Your decompression shelter and space for some increasingly empty shelves of canned vegetables.

There is an open hatch in the ceiling.

[going down - succeeded]

>d
[going down]
You can't go that way. The only obvious exit is up (to home).
[going down - failed]

>gonear pylon
Which do you mean, the pylon or the pylon?

>red
[(1) looking]
Sector 3: Forest
Trees, a house, and a church. A red pylon stretches up from the ground to the hub of the station. You can walk spinward or antispinward.

[(1) looking - succeeded]

>climb up
[climbing up]
You must name something more substantial.
[climbing up - failed the basic accessibility rule]

>climb up
[climbing up]
You must name something more substantial.
[climbing up - failed the basic accessibility rule]

>climb down
[climbing down]
You must name something more substantial.
[climbing down - failed the basic accessibility rule]

* * *

>gonear display
Pod Control
This room serves as an airlock for the pod bay, and holds an old space suit and various machinery such as the atmosphere pump. There is a brass plate on the wall.

There is a secured hatch in the ceiling.

Beside the secured port hatch, a status display shows an error message.

>help
Your objective is simply to leave the station and find other people.

You need to repair some things. Check out the status display in Pod Control.

By the way, it should be impossible to put this story into an unwinnable state, so feel free to explore and experiment.

If you are having trouble getting started, I suggest reading A Beginner's Guide to Interactive Fiction by Stephen Granade and Emily Short, available at:

  https://brasslantern.org/players/howto/beginnersguide.html

[You can type "hint" any time for contextual assistance. If you prefer not to be tempted, you can type "hints off" to disable hints.]

>help
You need to repair some things. Check out the status display in Pod Control.

>help
You need to repair some things. Check out the status display in Pod Control.

>x display
Pod bay locked down
 1. Telemetry sensor array offline - reset breaker FM36-87/A @ hub platform
 2. Launch system cooling loop offline - reset breaker FM29-63/A @ Sector 2
 3. Pod bay not pressurized - scan and repair atmosphere pump

>help
You need to make three repairs, so you get three hints:

   Explore a bit more.
   The Sector 2 circuit breaker is in an awkward spot.
   Now might be a good time to try out the scanner.

>look
Pod Control
This room serves as an airlock for the pod bay, and holds an old space suit and various machinery such as the atmosphere pump. There is a brass plate on the wall.

There is a secured hatch in the ceiling.

Beside the secured port hatch, a status display shows an error message.

>look
Pod Control
This room serves as an airlock for the pod bay, and holds an old space suit and various machinery such as the atmosphere pump. There is a brass plate on the wall.

There is a secured hatch in the ceiling.

Beside the secured port hatch, a status display shows an error message.

>x display
Pod bay locked down
 1. Telemetry sensor array offline - reset breaker FM36-87/A @ hub platform
 2. Launch system cooling loop offline - reset breaker FM29-63/A @ Sector 2
 3. Pod bay not pressurized - scan and repair atmosphere pump

* * *

>help
You need to make three repairs, so you get three hints:

   Explore a bit more.
   The Sector 2 circuit breaker is in an awkward spot.
   Now might be a good time to try out the scanner.

>x pump
The atmosphere pump is a smooth featureless machine. It contains a power module and a pressure regulation module.

* * *

>u
(first opening the ceiling hatch)

Sector 1: Crops
You still maintain the crops here. There is a small graveyard and the barn remains from when this was the livestock sector. A pylon stretches up from the ground to the hub of the station. You can walk spinward or antispinward.

There is an open hatch in the ground.

>gt all modules
That's not a verb I recognize.

>get all modules
You can't see any such thing.

>d
Pod Control
This room serves as an airlock for the pod bay, and holds an old space suit and various machinery such as the atmosphere pump. There is a brass plate on the wall.

There is an open hatch in the ceiling.

Beside the secured port hatch, a status display shows an error message.

>u
Sector 1: Crops
You still maintain the crops here. There is a small graveyard and the barn remains from when this was the livestock sector. A pylon stretches up from the ground to the hub of the station. You can walk spinward or antispinward.

There is an open hatch in the ground.

>purloin all modules
[Purloined.]
[Purloined.]
[Purloined.]
[Purloined.]
[Purloined.]
[Purloined.]
[Purloined.]

I beg your pardon?

>scan power
Module is functional.

>d
Pod Control
This room serves as an airlock for the pod bay, and holds an old space suit and various machinery such as the atmosphere pump. There is a brass plate on the wall.

There is an open hatch in the ceiling.

Beside the secured port hatch, a status display shows an error message.

>scan regulator
Module is functional.

>help
You need to make three repairs, so you get three hints:

   Explore a bit more.
   The Sector 2 circuit breaker is in an awkward spot.
   Now might be a good time to try out the scanner.

>x display
Pod bay locked down
 1. Telemetry sensor array offline - reset breaker FM36-87/A @ hub platform
 2. Launch system cooling loop offline - reset breaker FM29-63/A @ Sector 2
 3. Pod bay not pressurized - scan and repair atmosphere pump

>put scanned pods in pimp
Which do you mean, the functional pressure regulation module or the functional power module?

>put scanned pods in pump
Which do you mean, the functional pressure regulation module or the functional power module?

>put functional pressure in pump
You put the functional pressure regulation module into the atmosphere pump.

>x pump
The atmosphere pump is a smooth featureless machine. It contains a functional pressure regulation module as well as space for one more module.

>put functional power in pump
You put the functional power module into the atmosphere pump.

The atmosphere pump begins to hum.

[Your score has just gone up by one point.]

>hint
You need to make two repairs, so you get two hints:

   Explore a bit more.
   The Sector 2 circuit breaker is in an awkward spot.

>x panel
You can't see any such thing.

>x displa
You can't see any such thing.

>x display
Pod bay locked down
 1. Telemetry sensor array offline - reset breaker FM36-87/A @ hub platform
 2. Launch system cooling loop offline - reset breaker FM29-63/A @ Sector 2
 3. Secure pod control hatch

>hint
You need to make two repairs, so you get two hints:

   Explore a bit more.
   The Sector 2 circuit breaker is in an awkward spot.

>get all from machine
functional power module: (putting the scanner into your pocket to make room)
You're carrying too many things already.
functional pressure regulation module: (putting the unscanned power module into your pocket to make room)
You're carrying too many things already.

>i
You are carrying:
  two unscanned instruction modules
  an unscanned power module
  an unscanned pressure regulation module
  a green jumpsuit (being worn)

Your jumpsuit pocket contains:
  an unscanned power module
  a scanner

>look
Pod Control
This room serves as an airlock for the pod bay, and holds an old space suit and various machinery such as the atmosphere pump. There is a brass plate on the wall.

There is an open hatch in the ceiling.

Beside the secured port hatch, a status display shows an error message.

>x machine
The featureless atmosphere pump is softly humming. It contains a functional power module and a functional pressure regulation module.

>drop all
unscanned instruction module: Dropped.
unscanned instruction module: Dropped.
unscanned power module: Dropped.
unscanned pressure regulation module: Dropped.

>get all
unscanned pressure regulation module: Taken.
unscanned power module: Taken.
unscanned instruction module: Taken.
unscanned instruction module: (putting the unscanned pressure regulation module into your pocket to make room)
Taken.
functional power module: (putting the unscanned power module into your pocket to make room)
Taken.
functional pressure regulation module: (putting the unscanned instruction module into your pocket to make room)
Taken.

>get all from machine
The atmosphere pump is empty.

>i
You are carrying:
  a functional pressure regulation module
  a functional power module
  an unscanned instruction module
  a green jumpsuit (being worn)

Your jumpsuit pocket contains:
  an unscanned instruction module
  two unscanned power modules
  an unscanned pressure regulation module
  a scanner

>look
Pod Control
This room serves as an airlock for the pod bay, and holds an old space suit and various machinery such as the atmosphere pump. There is a brass plate on the wall.

There is an open hatch in the ceiling.

Beside the secured port hatch, a status display shows an error message.

>x machine
The atmosphere pump is a smooth featureless machine. There are spaces for two modules.

>x panel
You can't see any such thing.

>x status
Pod bay locked down
 1. Telemetry sensor array offline - reset breaker FM36-87/A @ hub platform
 2. Launch system cooling loop offline - reset breaker FM29-63/A @ Sector 2
 3. Atmosphere pump offline - scan and repair

>hint
You need to make two repairs, so you get two hints:

   Explore a bit more.
   The Sector 2 circuit breaker is in an awkward spot.

>x status
Pod bay locked down
 1. Telemetry sensor array offline - reset breaker FM36-87/A @ hub platform
 2. Launch system cooling loop offline - reset breaker FM29-63/A @ Sector 2
 3. Atmosphere pump offline - scan and repair

>x display
Pod bay locked down
 1. Telemetry sensor array offline - reset breaker FM36-87/A @ hub platform
 2. Launch system cooling loop offline - reset breaker FM29-63/A @ Sector 2
 3. Atmosphere pump offline - scan and repair

>look
Pod Control
This room serves as an airlock for the pod bay, and holds an old space suit and various machinery such as the atmosphere pump. There is a brass plate on the wall.

There is an open hatch in the ceiling.

Beside the secured port hatch, a status display shows an error message.

* * *

>gonear display
Pod Control
This room serves as an airlock for the pod bay, and holds an old space suit and various machinery such as the atmosphere pump. There is a brass plate on the wall.

There is a secured hatch in the ceiling.

Beside the secured port hatch, a status display shows an error message.

>x display
F.
Pod bay locked down
 1. Telemetry sensor array offline - reset breaker FM36-87/A @ hub platform
 2. Launch system cooling loop offline - reset breaker FM29-63/A @ Sector 2
 3. Pod control atmosphere pump offline - scan and repair

>x pump
The atmosphere pump is a smooth featureless machine. It contains a power module and a pressure regulation module.

* * *

>u
(first opening the ceiling hatch)

Sector 1: Crops
You still maintain the crops here. There is a small graveyard and the barn remains from when this was the livestock sector. A pylon stretches up from the ground to the hub of the station. You can walk spinward or antispinward.

There is an open hatch in the ground.

>purloin all modules
[Purloined.]
[Purloined.]
[Purloined.]
[Purloined.]
[Purloined.]
[Purloined.]
[Purloined.]

* * *

>d
Pod Control
This room serves as an airlock for the pod bay, and holds an old space suit and various machinery such as the atmosphere pump. There is a brass plate on the wall.

There is an open hatch in the ceiling.

Beside the secured port hatch, a status display shows an error message.

>x modules
You can't use multiple objects with that verb.

>x module
Which do you mean, a pressure regulation module, an instruction module, or a power module?

>i
You are carrying:
  two pressure regulation modules
  two instruction modules
  three power modules
  a scanner
  a green jumpsuit (being worn)

>san pressure
That's not a verb I recognize.

>scan pressure
Module is functional.

>put functional pressure in pump
You put the functional pressure regulation module into the atmosphere pump.

>scan power
Module is functional.

* * *

>put functional power in pump
You put the functional power module into the atmosphere pump.

The atmosphere pump begins to hum.

[Your score has just gone up by one point.]

>x displa
You can't see any such thing.

* * *

>x display
Pod bay locked down
 1. Telemetry sensor array offline - reset breaker FM36-87/A @ hub platform
 2. Launch system cooling loop offline - reset breaker FM29-63/A @ Sector 2
 3. Secure pod control hatch

>close ceiling hatch
You close the ceiling hatch.

>x display
Pod bay locked down
 1. Telemetry sensor array offline - reset breaker FM36-87/A @ hub platform
 2. Launch system cooling loop offline - reset breaker FM29-63/A @ Sector 2

>gonear red
(the red circuit breaker)
Platform 3
A mesh platform about two thirds of the way towards the hub. You can continue spinward or antispinward.

You feel much lighter here, and you are very aware of how the station rotates, but everything is okay as long as you don't look down.

There is a red circuit breaker here.

>turn red off
That's already off.

>turn red on
You reach out and switch the circuit breaker on.

[Your score has just gone up by one point.]

>gonear display
Pod Control
This room serves as an airlock for the pod bay, and holds an old space suit and various machinery such as the atmosphere pump. There is a brass plate on the wall.

There is a secured hatch in the ceiling.

Beside the secured port hatch, a status display shows an error message.

>x display
Pod bay locked down
 1. Launch system cooling loop offline - reset breaker FM29-63/A @ Sector 2

* * *

>gonear doll
House
Two families lived here, but not recently.

Someone has left a doll on the well swept floor.

>play with doll
You can't see any such thing.

>x doll
Wearing a brown jumpsuit and faceless, because we are all alike in the Founder's eyes. It was yours once, but you passed it on with other childish things when you were old enough to help in the fields.

* * *

>gonear doll
House
Two families lived here, but not recently.

Someone has left a doll on the well swept floor.

>x doll
Wearing a brown jumpsuit and faceless, because we are all alike in the Founder's eyes. It was yours once, but you passed it on with other childish things when you were old enough to help in the fields.

>dd
That's not a verb I recognize.

>d
The only exit is outside to sector 3.

>u
The only exit is outside to sector 3.

>gonear yellow
Inside the Hub
You float weightless in the middle of a cylinder. A ladder rotates around you, leading up or down or maybe out.

A yellow cable flaps from a small panel.

>exits
The only exit is outside to platform 1.

>out
You struggle a little to make sure you are heading legs first and follow the ladder.

Platform 1
A mesh platform about two thirds of the way towards the hub. You can continue spinward or antispinward, or go up a ladder into the hub.

>u
Inside the Hub
You float weightless in the middle of a cylinder. A ladder rotates around you, leading up or down or maybe out.

A yellow cable flaps from a small panel.

>scanner, open cable
Cable is unitary.

>scanner, diagnose cable
Syntax error: command not in vocabulary.

[You can ask the scanner for a list of commands by typing "scanner, help" and give it voice commands by typing phrases such as "scanner, scan SOMETHING" or "scanner, open SOMETHING" where SOMETHING is a visible object.]

*** Run-time problem P39: Attempt to say a snippet value which is currently invalid: words 0 to 4.

>scanner, jksjdkf
Syntax error: command not in vocabulary.

*** Run-time problem P39: Attempt to say a snippet value which is currently invalid: words 0 to 3.

>scanner, help
Recognized commands are "help", "open", and "scan".

[You can ask the scanner for a list of commands by typing "scanner, help" and give it voice commands by typing phrases such as "scanner, scan SOMETHING" or "scanner, open SOMETHING" where SOMETHING is a visible object.]

>scanner, jkjkjkjkjkjk
Syntax error: command not in vocabulary.

*** Run-time problem P39: Attempt to say a snippet value which is currently invalid: words 0 to 3.

>scanner, go north
Syntax error: command not in vocabulary.

>d
You fight off a moment of vertigo and climb the ladder.

Platform 1
A mesh platform about two thirds of the way towards the hub. You can continue spinward or antispinward, or go up a ladder into the hub.

>scanner, jkjk
Syntax error: command not in vocabulary.

*** Run-time problem P39: Attempt to say a snippet value which is currently invalid: words 0 to 3.

* * *

>gonear eraser
School House
A broken learning machine remains in a corner, but mostly the older farmers took turns leading the class. There is a desk, and a chalkboard hangs on one wall.

On the desk is a clean eraser.

* * *

>erase board
(with the eraser)
You carefully erase the chalkboard.

>gonear boots
Supply Vault
This room is dim, quiet, and stuffy. There is still one crate of machine parts left.

There is a secured hatch in the ceiling.

You can also see a pair of gravity boots here.

>get boots
Taken.

>hit eraser
You fill the vault with a cloud of dust which scatters the laser beam that you can now see scanning across the hatch.

>u
You maneuver around the laser beam and pull yourself up through the ceiling hatch2.

(first opening the ceiling hatch)
You maneuver around the laser beam and open the ceiling hatch.

Sector 6: Hydroponics
Your people preferred to grow things the old fashioned way, but in truth the majority of your fruit and vegetables came from this sector when the machines still worked. You can walk spinward or antispinward.

There is an open hatch in the ground.

[Your score has just gone up by one point.]

>undo
Supply Vault
[Previous turn undone.]

* * *

>erase board
(with the eraser)
You carefully erase the chalkboard.

>gonear crate
Supply Vault
This room is dim, quiet, and stuffy. There is still one crate of machine parts left.

There is a secured hatch in the ceiling.

You can also see a pair of gravity boots here.

* * *

>u
An alarm sounds, and a synthesized voice says "Laser scan detects unauthorized materiel removal."

The hatch seems to be locked.

>close hatch
That's already closed.

>hit eraser
You fill the vault with a cloud of dust which scatters the laser beam that you can now see scanning across the hatch.

>u
You maneuver around the laser beam, open the ceiling hatch, and pull yourself up through it.

(first opening the ceiling hatch)
You maneuver around the laser beam and open the ceiling hatch.

Sector 6: Hydroponics
Your people preferred to grow things the old fashioned way, but in truth the majority of your fruit and vegetables came from this sector when the machines still worked. You can walk spinward or antispinward.

There is an open hatch in the ground.

[Your score has just gone up by one point.]

* * *

>gonear crate
Supply Vault
This room is dim, quiet, and stuffy. There is still one crate of machine parts left.

There is a secured hatch in the ceiling.

You can also see a pair of gravity boots here.

>open hatch
You open the ceiling hatch.

* * *

>hit eraser
You fill the vault with a cloud of dust which scatters the laser beam that you can now see scanning across the hatch.

>open hatch
You maneuver around the laser beam.

You maneuver around the laser beam and open the ceiling hatch.

>open hatch
That's already open.

* * *

>gonear eraser
School House
A broken learning machine remains in a corner, but mostly the older farmers took turns leading the class. There is a desk, and a chalkboard hangs on one wall.

On the desk is a clean eraser.

>out
Sector 5: Forest
The school house is nestled among the trees. A pylon stretches up from the same grove to the hub of the station. You can walk spinward or antispinward.

>in
School House
A broken learning machine remains in a corner, but mostly the older farmers took turns leading the class. There is a desk, and a chalkboard hangs on one wall.

On the desk is a clean eraser.

>get it
That's hardly portable.

>nouns
At the moment, "it" means the desk, "him" is unset, "her" is unset, and "them" is unset.

>get eraser
Taken.

* * *

>open hatch
You maneuver around the laser beam and open the ceiling hatch.

>undo
Supply Vault
[Previous turn undone.]

>u
(first opening the ceiling hatch)
You maneuver around the laser beam, open the ceiling hatch, and pull yourself up through it.

Sector 6: Hydroponics
Your people preferred to grow things the old fashioned way, but in truth the majority of your fruit and vegetables came from this sector when the machines still worked. You can walk spinward or antispinward.

There is an open hatch in the ground.

[Your score has just gone up by one point.]

* * *

>gonear gray
Church
Before everyone left or died, you celebrated every sabbath here. The altar stands against one wall, and an organ and a portable audio unit stand against the other.

On the altar is The Founder's Testament.

A gray cable connects the organ to the audio unit.

>x cable
A one meter USB 7.2 cable with a Type-F plug at each end.
It is plugged into the organ and an audio unit.

* * *

>gonear gray
Church
Before everyone left or died, you celebrated every sabbath here. The altar stands against one wall, and an organ and a portable audio unit stand against the other.

On the altar is The Founder's Testament.

A gray cable connects the organ to the audio unit.

>x gray
A one meter USB 7.2 cable with a Type-F plug at each end.It is plugged into the organ and an audio unit.

* * *

>gonear hub
(Inside the Hub)
Inside the Hub
You float weightless in the middle of a cylinder. A ladder rotates around you, leading up or down or maybe out.

A yellow cable flaps from a small panel.

>d
"L" = list of things: {yellow cable}
You feel that you shouldn't leave the yellow cable behind in case it floats off.

* * *

>gonear ladder
Platform 1
A mesh platform about two thirds of the way towards the hub. You can continue spinward or antispinward, or go up a ladder into the hub.

* * *

>u
Inside the Hub
You are weightless, so instead of up and down, you think of the ladder as leading "out."

>remove jumpsuit
Your nudity is pure and innocent, but still a little cold and uncomfortable.

>drop all
scanner: It floats nearby.
green jumpsuit: It floats nearby.

>look
Inside the Hub
You are weightless, so instead of up and down, you think of the ladder as leading "out."

You can see a green jumpsuit and a scanner floating here.

>x jumpsuit
You have worn modest jumpsuits like this since you were small. Originally, the colors had meanings: forest green for farmers, navy blue for technicians, and so on, but that distinction died even before the population.

It features a single large pocket, currently empty.

>put scanner in pocket
(first taking the scanner)
You put the scanner into the pocket.

>look
Inside the Hub
You are weightless, so instead of up and down, you think of the ladder as leading "out."

You can see a green jumpsuit floating here.

>x jumpsuit
You have worn modest jumpsuits like this since you were small. Originally, the colors had meanings: forest green for farmers, navy blue for technicians, and so on, but that distinction died even before the population.

The pocket contains a scanner.

I beg your pardon?

>look
Inside the Hub
You are weightless, so instead of up and down, you think of the ladder as leading "out."

You can see a green jumpsuit floating here.

>analyze
(the green jumpsuit)
examining the green jumpsuit:
You have worn modest jumpsuits like this since you were small. Originally, the colors had meanings: forest green for farmers, navy blue for technicians, and so on, but that distinction died even before the population.

The pocket contains a scanner.

looking under the green jumpsuit:
You find nothing of interest.

searching the green jumpsuit:
You find nothing of interest.

listening to the green jumpsuit:
You hear nothing unexpected.

smelling the green jumpsuit:
You smell nothing unexpected.

attacking the green jumpsuit:
The Founder said that violence is never the answer.

buying the green jumpsuit:
Nothing is on sale.

climbing the green jumpsuit:
Little is to be achieved by that.

pulling the green jumpsuit:
Nothing obvious happens.

pushing the green jumpsuit:
Nothing obvious happens.

turning the green jumpsuit:
Nothing obvious happens.

pushing the green jumpsuit to outside:
The green jumpsuit cannot be pushed from place to place.

opening the green jumpsuit:
It isn't something you can open.

entering the green jumpsuit:
That's not something you can enter.

getting off the green jumpsuit:
But you aren't on the green jumpsuit at the moment.

closing the green jumpsuit:
It isn't something you can close.

taking the green jumpsuit:
Taken.

switching on the green jumpsuit:
It isn't something you can switch.

switching off the green jumpsuit:
It isn't something you can switch.

wearing the green jumpsuit:
You put on the green jumpsuit.

taking off the green jumpsuit:
Your nudity is pure and innocent, but still a little cold and uncomfortable.

(no other people in the location; can't test throwing at.)

(no other people in the location; can't test showing to.)

(no other people in the location; can't test giving to.)

touching the green jumpsuit:
You feel nothing unexpected.

rubbing the green jumpsuit:
You rub the green jumpsuit.

waving the green jumpsuit:
You wave the green jumpsuit.

squeezing the green jumpsuit:
You achieve nothing by this.

burning the green jumpsuit:
There is no open flame on the station.

cutting the green jumpsuit:
The Founder said that violence is never the answer.

tying the green jumpsuit to yourself:
You would achieve nothing by this.

swinging the green jumpsuit:
There's nothing sensible to swing here.

tasting the green jumpsuit:
You taste nothing unexpected.

drinking the green jumpsuit:
There's nothing suitable to drink here.

eating the green jumpsuit:
That's plainly inedible.

dropping the green jumpsuit:
It floats nearby.

>get jumpsuit
Taken.

>wear jumpsuit
You put on the green jumpsuit.

>analyze
(the green jumpsuit)
examining the green jumpsuit:
You have worn modest jumpsuits like this since you were small. Originally, the colors had meanings: forest green for farmers, navy blue for technicians, and so on, but that distinction died even before the population.

The pocket contains a scanner.

looking under the green jumpsuit:
You find nothing of interest.

searching the green jumpsuit:
You find nothing of interest.

listening to the green jumpsuit:
You hear nothing unexpected.

smelling the green jumpsuit:
You smell nothing unexpected.

attacking the green jumpsuit:
The Founder said that violence is never the answer.

buying the green jumpsuit:
Nothing is on sale.

climbing the green jumpsuit:
Little is to be achieved by that.

pulling the green jumpsuit:
Nothing obvious happens.

pushing the green jumpsuit:
Nothing obvious happens.

turning the green jumpsuit:
Nothing obvious happens.

pushing the green jumpsuit to outside:
The green jumpsuit cannot be pushed from place to place.

opening the green jumpsuit:
It isn't something you can open.

entering the green jumpsuit:
That's not something you can enter.

getting off the green jumpsuit:
But you aren't on the green jumpsuit at the moment.

closing the green jumpsuit:
It isn't something you can close.

taking the green jumpsuit:
You already have that.

switching on the green jumpsuit:
It isn't something you can switch.

switching off the green jumpsuit:
It isn't something you can switch.

wearing the green jumpsuit:
You're already wearing that!

taking off the green jumpsuit:
Your nudity is pure and innocent, but still a little cold and uncomfortable.

(no other people in the location; can't test throwing at.)

(no other people in the location; can't test showing to.)

(no other people in the location; can't test giving to.)

touching the green jumpsuit:
You feel nothing unexpected.

rubbing the green jumpsuit:
You rub the green jumpsuit.

waving the green jumpsuit:
You wave the green jumpsuit.

squeezing the green jumpsuit:
You achieve nothing by this.

burning the green jumpsuit:
There is no open flame on the station.

cutting the green jumpsuit:
The Founder said that violence is never the answer.

tying the green jumpsuit to yourself:
You would achieve nothing by this.

swinging the green jumpsuit:
There's nothing sensible to swing here.

tasting the green jumpsuit:
You taste nothing unexpected.

drinking the green jumpsuit:
There's nothing suitable to drink here.

eating the green jumpsuit:
That's plainly inedible.

dropping the green jumpsuit:
It floats nearby.

>nounless
taking inventory:
You are carrying nothing.

jumping:
You jump on the spot.

thinking:
What a good idea.

waiting:
Time passes.

sleeping:
You aren't feeling especially drowsy.

waking up:
The dreadful truth is, this is not a dream.

waving hands:
You wave.

saying yes:
That was a rhetorical question.

saying no:
That was a rhetorical question.

nounless listening:
You hear only the familiar hum of the station.

nounless smelling:
Only familiar odors.

>push
(the green jumpsuit)
Nothing obvious happens.

>swim
There's nothing to swim in.

* * *

>gonear ladder
Platform 1
A mesh platform about two thirds of the way towards the hub. You can continue spinward or antispinward, or go up a ladder into the hub.

>asw
Platform 5
A mesh platform about two thirds of the way towards the hub. You can continue spinward or antispinward.

>asw
Platform 3
A mesh platform about two thirds of the way towards the hub. You can continue spinward or antispinward.

You feel much lighter here, and you are very aware of how the station rotates, but everything is okay as long as you don't look down.

There is a red circuit breaker here.

>asw
Platform 1
A mesh platform about two thirds of the way towards the hub. You can continue spinward or antispinward, or go up a ladder into the hub.

>asw
Platform 5
A mesh platform about two thirds of the way towards the hub. You can continue spinward or antispinward.

>asw
Platform 3
A mesh platform about two thirds of the way towards the hub. You can continue spinward or antispinward.

There is a red circuit breaker here.

>look
Platform 3
A mesh platform about two thirds of the way towards the hub. You can continue spinward or antispinward.

There is a red circuit breaker here.

>asw
Platform 1
A mesh platform about two thirds of the way towards the hub. You can continue spinward or antispinward, or go up a ladder into the hub.

>u
Gravity fades as you climb.

Inside the Hub
You float weightless in the middle of a cylinder. A ladder rotates around you, leading up or down or maybe out.

A yellow cable waves from a small panel.

>restart
Are you sure you want to restart?

>yes
You awake. You are lonely, so lonely. It was a thousand days ago today. All alone these thousand days. Your parents were the last. No, your father was the last. He held on for nearly a hundred days longer. No, you are the last. Alone. Adrift.

But maybe it isn't hopeless. There must still be other people in other worlds, and you think you know how to get there.

Today is the day.

Founder's Mercy
A Space Story by Thomas Insel
Release 1 / Serial number 181208 / Inform 7 build 6M62 (I6/v6.33 lib 6/12N) SD
Type "about" for credits or "hint" for assistance.

Home
The room where you've slept your entire life. You can go out to your crops.

There is a secured hatch in the floor.

>out
Sector 4: Crops
Your home is here among the crops. You can walk spinward or antispinward.

* * *

>asw
You walk a little ways to the next sector.

Sector 3: Forest
Trees, a house, and a church. A red pylon stretches up from the ground to the hub of the station. You can walk spinward or antispinward.

>house
House
Two families lived here, but not recently.

Someone has left a doll on the well swept floor.

* * *

>out
Sector 3: Forest
Trees, a house, and a church. A red pylon stretches up from the ground to the hub of the station. You can walk spinward or antispinward.

>exits
The exits are starboard to the house, port to the church, spinward to sector 4, and antispinward to sector 2.

* * *

>gonear ladder
Platform 1
A mesh platform about two thirds of the way towards the hub. You can continue spinward or antispinward, or go up a ladder into the hub.

>d
You slide down the pylon.

Sector 1: Crops
You still maintain the crops here. There is a small graveyard and the barn remains from when this was the livestock sector. A pylon stretches up from the ground to the hub of the station. You can walk spinward or antispinward.

There is a secured hatch in the ground.

>u
The pylon is slick metal with no obvious handholds.

>gonear yellow
Inside the Hub
You float weightless in the middle of a cylinder. A ladder rotates around you, leading up or down or maybe out.

A yellow cable flaps from a small panel.

>d
"L" = list of things: {ladder, yourself, panel, yellow cable}
"L" = list of things: {}

You fight off a moment of vertigo and climb the ladder.

Platform 1
A mesh platform about two thirds of the way towards the hub. You can continue spinward or antispinward, or go up a ladder into the hub.

>u
Inside the Hub
You float weightless in the middle of a cylinder. A ladder rotates around you, leading up or down or maybe out.

A yellow cable flaps from a small panel.

>get yellow
Taken.

>d
"L" = list of things: {ladder, yourself, panel}
"L" = list of things: {}

The yellow cable is permanently attached to the panel, so you must drop it before leaving.

* * *

>gonear ladder
Platform 1
A mesh platform about two thirds of the way towards the hub. You can continue spinward or antispinward, or go up a ladder into the hub.

>exits
The exits are up, down to sector 1, spinward to platform 3, and antispinward to platform 5.

>u
Gravity fades as you climb.

Inside the Hub
You float weightless in the middle of a cylinder. A ladder rotates around you, leading up or down or maybe out.

>exits
The exits are outside to platform 1, starboard, and port.

>port
Port End
You float weightless at the port end of a cylinder.

A yellow cable waves from a small panel.

>look
Port End
You float weightless at the port end of a cylinder.

A yellow cable waves from a small panel.

>exits
The only exit is starboard to inside the hub.

>s
Inside the Hub
You float weightless in the middle of a cylinder. A ladder rotates around you, leading up or down or maybe out.

>exits
The exits are outside to platform 1, starboard, and port to port end.

* * *

>exits
The exits are up, down to sector 1, spinward to platform 3, and antispinward to platform 5.

>up
Inside the Hub
You float weightless in the middle of a cylinder. A ladder rotates around you, leading up or down or maybe out.

A yellow cable waves from a small panel.

>exits
The only exit is outside to platform 1.

>d
You struggle a little to make sure you are heading legs first and follow the ladder.

Platform 1
A mesh platform about two thirds of the way towards the hub. You can continue spinward or antispinward, or go up a ladder into the hub.

>exits
The exits are up to inside the hub, down to sector 1, spinward to platform 3, and antispinward to platform 5.

* * *

>gonear ladder
Platform 1
A mesh platform about two thirds of the way towards the hub. You can continue spinward or antispinward, or go up a ladder into the hub.

>gonear panel
(the solar panels)
Platform 1
A mesh platform about two thirds of the way towards the hub. You can continue spinward or antispinward, or go up a ladder into the hub.

>d
You slide down the pylon.

Sector 1: Crops
You still maintain the crops here. There is a small graveyard and the barn remains from when this was the livestock sector. A pylon stretches up from the ground to the hub of the station. You can walk spinward or antispinward.

There is a secured hatch in the ground.

>gonear panel
(the solar panels)
Sector 1: Crops
You still maintain the crops here. There is a small graveyard and the barn remains from when this was the livestock sector. A pylon stretches up from the ground to the hub of the station. You can walk spinward or antispinward.

There is a secured hatch in the ground.

>gonear yellow
Inside the Hub
You float weightless in the middle of a cylinder. A ladder rotates around you, leading up or down or maybe out.

A yellow cable flaps from a small panel.

>d
"L" = list of things: {ladder, yourself, panel, yellow cable}
 the ladder  "item" = thing: ladder
 yourself  "item" = thing: yourself
 the panel  "item" = thing: panel
 the yellow cable  "item" = thing: yellow cable
"L" = list of things: {ladder, panel, yellow cable}
You feel that you shouldn't leave the yellow cable behind in case it floats off.

* * *

>gonear ladder
Platform 1
A mesh platform about two thirds of the way towards the hub. You can continue spinward or antispinward, or go up a ladder into the hub.

>in
You can't go inside, but you can go up, down to sector 1, spinward to platform 3, or antispinward to platform 5.

>showme center of the hub
There seems to be no such object anywhere in the model world.

>showme inside the hub
Inside the Hub - room
singular-named, proper-named; lighted, unvisited, unfamiliar
list grouping key: none
printed name: "Inside the Hub"
printed plural name: none
indefinite article: none
description: "You float weightless in the middle of a cylinder. A ladder rotates around you, leading up or down or maybe out, and you can continue port or starboard inside the hub."
map region: Zero-G
destination name: "the center of the hub"

>exits
The exits are up, down to sector 1, spinward to platform 3, and antispinward to platform 5.

>u
Gravity fades as you climb.

Inside the Hub
You float weightless in the middle of a cylinder. A ladder rotates around you, leading up or down or maybe out, and you can continue port or starboard inside the hub.

>d
You make sure you are heading legs first and follow the ladder.

Platform 1
A mesh platform about two thirds of the way towards the hub. You can continue spinward or antispinward, or go up a ladder into the hub.

>s
You can't go starboard, but you can go up to the center of the hub, down to sector 1, spinward to platform 3, or antispinward to platform 5.

>u
Gravity fades as you climb.

Inside the Hub
You float weightless in the middle of a cylinder. A ladder rotates around you, leading up or down or maybe out, and you can continue port or starboard inside the hub.

>u
You fight off a moment of vertigo and climb the ladder.

Platform 1
A mesh platform about two thirds of the way towards the hub. You can continue spinward or antispinward, or go up a ladder into the hub.

>d
You slide down the pylon.

Sector 1: Crops
You still maintain the crops here. There is a small graveyard and the barn remains from when this was the livestock sector. A pylon stretches up from the ground to the hub of the station. You can walk spinward or antispinward.

There is a secured hatch in the ground.

>sw
You walk a little ways to the next sector.

Sector 2: Aquaculture
A deep pond is used as part of the water filtration system and for raising fish. You can walk spinward or antispinward.

>gonear ladder
Platform 1
A mesh platform about two thirds of the way towards the hub. You can continue spinward or antispinward, or go up a ladder into the hub.

>u
Gravity fades as you climb.

Inside the Hub
You float weightless in the middle of a cylinder. A ladder rotates around you, leading up or down or maybe out, and you can continue port or starboard inside the hub.

>sw
You can't go spinward, but you can go outside to platform 1, starboard, or port.

>s
Starboard End
You float weightless at the starboard end of a cylinder.

>exits
The only exit is port to the center of the hub.

>p
Inside the Hub
You float weightless in the middle of a cylinder. A ladder rotates around you, leading up or down or maybe out, and you can continue port or starboard inside the hub.

>p
Port End
You float weightless at the port end of a cylinder.

A yellow cable waves from a small panel.

>p
The only exit is starboard to the center of the hub.

>s
Inside the Hub
You float weightless in the middle of a cylinder. A ladder rotates around you, leading up or down or maybe out, and you can continue port or starboard inside the hub.

>exits
The exits are outside to platform 1, starboard to the starboard end of the hub, and port to the port end of the hub.

* * *

>gonear ladder
Platform 1
A mesh platform about two thirds of the way towards the hub. You can continue spinward or antispinward, or go up a ladder into the hub.

>look
Platform 1
A mesh platform about two thirds of the way towards the hub. You can continue spinward or antispinward, or go up a ladder into the hub.

>u
Inside the Hub
You float weightless in the middle of a cylinder. A ladder leads up or down or maybe out.

>d
You struggle a little to make sure you are heading legs first and follow the ladder.

Platform 1
A mesh platform about two thirds of the way towards the hub. You can continue spinward or antispinward, or go up a ladder into the hub.

>u
Inside the Hub
You float weightless in the middle of a cylinder. A ladder leads up or down or maybe out.

>look
Inside the Hub
You float weightless in the middle of a cylinder. A ladder leads up or down or maybe out.

>i
You are carrying:
  a scanner
  a green jumpsuit (being worn)

>get scanner
You already have that.

>drop scanner
You drop the scanner and it floats nearby.

>d
You feel that you shouldn't leave the scanner behind.

* * *

>gonear ladder
Platform 1
A mesh platform about two thirds of the way towards the hub. You can continue spinward or antispinward, or go up a ladder into the hub.

>purloin boots
[Purloined.]

>drop boots
You drop the pair of gravity boots and it spirals off to the ground below.

>undo
Platform 1
[Previous turn undone.]

>u
Inside the Hub
You float weightless in the middle of a cylinder. A ladder leads up or down or maybe out.

>drop boots
It floats nearby.

* * *

>gonear ladder
Platform 1
A mesh platform about two thirds of the way towards the hub. You can continue spinward or antispinward, or go up a ladder into the hub.

>u
Gravity fades as you climb.

Inside the Hub
You float weightless in the middle of a cylinder. It is colder up here, and the light is all artifical but without an obvious source. A ladder rotates around you, leading up or down or maybe out, and you can continue port or starboard inside the hub.

>d
You struggle a little to make sure you are heading legs first and follow the ladder.

Platform 1
A mesh platform about two thirds of the way towards the hub. You can continue spinward or antispinward, or go up a ladder into the hub.

>d
No.

* * *

>u
Inside the Hub
You float weightless in the middle of a cylinder. A ladder leads up or down or maybe out.

>drop all
scanner: You drop the scanner and it floats nearby.

>d
You feel that you shouldn't leave the scanner behind.

>u
You feel that you shouldn't leave the scanner behind.

>purloin modules
[Purloined.]
[Purloined.]
[Purloined.]
[Purloined.]
[Purloined.]
[Purloined.]
[Purloined.]

>drop all
pressure regulation module: You drop the pressure regulation module and it floats nearby.
instruction module: You drop the instruction module and it floats nearby.
instruction module: You drop the instruction module and it floats nearby.
power module: You drop the power module and it floats nearby.
power module: You drop the power module and it floats nearby.
pressure regulation module: You drop the pressure regulation module and it floats nearby.
power module: You drop the power module and it floats nearby.

>d
You feel that you shouldn't leave the instruction module behind.

>d
You feel that you shouldn't leave the instruction module behind.

>look
Inside the Hub
You float weightless in the middle of a cylinder. A ladder leads up or down or maybe out.

You can see three power modules, two pressure regulation modules, two instruction modules, and a scanner floating here.

>d
You feel that you shouldn't leave the pressure regulation module behind.

>d
You feel that you shouldn't leave the instruction module behind.

>d
You feel that you shouldn't leave the pressure regulation module behind.

* * *

>d
You feel that you shouldn't leave the instruction module behind.

>d
You feel that you shouldn't leave the power module behind.

>d
You feel that you shouldn't leave the scanner behind.

>d
You feel that you shouldn't leave the power module behind.

>d
You feel that you shouldn't leave the instruction module behind.

* * *

>d
You feel that you shouldn't leave the pressure regulation module behind.

>d
You feel that you shouldn't leave the scanner behind.

* * *

>d
You feel that you shouldn't leave the power module behind.

>d
You feel that you shouldn't leave the pressure regulation module behind.

* * *

>u
You feel that you shouldn't leave the scanner behind.

>remove all
(the green jumpsuit)
Your nudity is pure and innocent, but still a little cold and uncomfortable.

>drop suit
You drop the green jumpsuit and it floats nearby.

>d
the green jumpsuit and the scanner.

You struggle a little to make sure you are heading legs first and follow the ladder.

Platform 1
A mesh platform about two thirds of the way towards the hub. You can continue spinward or antispinward, or go up a ladder into the hub.

* * *

>u
You feel that you shouldn't leave the scanner behind.

>s
The only exit is outside to platform 1.

>look
Inside the Hub
You float weightless in the middle of a cylinder. A ladder leads up or down or maybe out.

You can see a scanner floating here.

>i
You are carrying:
  a green jumpsuit (being worn)

>get jumpsuit
You already have that.

>remove jumpsuit
Your nudity is pure and innocent, but still a little cold and uncomfortable.

>drop it
You drop the green jumpsuit and it floats nearby.

>look
Inside the Hub
You float weightless in the middle of a cylinder. A ladder leads up or down or maybe out.

You can see a green jumpsuit and a scanner floating here.

>d
You feel that you shouldn't leave the green jumpsuit and the scanner behind.

* * *

>u
Gravity fades as you climb.

Inside the Hub
You float weightless in the middle of a cylinder. It is colder up here, and the light is all artifical but without an obvious source. A ladder rotates around you, leading up or down or maybe out, and you can continue port or starboard inside the hub.

>drop all
scanner: You drop the scanner and it floats nearby.

* * *

>u
Gravity fades as you climb.

Inside the Hub
You float weightless in the middle of a cylinder. It is colder up here, and the light is all artifical but without an obvious source. A ladder rotates around you, leading up or down or maybe out, and you can continue port or starboard inside the hub.

>drop boots
You can't see any such thing.

>look
Inside the Hub
You float weightless in the middle of a cylinder. A ladder leads up or down or maybe out.

>purloin boots
[Purloined.]

>rop all
That's not a verb I recognize.

>drop all
pair of gravity boots: You drop the pair of gravity boots, and it floats nearby.
scanner: You drop the scanner, and it floats nearby.

* * *

>u
Gravity fades as you climb.

Inside the Hub
You float weightless in the middle of a cylinder. It is colder up here, and the light is all artifical but without an obvious source. A ladder rotates around you, leading up or down or maybe out, and you can continue port or starboard inside the hub.

>drop scanner
You drop the scanner and it floats nearby.

>d
You feel that you shouldn't leave the scanner behind in case it floats off.

>u
You feel that you shouldn't leave the scanner behind in case it floats off.

>s
The only exit is outside to platform 1.

>p
The only exit is outside to platform 1.

* * *

>d
You feel that you shouldn't leave the scanner behind in case it floats off.

>x scanner
The handheld voice-activated scanner you use when working on the station's machines.

[You can ask the scanner for a list of commands by typing "scanner, help" and give it voice commands by typing phrases such as "scanner, scan SOMETHING" or "scanner, open SOMETHING" where SOMETHING is a visible object.]

>x gravity
You can't see any such thing.

>d
You feel that you shouldn't leave the scanner behind in case it floats off.

>look
Inside the Hub
You float weightless in the middle of a cylinder. A ladder rotates around you, leading up or down or maybe out.

A yellow cable waves from a small panel.

You can also see a scanner floating here.

* * *

>drop scanner
You drop the scanner and it floats nearby.

>look
Inside the Hub
You are weightless, so instead of up and down, you think of the ladder as leading "out."

You can see a scanner floating here.

>remove jumpsuit
Your nudity is pure and innocent, but still a little cold and uncomfortable.

>look
Inside the Hub
You are weightless, so instead of up and down, you think of the ladder as leading "out."

You can see a scanner floating here.

>drop jumpsuit
Dropped.

>look
Inside the Hub
You are weightless, so instead of up and down, you think of the ladder as leading "out."

You can see a green jumpsuit and a scanner floating here.

* * *

>u
Gravity fades as you climb.

Inside the Hub
You float weightless in the middle of a cylinder. It is colder up here, and the light is all artifical but without an obvious source. A ladder rotates around you, leading up or down or maybe out, and you can continue port or starboard inside the hub.

>i
You are carrying:
  a scanner
  a green jumpsuit (being worn)

>drop scanner
Dropped.

>look
Inside the Hub
You float weightless in the middle of a cylinder. A ladder rotates around you, leading up or down or maybe out.

A yellow cable waves from a small panel.

You can also see a scanner floating here.

>d
You struggle a little to make sure you are heading legs first and follow the ladder.

Platform 1
A mesh platform about two thirds of the way towards the hub. You can continue spinward or antispinward, or go up a ladder into the hub.

>u
Inside the Hub
You float weightless in the middle of a cylinder. A ladder rotates around you, leading up or down or maybe out.

A yellow cable waves from a small panel.

You can also see a scanner floating here.

* * *

>drop scanner
Dropped.

>ook
That's not a verb I recognize.

>look
Inside the Hub
You float weightless in the middle of a cylinder. A ladder leads up or down or maybe out.

You can see a scanner floating here.

>d
You feel that you shouldn't leave the scanner behind or it might float off.

* * *

>u
Gravity fades as you climb.

Inside the Hub
You float weightless in the middle of a cylinder. It is colder up here, and the light is all artifical but without an obvious source. A ladder rotates around you, leading up or down or maybe out, and you can continue port or starboard inside the hub.

>look
Inside the Hub
You float weightless in the middle of a cylinder.  A ladder leads up or down or maybe out.

>i
You are carrying:
  a scanner
  a green jumpsuit (being worn)

>purloin boots
[Purloined.]

>drop boots
It floats nearby.

>look
Inside the Hub
You float weightless in the middle of a cylinder.  A ladder leads up or down or maybe out.

You can see a pair of gravity boots floating here.

* * *

>u
Gravity fades as you climb.

Inside the Hub
You float weightless in the middle of a cylinder. It is colder up here, and the light is all artifical but without an obvious source. A ladder rotates around you, leading up or down or maybe out, and you can continue port or starboard inside the hub.

>out
You struggle a little to make sure you are heading legs first and follow the ladder.

Platform 1
A mesh platform about two thirds of the way towards the hub. You can continue spinward or antispinward, or go up a ladder into the hub.

>remove jumpsuit
Your nudity is pure and innocent, but still a little cold and uncomfortable.

>drop it
You drop the green jumpsuit and it spirals off to the ground below.

>u
Inside the Hub
You are weightless, so instead of up and down, you think of the ladder as leading "out."

A scanner is floating here.

* * *

>u
Gravity fades as you climb.

Inside the Hub
You float weightless in the middle of a cylinder. It is colder up here, and the light is all artifical but without an obvious source. A ladder rotates around you, leading up or down or maybe out, and you can continue port or starboard inside the hub.

>p
The passageway to the port is colder still, too cold for you in only your jumpsuit.

>purloin blanket
[Purloined.]

>wear blanket
You put on the blanket.

>port
Port End
You float weightless at the port end of a cylinder.

A yellow cable waves from a small panel.

>remove blanket
It is too cold here to even consider removing the blanket.

>drop blanket
(first taking the blanket off)
It is too cold here to even consider removing the blanket.

>drop jumpsuit
(first taking the green jumpsuit off)
It is too cold here to even consider removing the green jumpsuit.

* * *

>p
The passageway to the port is colder still, too cold for you in only your jumpsuit.

>s
Inside the Hub
You float weightless in the middle of a cylinder. A ladder rotates around you, leading up or down or maybe out.

>s
Starboard End

* * *

>u
Gravity fades as you climb.

Inside the Hub
You float weightless in the middle of a cylinder. It is colder up here, and the light is all artifical but without an obvious source. A ladder rotates around you, leading up or down or maybe out, and you can continue port or starboard inside the hub.

>port
The passageway to the port is colder still, too cold for you in only your jumpsuit.

>purloin blaket
There seems to be no such object anywhere in the model world.

>purloin blanket
[Purloined.]

* * *

>port
Port End
You float weightless at the port end of a cylinder.

A yellow cable waves from a small panel.

>i
You are carrying:
  a blanket (being worn)
  a scanner
  a green jumpsuit (being worn)

>x me
As virtuous as ever.

>s
Inside the Hub
You float weightless in the middle of a cylinder. It is colder up here, and the light is all artifical but without an obvious source. A ladder rotates around you, leading up or down or maybe out, and you can continue port or starboard inside the hub.

>remove blanket
You take off the blanket.

>remove jumpsuit
Your nudity is pure and innocent, but still a little cold and uncomfortable.

>port
The passageway to the port is colder still, too cold for you to bear nude.

>wear blanket
You put on the blanket.

>port
They passageway to the port is colder still, too cold for you wearing nothing under the blanket.

>i
You are carrying:
  a blanket (being worn)
  a scanner
  a green jumpsuit

>wear jumpsuit
You put on the green jumpsuit.

>remove blanket
You take off the blanket.

>port
The passageway to the port is colder still, too cold for you in only your jumpsuit.

* * *

>u
Gravity fades as you climb.

Inside the Hub
You float weightless in the middle of a cylinder. It is colder up here, and the light is all artifical but without an obvious source. A ladder rotates around you, leading up or down or maybe out, and you can continue port or starboard inside the hub.

>u
You struggle a little to make sure you are heading legs first and follow the ladder.

Platform 1
A mesh platform about two thirds of the way towards the hub. You can continue spinward or antispinward, or go up a ladder into the hub.

>u
Inside the Hub
You float weightless in the middle of a cylinder. A ladder rotates around you, leading up or down or maybe out.

>u
You fight off a moment of vertigo and climb the ladder.

Platform 1
A mesh platform about two thirds of the way towards the hub. You can continue spinward or antispinward, or go up a ladder into the hub.

>u
Inside the Hub
You float weightless in the middle of a cylinder. A ladder rotates around you, leading up or down or maybe out.

>u
You struggle a little to make sure you are heading legs first and follow the ladder.

Platform 1
A mesh platform about two thirds of the way towards the hub. You can continue spinward or antispinward, or go up a ladder into the hub.

* * *

>u
Inside the Hub
You float weightless in the middle of a cylinder. A ladder rotates around you, leading up or down or maybe out.

>u
You arrange yourself legs first and follow the ladder.

Platform 1
A mesh platform about two thirds of the way towards the hub. You can continue spinward or antispinward, or go up a ladder into the hub.

>u
Inside the Hub
You float weightless in the middle of a cylinder. A ladder rotates around you, leading up or down or maybe out.

* * *

>u
Gravity fades as you climb.

Inside the Hub
You float weightless in the middle of a cylinder. It is colder up here, and the light is all artifical but without an obvious source. A ladder rotates around you, leading up or down or maybe out, and you can continue port or starboard inside the hub.

>up
You struggle a little to make sure you are heading legs first and follow the ladder.

Platform 1
A mesh platform about two thirds of the way towards the hub. You can continue spinward or antispinward, or go up a ladder into the hub.

>up
Inside the Hub
You float weightless in the middle of a cylinder. A ladder rotates around you, leading up or down or maybe out.

>out
You struggle a little to make sure you are heading legs first and follow the ladder.

Platform 1
A mesh platform about two thirds of the way towards the hub. You can continue spinward or antispinward, or go up a ladder into the hub.

>look
Platform 1
A mesh platform about two thirds of the way towards the hub. You can continue spinward or antispinward, or go up a ladder into the hub.

>u
Inside the Hub
You float weightless in the middle of a cylinder. A ladder rotates around you, leading up or down or maybe out.

>drop all
scanner: You drop the scanner and it floats nearby.

>out
You feel that you shouldn't leave the scanner behind in case it floats off.

>get scanner
Taken.

>d
You struggle a little to make sure you are heading legs first and follow the ladder.

Platform 1
A mesh platform about two thirds of the way towards the hub. You can continue spinward or antispinward, or go up a ladder into the hub.

>look
Platform 1
A mesh platform about two thirds of the way towards the hub. You can continue spinward or antispinward, or go up a ladder into the hub.

>d
You slide down the pylon.

Sector 1: Crops
You still maintain the crops here. There is a small graveyard and the barn remains from when this was the livestock sector. A pylon stretches up from the ground to the hub of the station. You can walk spinward or antispinward.

There is a secured hatch in the ground.

>x ladder
You can't see any such thing.

>gonear ladder
Platform 1
A mesh platform about two thirds of the way towards the hub. You can continue spinward or antispinward, or go up a ladder into the hub.

>x ladder
A ladder leads up into the hub.

>u
Inside the Hub
You float weightless in the middle of a cylinder. A ladder rotates around you, leading up or down or maybe out.

>x ladder
A ladder leads up into the hub.

* * *

>u
Gravity fades as you climb.

Inside the Hub
You float weightless in the middle of a cylinder. It is colder up here, and the light is all artifical but without an obvious source. A ladder rotates around you, leading up or down or maybe out, and you can continue port or starboard inside the hub.

>x ladder
The ladder moves with the station, rotating several times around you.

>d
You struggle a little to make sure you are heading legs first and follow the ladder.

Platform 1
A mesh platform about two thirds of the way towards the hub. You can continue spinward or antispinward, or go up a ladder into the hub.

>x ladder
A ladder leads up into the hub.

* * *

>u
Gravity fades as you climb.

Inside the Hub
You float weightless in the middle of a cylinder. It is colder up here, and the light is all artifical but without an obvious source. A ladder rotates around you, leading up or down or maybe out, and you can continue port or starboard inside the hub.

>x panel
You see nothing special about the panel.

>look
Inside the Hub
You float weightless in the middle of a cylinder. A ladder rotates around you, leading up or down or maybe out.

>get panel
That's hardly portable.

* * *

>u
Gravity fades as you climb.

Inside the Hub
You float weightless in the middle of a cylinder. It is colder up here, and the light is all artifical but without an obvious source. A ladder rotates around you, leading up or down or maybe out, and you can continue port or starboard inside the hub.

>x scanner
The handheld voice-activated scanner you use when working on the station's machines.

[You can ask the scanner for a list of commands by typing "scanner, help" and give it voice commands by typing phrases such as "scanner, scan SOMETHING" or "scanner, open SOMETHING" where SOMETHING is a visible object.]

>d
You struggle a little to make sure you are heading legs first and follow the ladder.

Platform 1
A mesh platform about two thirds of the way towards the hub. You can continue spinward or antispinward, or go up a ladder into the hub.

* * *

>u
Inside the Hub
You float weightless in the middle of a cylinder. A ladder leads up or down or maybe out.

>drop scanner
You drop the scanner and it floats nearby.

* * *

>d
You feel that you shouldn't leave the scanner behind in case it floats off.

>look
Inside the Hub
You float weightless in the middle of a cylinder. A ladder leads up or down or maybe out.

You can see a scanner floating here.

* * *

>gonear ladder
Platform 1
A mesh platform about two thirds of the way towards the hub. You can continue spinward or antispinward, or go up a ladder into the hub.

>up
Inside the Hub
You float weightless in the middle of a cylinder. A ladder rotates around you, leading up or down or maybe out.

>d
yourself.

You struggle a little to make sure you are heading legs first and follow the ladder.

Platform 1
A mesh platform about two thirds of the way towards the hub. You can continue spinward or antispinward, or go up a ladder into the hub.

* * *

>up
Inside the Hub
You float weightless in the middle of a cylinder. A ladder rotates around you, leading up or down or maybe out.

>drop boots
You can't see any such thing.

>purloin boots
[Purloined.]

* * *

>drop boots
It floats nearby.

>x boots
Black work boots with red stripes. They don't really make gravity, but they do stick to some maintenance walkways to help workers get around in low gravity or on the outside of a rotating station.

>showme boots
pair of gravity boots - thing
location: in Inside the Hub
plural-named, improper-named; unlit, inedible, portable, wearable, handled
list grouping key: none
printed name: "pair of gravity boots"
printed plural name: none
indefinite article: none
description: "Black work boots with red stripes. They don't really make gravity, but they do stick to some maintenance walkways to help workers get around in low gravity or on the outside of a rotating station."
initial appearance: none

* * *

>up
Inside the Hub
You float weightless in the middle of a cylinder. A ladder rotates around you, leading up or down or maybe out.

>i
You are carrying:
  a scanner
  a green jumpsuit (being worn)

>drop all
scanner: Dropped.

>look
Inside the Hub
You are weightless, so instead of up and down, you think of the ladder as leading "out."

You can see a scanner here.

>i
You are carrying:
  a green jumpsuit (being worn)

* * *

>remove jumpsuit
Your nudity is pure and innocent, but still a little cold and uncomfortable.

>drop all
(the green jumpsuit)
Dropped.

>look
Inside the Hub
You are weightless, so instead of up and down, you think of the ladder as leading "out."

You can see a green jumpsuit and a scanner here.

* * *

>u
Inside the Hub
You float weightless in the middle of a cylinder. A ladder rotates around you, leading up or down or maybe out.

>x ladder
The ladder moves with the station, rotating several times around you every minute.

>jumpo
That's not a verb I recognize.

>jump
That's meaningless without gravity.

* * *

>gonear lader
There seems to be no such object anywhere in the model world.

>gonear ladder
Platform 1
A mesh platform about two thirds of the way towards the hub. You can continue spinward or antispinward, or go up a ladder into the hub.

>u
Gravity fades as you climb.

Inside the Hub
You float weightless in the middle of a cylinder. A ladder rotates around you, leading up or down or maybe out.

>asw
You can't go antispinward, but you can go outside to platform 1, starboard to starboard end, or port to port end.

>p
Port End
You float weightless at the port end of a cylinder.

A yellow cable waves from a small panel.

* * *

>u
Gravity fades as you climb.

Inside the Hub
You float weightless in the middle of a cylinder. A ladder rotates around you, leading up or down or maybe out.

>out
You make sure you are heading legs first and follow the ladder.

Platform 1
A mesh platform about two thirds of the way towards the hub. You can continue spinward or antispinward, or go up a ladder into the hub.

>u
Gravity fades as you climb.

Inside the Hub
You float weightless in the middle of a cylinder. A ladder rotates around you, leading up or down or maybe out.

>port
Port End
A yellow cable waves from a small panel.

>i
You are carrying:
  a scanner
  a green jumpsuit (being worn)

>drop scanner
You drop the scanner and it floats nearby.

>s
You feel that you shouldn't abondon the scanner floating in zero gravity.

* * *

>gonear laser
*** Run-time problem P61: Attempt to move the player off-stage.

>rstart
That's not a verb I recognize.

>restart
Are you sure you want to restart?

>yes
You awake. You are lonely, so lonely. It was a thousand days ago today. All alone these thousand days. Your parents were the last. No, your father was the last. He held on for nearly a hundred days longer. No, you are the last. Alone. Adrift.

But maybe it isn't hopeless. There must still be other people in other worlds, and you think you know how to get there.

Today is the day.

Founder's Mercy
A Space Story by Thomas Insel
Release 1 / Serial number 181207 / Inform 7 build 6M62 (I6/v6.33 lib 6/12N) SD
Type "about" for credits or "hint" for assistance.

Home
The room where you've slept your entire life. You can go out to your crops.

There is a secured hatch in the floor.

>showme laser beam
laser beam - thing
location: out of play
singular-named, improper-named; unlit, inedible, fixed in place, scenery; clean
list grouping key: none
printed name: "laser beam"
printed plural name: none
indefinite article: none
description: "The cloud of dust scatters the laser beam just enough that you can see it scan across the north passageway at seemingly random angles."
initial appearance: none

>showme laser
laser beam - thing
location: out of play
singular-named, improper-named; unlit, inedible, fixed in place, scenery; clean
list grouping key: none
printed name: "laser beam"
printed plural name: none
indefinite article: none
description: "The cloud of dust scatters the laser beam just enough that you can see it scan across the north passageway at seemingly random angles."
initial appearance: none

* * *

>gonear learning
School
A broken learning machine remains in a corner, but mostly the older farmers took turns leading the class. There is a desk, and a chalkboard hangs on one wall.

On the desk is a clean eraser.

>open learning
You will need to use the scanner to do that.

>scanner, open learning
Opening.

The learning machine swings open, revealing a power module and an instruction module.

[Your score has just gone up by one point.]

>look
School
A broken learning machine remains in a corner, but mostly the older farmers took turns leading the class. There is a desk, and a chalkboard hangs on one wall.

The learning machine is open and contains a power module and an instruction module.

On the desk is a clean eraser.

* * *

>gonear learning
School
A broken learning machine remains in a corner, but mostly the older farmers took turns leading the class. There is a desk, and a chalkboard hangs on one wall.

On the desk is a clean eraser.

>scanner, open learning
Opening.

The learning machine swings open, revealing a power module and an instruction module.

BOO>
[Your score has just gone up by one point.]

>z
Time passes.

BOO>

>z
Time passes.

BOO>

>close
What do you want to close?

>learning
You close the learning machine and it seals without any trace of a seam.

>scanner, open learninig
Search error: cannot find learninig.
[You can ask the scanner for a list of commands by typing "scanner, help" and give it voice commands by typing phrases such as "scanner, scan SOMETHING" or "scanner, open SOMETHING" where SOMETHING is a visible object.]

* * *

>gonear organ
Church
Before everyone left or died, you celebrated every sabbath here. The altar stands against one wall, and an organ and a portable audio unit stand against the other.

On the altar is The Founder's Testament.

A gray cable connects the organ to the audio unit.

>get cable
Taken.

>unplug cable from organ
You unplug the gray cable from the organ.

>plug cable into socket
Which do you mean, the tan socket or the beige socket?

>tan
You plug the gray cable into the tan socket.

>unplug cable from socket
Which do you mean, the tan socket or the beige socket?

>beige
You cannot specify a particular socket when unplugging something.

>gonear yellow
Inside the Hub
You float weightless in the middle of a cylinder. A ladder rotates around you, leading up or down or maybe out.

A yellow cable flaps from a small panel.

>x yellow
A yellow RF cable.

It is plugged into a panel.

>get yellow
Taken.

>i
You are carrying:
  a yellow cable (plugged into a panel)
  a gray cable (plugged into the organ and an audio unit)
  a scanner
  a green jumpsuit (being worn)

>out
The yellow cable pulls out of the panel.
The gray cable pulls out of the organ.
The gray cable pulls out of the audio unit.

You struggle a little to make sure you are heading legs first and follow the ladder.

Platform 1
A mesh platform about two thirds of the way towards the hub. You can continue spinward or antispinward, or go up a ladder into the hub.

>in
You can't go inside, but you can go up to inside the hub, down to sector 1, spinward to platform 3, or antispinward to platform 5.

>up
Inside the Hub
You float weightless in the middle of a cylinder. A ladder rotates around you, leading up or down or maybe out.

>plug yellow into panel
You plug the yellow cable into the panel.

>unplug yellow
(from the panel)
No.

>showme panel
(the panel)
panel - thing
    RF socket (part of panel) - RF socket
location: in Inside the Hub
singular-named, improper-named; unlit, inedible, fixed in place, scenery, machinelike
list grouping key: none
printed name: "panel"
printed plural name: none
indefinite article: none
description: none
initial appearance: none

* * *

>gonear organ
Church
Before everyone left or died, you celebrated every sabbath here. The altar stands against one wall, and an organ and a portable audio unit stand against the other.

On the altar is The Founder's Testament.

A gray cable connects the organ to the audio unit.

>x organ
It's really just a keyboard in a fancy box with a socket to connect it to an audio unit.

The organ has a gray cable plugged into it.

>x cable
A one meter USB 7.2 cable with a Type-F plug at each end. It is plugged into the organ and an audio unit.

>x organ
It's really just a keyboard in a fancy box with a socket to connect it to an audio unit.

The organ has a gray cable plugged into it.

>x audio
The audio unit incorporates a speaker, a microphone, and a socket you would use to connect it to another device. It contains a power module.

The audio unit has a gray cable plugged into it.

* * *

>gonear panel
Which do you mean, the solar panels or the antenna panel?

>antenna
Inside the Hub
You float weightless in the middle of a cylinder. A ladder rotates around you, leading up or down or maybe out.

A yellow cable waves from a small panel.

>x panel
Panel.

The antenna panel has a yellow cable plugged into it.

>scan panel
Machine is functional.

>scanner, open panel
Machine is unitary.

* * *

>gonear panel
Which do you mean, the solar panels or the antenna panel?

>gonear ivory
There seems to be no such object anywhere in the model world.

>purloin gray
[Purloined.]

>look
Home
The room where you've slept your entire life. You can go out towards the crops.

There is a secured hatch in the floor.

>i
You are carrying:
  a gray cable (plugged into the organ and an audio unit)
  a scanner
  a green jumpsuit (being worn)

>unplug gray
The gray cable is plugged into more than one thing.

[Try "unplug gray cable from SOMETHING".]

>unplug gray from organ
You can't see any such thing.

>gonear organ
Church
Before everyone left or died, you celebrated every sabbath here. The altar stands against one wall, and an organ and a portable audio unit stand against the other.

On the altar is The Founder's Testament.

>unplug gray from organ
You unplug the gray cable from the organ.

>unplug gray from all
You can't see any such thing.

>unplug gray from audio
You unplug the gray cable from the audio unit.

>get cable
You already have that.

>gonear ivory
There seems to be no such object anywhere in the model world.

>x panel
You can't see any such thing.

>x socket
Which do you mean, the tan socket or the beige socket?

>get socket
Which do you mean, the tan socket or the beige socket?

>i
You are carrying:
  a gray cable
  a scanner
  a green jumpsuit (being worn)

>plug gray into socket
Which do you mean, the tan socket or the beige socket?

>g
You can't see any such thing.

>i
You are carrying:
  a gray cable
  a scanner
  a green jumpsuit (being worn)

>x gray
A one meter USB 7.2 cable with a Type-F plug at each end.

It is not plugged into anything.

>gonear panel
Which do you mean, the solar panels or the panel?

>panel
Which do you mean, the solar panels or the panel?

>gonear ladder
Platform 1
A mesh platform about two thirds of the way towards the hub. You can continue spinward or antispinward, or go up a ladder into the hub.

>u
Inside the Hub
You float weightless in the middle of a cylinder. A ladder rotates around you, leading up or down or maybe out.

>plug gray into socket
You plug the gray cable into the usb socket.

>g
The usb socket already has the gray cable plugged into it.

>look
Inside the Hub
You float weightless in the middle of a cylinder. A ladder rotates around you, leading up or down or maybe out.

>actions
Actions listing on.

>get cable
[taking the gray cable]
You already have that.
[taking the gray cable - failed the can't take what's already taken rule]

>undo
Inside the Hub
[Previous turn undone.]

>unplug cable
[unplugging the gray cable]
(from the panel)
[(1) unplugging the gray cable from the panel]
You unplug the gray cable from the panel.
[(1) unplugging the gray cable from the panel - succeeded]

[unplugging the gray cable - succeeded]

* * *

>gonear panel
Which do you mean, the solar panels or the antenna panel?

>x socket
It is a female standard connector of the panel. It has nothing plugged into it.

>x panel
(the panel)
You see nothing special about the panel.

The panel has nothing plugged into it.

* * *

>gonear pile
Pod Bay
There are four berths for transit pods. Unfortunately, all are empty.

A secured door leads starboard.

There is a pile of clutter. It looks like equipment removed to free up space in the transit pods.

This is troubling. You counted. You were sure there would be one pod left. There are none.

[Your score has just gone up by two points.]

>pile
That's not a verb I recognize.

>x pile
an atmosphere sensor and the emergency communications unit.

* * *

>gonear pile
Pod Bay
There are four berths for transit pods. Unfortunately, all are empty.

A secured door leads starboard.

There is a pile of clutter. It looks like equipment removed to free up space in the transit pods.

This is troubling. You counted. You were sure there would be one pod left. There are none.

[Your score has just gone up by two points.]

>actions
Actions listing on.

>take all
[taking the atmosphere sensor]
atmosphere sensor: Taken.
[taking the atmosphere sensor - succeeded]
[taking the emergency communications unit]
emergency communications unit: Taken.
[taking the emergency communications unit - succeeded]

* * *

>gonear pile
Pod Bay
There are four berths for transit pods. Unfortunately, all are empty.

A secured door leads starboard.

There is a pile of clutter. It looks like equipment removed to free up space in the transit pods.

This is troubling. You counted. You were sure there would be one pod left. There are none.

[Your score has just gone up by two points.]

>get all from pile
atmosphere sensor: Taken.
emergency communications unit: Taken.

>undo
Pod Bay
[Previous turn undone.]

>take sensor
Taken.

>undo
Pod Bay
[Previous turn undone.]

>take pile
atmosphere sensor: Taken.
emergency communications unit: Taken.

(putting the scanner into your pocket to make room)
That's fixed in place.

* * *

>gonear pile
Pod Bay
There are four berths for transit pods. Unfortunately, all are empty.

A secured door leads starboard.

There is a pile of clutter. It looks like equipment removed to free up space in the transit pods.

This is troubling. You counted. You were sure there would be one pod left. There are none.

[Your score has just gone up by two points.]

>get junk
It really is unremarkable.

>search junk
It really is unremarkable.

>search pile
You find an atmosphere sensor, an emergency communications unit, and some unremarkable junk.

No pods left ... you consider despair.

>x clutter
There are an atmosphere sensor, an emergency communications unit, and some unremarkable junk.

>get clutter
That's fixed in place.

So what if you can't escape in a pod. You will just need to bring a pod here. Time to get the communications module working.

* * *

>gonear pile
Pod Bay
There are four berths for transit pods. Unfortunately, all are empty.

A secured door leads starboard.

There is a pile of clutter. It looks like equipment removed to free up space in the transit pods.

This is troubling. You counted. You were sure there would be one pod left. There are none.

[Your score has just gone up by two points.]

>take all from pile
atmosphere sensor: Taken.
emergency communications unit: Taken.

>undo
Pod Bay
[Previous turn undone.]

>i
You are carrying:
  a scanner
  a green jumpsuit (being worn)

>purloin all components
There seems to be no such object anywhere in the model world.

>purloin all modules
[Purloined.]
[Purloined.]
[Purloined.]
[Purloined.]
[Purloined.]
[Purloined.]
[Purloined.]

>take all from pile
atmosphere sensor: (putting the scanner into your pocket to make room)
You're carrying too many things already.
emergency communications unit: (putting the power module into your pocket to make room)
You're carrying too many things already.

>drop all
pressure regulation module: Dropped.
instruction module: Dropped.
instruction module: Dropped.
power module: Dropped.
power module: Dropped.
pressure regulation module: Dropped.

No pods left ... you consider despair.

>take all
pressure regulation module: Taken.
power module: Taken.
power module: Taken.
instruction module: (putting the pressure regulation module into your pocket to make room)
Taken.
instruction module: (putting the power module into your pocket to make room)
Taken.
pressure regulation module: (putting the power module into your pocket to make room)
Taken.
atmosphere sensor: (putting the instruction module into your pocket to make room)
Taken.
emergency communications unit: (putting the instruction module into your pocket to make room)
Taken.

* * *

>undo
Pod Bay
[Previous turn undone.]

>take all
There are none at all available!

>gonear church
(Church)
Church
Before everyone left or died, you celebrated every sabbath here. The altar stands against one wall, and an organ and a portable audio unit stand against the other.

On the altar is The Founder's Testament.

A gray cable connects the organ to the audio unit.

>take all
gray cable: Taken.
Founder's Testament: Taken.
power module: (putting the scanner into your pocket to make room)
Taken.

* * *

>take all from pile
atmosphere sensor: Taken.
emergency communications unit: Taken.

>unfo
That's not a verb I recognize.

>undo
Pod Bay
[Previous turn undone.]

>purloin all modules
[Purloined.]
[Purloined.]
[Purloined.]
[Purloined.]
[Purloined.]
[Purloined.]
[Purloined.]

>take all from pile
There is nothing of interest in the pile.

>x pile
You find nothing of interest.

No pods left ... you consider despair.

>restart
Are you sure you want to restart?

>yes
You awake. You are lonely, so lonely. It was a thousand days ago today. All alone these thousand days. Your parents were the last. No, your father was the last. He held on for nearly a hundred days longer. Now you are the last. Alone. Adrift.

But maybe it isn't hopeless. There must still be other people in other worlds, and you think you know how to get there.

Today is the day.

Founder's Mercy
A Space Story by Thomas Insel
Release 1 / Serial number 181209 / Inform 7 build 6M62 (I6/v6.33 lib 6/12N) SD
Type "about" for credits or "hint" for assistance.

Home (on the blanket)
The room where you've slept your entire life. The crops are outside.

There is a secured hatch in the floor.

>gonear pile
Pod Bay
There are four berths for transit pods. Unfortunately, all are empty.

A secured door leads starboard.

There is a pile of clutter. It looks like equipment removed to free up space in the transit pods.

This is troubling. You counted. You were sure there would be one pod left. There are none.

[Your score has just gone up by two points.]

>purloin all modules
[Purloined.]
[Purloined.]
[Purloined.]
[Purloined.]
[Purloined.]
[Purloined.]
[Purloined.]

>take all from pile
atmosphere sensor: (putting the scanner into your pocket to make room)
You're carrying too many things already.

emergency communications unit: (putting the power module into your pocket to make room)
You're carrying too many things already.

>undo
Pod Bay
[Previous turn undone.]

>drop a module
(the pressure regulation module)
Dropped.

>g
(the instruction module)
Dropped.

>get all
instruction module: (putting the scanner into your pocket to make room)
You're carrying too many things already.
pressure regulation module: (putting the power module into your pocket to make room)
You're carrying too many things already.

No pods left ... you consider despair.

* * *

>gonear pile
Pod Bay
There are four berths for transit pods. Unfortunately, all are empty.

A secured door leads starboard.

There is a pile of clutter. It looks like equipment removed to free up space in the transit pods.

This is troubling. You counted. You were sure there would be one pod left. There are none.

[Your score has just gone up by two points.]

>take pile
atmosphere sensor: Taken.
emergency communications unit: Taken.

>g
There is nothing useful left in the pile.

>g
1.
There is nothing useful left in the pile.

No pods left ... you consider despair.

* * *

>take pile
So what if you can't escape in a pod. You will just need to bring a pod here. Time to get the communications module working.

>look
Pod Bay
There are four berths for transit pods. Unfortunately, all are empty.

A secured door leads starboard.

There is a pile of clutter. It looks like equipment removed to free up space in the transit pods.

* * *

>g
1.
There is nothing useful left in the pile.

No pods left ... you consider despair.

>take all from pile
It really is unremarkable.

* * *

>g
1.
There is nothing useful left in the pile.

No pods left ... you consider despair.

>take all from pile of cluster
You can't see any such thing.

>take all from pile
It really is unremarkable.

* * *

>g
There is nothing useful left in the pile.

>put scanner in pile
You put the scanner into the pile of clutter.

No pods left ... you consider despair.

>look
Pod Bay
There are four berths for transit pods. Unfortunately, all are empty.

A secured door leads starboard.

There is a pile of clutter. It looks like equipment removed to free up space in the transit pods.

>s pile
That's not a verb I recognize.

>x pile
In the pile of clutter are a scanner and some unremarkable junk.

So what if you can't escape in a pod. You will just need to bring a pod here. Time to get the communications module working.

>restart
Are you sure you want to restart?

* * *

>gonear ile
There seems to be no such object anywhere in the model world.

>gonear pile
Pod Bay
There are four berths for transit pods. Unfortunately, all are empty.

A secured door leads starboard.

There is a pile of clutter. It looks like equipment removed to free up space in the transit pods.

This is troubling. You counted. You were sure there would be one pod left. There are none.

[Your score has just gone up by two points.]

>x pile
In the pile of clutter are an atmosphere sensor, an emergency communications unit, and some unremarkable junk.

>get comms
Taken.

>put comms in pile
You put the emergency communications unit into the pile of clutter.

No pods left ... you consider despair.

>x pile
In the pile of clutter are an emergency communications unit, an atmosphere sensor, and some unremarkable junk.

>get all from pile
emergency communications unit: Taken.
atmosphere sensor: Taken.

So what if you can't escape in a pod. You will just need to bring a pod here. Time to get the communications module working.

>x pile
In the pile of clutter is some unremarkable junk.

>i
You are carrying:
  an atmosphere sensor
  an emergency communications unit
  a scanner
  a green jumpsuit (being worn)

>put all into pile
atmosphere sensor: Done.
emergency communications unit: Done.
scanner: Done.

>x pile
In the pile of clutter are a scanner, an emergency communications unit, an atmosphere sensor, and some unremarkable junk.

>get pile
scanner: Taken.
emergency communications unit: Taken.
atmosphere sensor: Taken.

>look
Pod Bay
There are four berths for transit pods. Unfortunately, all are empty.

A secured door leads starboard.

There is a pile of clutter. It looks like equipment removed to free up space in the transit pods.

>x me
As virtuous as ever.

>x clutter
In the pile of clutter is some unremarkable junk.

>take junk
(putting the scanner into your pocket to make room)
It really is unremarkable.

>x box
A small box with a large lamp that is slowly flashing amber.

>scan box
Machine functional. Pressure low at 80 kilopascals, O normal, CO high at 0.10%. No immediate danger.

>restart
Are you sure you want to restart?

* * *

>x pile
In the pile of clutter are an atmosphere sensor, an emergency communications unit, and some unremarkable junk.

>search pile
In the pile of clutter are an atmosphere sensor, an emergency communications unit, and some unremarkable junk.

>get all from pile
atmosphere sensor: Taken.
emergency communications unit: Taken.

No pods left ... you consider despair.

>search pile
In the pile of clutter is some unremarkable junk.

* * *

>gonear pile
Pod Bay
There are four berths for transit pods. Unfortunately, all are empty.

A secured door leads starboard.

There is a pile of clutter. It looks like equipment removed to free up space in the transit pods.

This is troubling. You counted. You were sure there would be one pod left. There are none.

[Your score has just gone up by two points.]

>take sensor from pile
Taken.

>take scanner from pile
But it isn't there now.

>take pile
You should try taking something specific instead.

No pods left ... you consider despair.

>x pile
There are an emergency communications unit and some unremarkable junk.

>take comms
Taken.

So what if you can't escape in a pod. You will just need to bring a pod here. Time to get the communications module working.

>take pile
There is nothing you need left in the pile.

>x comms
A bulky but portable emergency communications unit from a transit pod. It can work independently if you provide audio and antenna connections.

The emergency communications unit has nothing plugged into it.

>i
You are carrying:
  an emergency communications unit
  an atmosphere sensor
  a scanner
  a green jumpsuit (being worn)

>drop comms
Dropped.

>look
Pod Bay
There are four berths for transit pods. Unfortunately, all are empty.

A secured hatch leads starboard.

There is a pile of clutter. It looks like equipment removed to free up space in the transit pods.

You can also see an emergency communications unit here.

>purloin audio
[Purloined.]

>drop audio
Dropped.

>ook
That's not a verb I recognize.

>look
Pod Bay
There are four berths for transit pods. Unfortunately, all are empty.

A secured hatch leads starboard.

There is a pile of clutter. It looks like equipment removed to free up space in the transit pods.

You can also see an audio unit and an emergency communications unit here.

>x audio
The audio unit incorporates a speaker, a microphone, and a socket you would use to connect it to another device. It contains a power module.

The audio unit has a gray cable plugged into it.

>x comms
A bulky but portable emergency communications unit from a transit pod. It can work independently if you provide audio and antenna connections.

The emergency communications unit has nothing plugged into it.

>x audio
The audio unit incorporates a speaker, a microphone, and a socket you would use to connect it to another device. It contains a power module.

The audio unit has a gray cable plugged into it.

>gonear learning
School House
A broken learning machine remains in a corner, but mostly the older farmers took turns leading the class. There is a desk, and a chalkboard hangs on one wall.

On the desk is a clean eraser.

>x learning
This last learning machine broke when you were maybe three thousand days old. It contains a power module and an instruction module.

>look
School House
A broken learning machine remains in a corner, but mostly the older farmers took turns leading the class. There is a desk, and a chalkboard hangs on one wall.

On the desk is a clean eraser.

>i
You are carrying:
  an atmosphere sensor
  a scanner
  a green jumpsuit (being worn)

>look
School House
A broken learning machine remains in a corner, but mostly the older farmers took turns leading the class. There is a desk, and a chalkboard hangs on one wall.

On the desk is a clean eraser.

>gonear pile
Pod Bay
There are four berths for transit pods. Unfortunately, all are empty.

A secured hatch leads starboard.

There is a pile of clutter. It looks like equipment removed to free up space in the transit pods.

You can also see an audio unit and an emergency communications unit here.

>look
Pod Bay
There are four berths for transit pods. Unfortunately, all are empty.

A secured hatch leads starboard.

There is a pile of clutter. It looks like equipment removed to free up space in the transit pods.

You can also see an audio unit and an emergency communications unit here.

>get comms
Taken.

>i
You are carrying:
  an emergency communications unit
  an atmosphere sensor
  a scanner
  a green jumpsuit (being worn)

>get audio
(putting the scanner into your pocket to make room)
Taken.

>i
You are carrying:
  an audio unit
  an emergency communications unit
  an atmosphere sensor
  a green jumpsuit (being worn)

Your jumpsuit pocket contains:
  a scanner

>x audio
The audio unit incorporates a speaker, a microphone, and a socket you would use to connect it to another device. It contains a power module.

The audio unit has a gray cable plugged into it.

>x cable
You can't see any such thing.

>x me
As virtuous as ever.

>x audio
The audio unit incorporates a speaker, a microphone, and a socket you would use to connect it to another device. It contains a power module.

The audio unit has a gray cable plugged into it.

>restart
Are you sure you want to restart?

>es
Please answer yes or no.

>yes
You awake. You are lonely, so lonely. It was a thousand days ago today. All alone these thousand days. Your parents were the last. No, your father was the last. He held on for nearly a hundred days longer. No, you are the last. Alone. Adrift.

But maybe it isn't hopeless. There must still be other people in other worlds, and you think you know how to get there.

Today is the day.

Founder's Mercy
A Space Story by Thomas Insel
Release 1 / Serial number 181209 / Inform 7 build 6M62 (I6/v6.33 lib 6/12N) SD
Type "about" for credits or "hint" for assistance.

Home
The room where you've slept your entire life. You can go out to your crops.

There is a secured hatch in the floor.

>gonear pile
Pod Bay
There are four berths for transit pods. Unfortunately, all are empty.

A secured hatch leads starboard.

There is a pile of clutter. It looks like equipment removed to free up space in the transit pods.

This is troubling. You counted. You were sure there would be one pod left. There are none.

[Your score has just gone up by two points.]

>look
Pod Bay
There are four berths for transit pods. Unfortunately, all are empty.

A secured hatch leads starboard.

There is a pile of clutter. It looks like equipment removed to free up space in the transit pods.

>x pile
There are an atmosphere sensor, an emergency communications unit, and some unremarkable junk.

>get comms
Taken.

No pods left ... you consider despair.

>i
You are carrying:
  an emergency communications unit
  a scanner
  a green jumpsuit (being worn)

>x comms
A bulky but portable emergency communications unit from a transit pod. It can work independently if you provide audio and antenna connections.

The emergency communications unit has nothing plugged into it.

So what if you can't escape in a pod. You will just need to bring a pod here. Time to get the communications module working.

>gonear school
(School House)
School House
A broken learning machine remains in a corner, but mostly the older farmers took turns leading the class. There is a desk, and a chalkboard hangs on one wall.

On the desk is a clean eraser.

>x learning
This last learning machine broke when you were maybe three thousand days old. It contains a power module and an instruction module.

>get learning
That's hardly portable.

>restart
Are you sure you want to restart?

>yes
You awake. You are lonely, so lonely. It was a thousand days ago today. All alone these thousand days. Your parents were the last. No, your father was the last. He held on for nearly a hundred days longer. No, you are the last. Alone. Adrift.

But maybe it isn't hopeless. There must still be other people in other worlds, and you think you know how to get there.

Today is the day.

Founder's Mercy
A Space Story by Thomas Insel
Release 1 / Serial number 181209 / Inform 7 build 6M62 (I6/v6.33 lib 6/12N) SD
Type "about" for credits or "hint" for assistance.

Home
The room where you've slept your entire life. You can go out to your crops.

There is a secured hatch in the floor.

* * *

>gonear pile
Pod Bay
There are four berths for transit pods. Unfortunately, all are empty.

A secured hatch leads starboard.

There is a pile of clutter. It looks like equipment removed to free up space in the transit pods.

This is troubling. You counted. You were sure there would be one pod left. There are none.

[Your score has just gone up by two points.]

>analyze pile
examining the pile of clutter:
There are an atmosphere sensor, an emergency communications unit, and some unremarkable junk.

looking under the pile of clutter:
You find nothing of interest.

searching the pile of clutter:
You find an atmosphere sensor, an emergency communications unit, and some unremarkable junk.

listening to the pile of clutter:
You hear nothing unexpected.

smelling the pile of clutter:
You smell nothing unexpected.

attacking the pile of clutter:
The Founder said that violence is never the answer.

buying the pile of clutter:
Nothing is on sale.

climbing the pile of clutter:
Little is to be achieved by that.

pulling the pile of clutter:
It is fixed in place.

pushing the pile of clutter:
It is fixed in place.

turning the pile of clutter:
It is fixed in place.

pushing the pile of clutter to starboard:
The pile of clutter cannot be pushed from place to place.

opening the pile of clutter:
It isn't something you can open.

entering the pile of clutter:
That's not something you can enter.

getting off the pile of clutter:
But you aren't on the pile of clutter at the moment.

closing the pile of clutter:
It isn't something you can close.

taking the pile of clutter:
You should try taking something specific instead.

switching on the pile of clutter:
It isn't something you can switch.

switching off the pile of clutter:
It isn't something you can switch.

wearing the pile of clutter:
(first taking the pile of clutter)
You should try taking something specific instead.

taking off the pile of clutter:
You aren't wearing the pile of clutter.

touching the pile of clutter:
You feel nothing unexpected.

rubbing the pile of clutter:
You rub the pile of clutter.

waving the pile of clutter:
But you aren't holding that.

squeezing the pile of clutter:
You achieve nothing by this.

burning the pile of clutter:
There is no open flame on the station.

cutting the pile of clutter:
The Founder said that violence is never the answer.

tying the pile of clutter to the unremarkable junk:
You would achieve nothing by this.

swinging the pile of clutter:
There's nothing sensible to swing here.

tasting the pile of clutter:
You taste nothing unexpected.

drinking the pile of clutter:
There's nothing suitable to drink here.

eating the pile of clutter:
That's plainly inedible.

dropping the pile of clutter:
The pile of clutter is already here.

* * *

>x pile
In the pile of clutter are an atmosphere sensor, an emergency communications unit, and some unremarkable junk.

>actions
Actions listing on.

>take sensor from pile
You can't see any such thing.

* * *

>x pile
In the pile of clutter are an atmosphere sensor, an emergency communications unit, and some unremarkable junk.

>get all from pile
atmosphere sensor: Taken.
emergency communications unit: Taken.

>get sensor
Taken.

>get comms
Taken.

No pods left ... you consider despair.

>x pile
Stuff.

* * *

>get all from pile
atmosphere sensor: Taken.
emergency communications unit: Taken.

>x pile
In the pile of clutter is some unremarkable junk.

No pods left ... you consider despair.

>get junk
(putting the scanner into your pocket to make room)
It really is unremarkable.

>look
Pod Bay
There are four berths for transit pods. Unfortunately, all are empty.

A secured door leads starboard.

There is a pile of clutter. It looks like equipment removed to free up space in the transit pods.

So what if you can't escape in a pod. You will just need to bring a pod here. Time to get the communications module working.

>x junk
It really is unremarkable.

* * *

>x pile
In the pile of clutter are an atmosphere sensor, an emergency communications unit, and some unremarkable junk.

>get pile
There is nothing you need left in the pile.

* * *

>x pile
In the pile of clutter are an atmosphere sensor, an emergency communications unit, and some unremarkable junk.

>get sensor
Taken.

* * *

>get comms
Taken.

No pods left ... you consider despair.

>look at pile
There is only some unremarkable junk.

>search pile
You find some unremarkable junk.

So what if you can't escape in a pod. You will just need to bring a pod here. Time to get the communications module working.

* * *

>get sensor
Taken.

>x pile
emergency communications unit
No pods left ... you consider despair.

>l
Pod Bay
There are four berths for transit pods. Unfortunately, all are empty.

A secured hatch leads starboard.

There is a pile of clutter. It looks like equipment removed to free up space in the transit pods.

>x comms
A bulky but portable emergency communications unit from a transit pod. It can work independently if you provide audio and antenna connections.

The emergency communications unit has nothing plugged into it.

So what if you can't escape in a pod. You will just need to bring a pod here. Time to get the communications module working.

>l
Pod Bay
There are four berths for transit pods. Unfortunately, all are empty.

A secured hatch leads starboard.

There is a pile of clutter. It looks like equipment removed to free up space in the transit pods.

>get comms
Taken.

* * *

>x pile
In the pile of clutter are an atmosphere sensor, an emergency communications unit, and some unremarkable junk.

>look
Pod Bay
There are four berths for transit pods. Unfortunately, all are empty.

A secured door leads starboard.

There is a pile of clutter. It looks like equipment removed to free up space in the transit pods.

>get pile
That's fixed in place.

No pods left ... you consider despair.

>get sensor
Taken.

>drop sensor
Dropped.

So what if you can't escape in a pod. You will just need to bring a pod here. Time to get the communications module working.

>look
Pod Bay
There are four berths for transit pods. Unfortunately, all are empty.

A secured hatch leads starboard.

There is a pile of clutter. It looks like equipment removed to free up space in the transit pods.

You can also see an atmosphere sensor here.

* * *

>x pile
In the pile of clutter are an atmosphere sensor, an emergency communications unit, and some unremarkable junk.

>push pile
That isn't practical.

>showme pile
pile of clutter - open container
    unremarkable junk
    atmosphere sensor
    emergency communications unit - machine
        almond socket (part of emergency communications unit) - USB socket
        RF socket (part of emergency communications unit) - RF socket
location: in Pod Bay
singular-named, improper-named; unlit, inedible, fixed in place; opaque, open, unopenable, unlocked
list grouping key: none
printed name: "pile of clutter"
printed plural name: "containers"
indefinite article: none
description: none
initial appearance: "There is a pile of clutter. It looks like equipment removed to free up space in the transit pods."
carrying capacity: 100

>x pile
The pile of clutter is empty.

No pods left ... you consider despair.

>x sensor
A small box with a large light that is slowly flashing amber.

>look in pile
The pile of clutter is empty.

So what if you can't escape in a pod. You will just need to bring a pod here. Time to get the communications module working.

>search pile
The pile of clutter is empty.

* * *

>x pile
In the pile of clutter are an atmosphere sensor, an emergency communications unit, and some unremarkable junk.

>search pile
You find an atmosphere sensor, an emergency communications unit, and some unremarkable junk.

>search berths
You find nothing of interest.

No pods left ... you consider despair.

* * *

>search pile
You find an atmosphere sensor, an emergency communications unit, and some unremarkable junk.

>search me
You find nothing of interest.

No pods left ... you consider despair.

>get sensor
Taken.

>x pile
There are an emergency communications unit and some unremarkable junk.

So what if you can't escape in a pod. You will just need to bring a pod here. Time to get the communications module working.

>search pile
You find an emergency communications unit and some unremarkable junk.

>get comms
Taken.

>x pile
There is only some unremarkable junk.

>search pile
You find nothing of interest.

>get junk
(putting the scanner into your pocket to make room)
They're fixed in place.

* * *

>x pile
In the pile of clutter are an atmosphere sensor, an emergency communications unit, and some unremarkable junk.

>take comms
Taken.

>x pile
There are an atmosphere sensor and some unremarkable junk.

No pods left ... you consider despair.

>get sensor
Taken.

>x pile
There is some unremarkable junk.

So what if you can't escape in a pod. You will just need to bring a pod here. Time to get the communications module working.

>get junk
(putting the scanner into your pocket to make room)
They're fixed in place.

* * *

>x pile
In the pile of clutter are an atmosphere sensor, an emergency communications unit, and some unremarkable junk.

>take sensor
Taken.

>take comms
Taken.

No pods left ... you consider despair.

>x sensor
x.

>x pile
There is only some unremarkable junk.

So what if you can't escape in a pod. You will just need to bring a pod here. Time to get the communications module working.

>search pile
You find only some unremarkable junk.

* * *

>gonear pile
Pod Bay
There are four berths for transit pods. Unfortunately, all are empty.

A secured door leads starboard.

There is a pile of clutter. It looks like equipment removed to free up space in the transit pods.

This is troubling. You counted. You were sure there would be one pod left. There are none.

[Your score has just gone up by two points.]

>x sensor
x.

>get sensor
Taken.

>drop sensor
Dropped.

No pods left ... you consider despair.

>look
Pod Bay
There are four berths for transit pods. Unfortunately, all are empty.

A secured hatch leads starboard.

You can also see an atmosphere sensor and a pile of clutter here.

* * *

>gonear platform
Which do you mean, the maintenance platform, the maintenance platform, Platform 1, Platform 3, or Platform 5?

>red
There seems to be no such object anywhere in the model world.

>gonear red
(the red circuit breaker)
Platform 3
It's a mesh platform about two thirds of the way towards the hub. You feel much lighter here, and you are very aware of how the station rotates, but everything is okay as long as you don't look down. You can continue spinward or antispinward.

There is a red circuit breaker here.

>x platform
You are on a circular platform suspended  about two thirds of the way up the pylons to the hub.

>x pylon
The pylon stretches between the ground, the maintenance platform, and the hub.

>go pylon
That's not something you can enter.

* * *

>gonear platform 1
Platform 1
A mesh platform about two thirds of the way towards the hub. You can continue spinward or antispinward, or go up a ladder into the hub.

>u
Gravity fades as you climb.

Inside the Hub
You float weightless in the middle of a cylinder. A ladder rotates around you, leading up or down or maybe out.

A yellow cable waves from a small panel.

>d
You make sure you are heading legs first and follow the ladder.

Platform 1
A mesh platform about two thirds of the way towards the hub. You can continue spinward or antispinward, or go up a ladder into the hub.

>u
Gravity fades as you climb.

Inside the Hub
You float weightless in the middle of a cylinder. A ladder rotates around you, leading up or down or maybe out.

A yellow cable waves from a small panel.

>x ladder
The ladder moves with the station, rotating around you about four times every minute.

* * *

>u
Gravity fades as you climb.

Inside the Hub
You float weightless in the middle of a cylinder. A ladder rotates around you, leading up or down or maybe out.

A yellow cable waves from a small panel.

>undo
Platform 1
[Previous turn undone.]

>ctions
That's not a verb I recognize.

>actions
Actions listing on.

>p
[going port]
You can't go port, but you can go up to inside the hub, down to sector 1, spinward to platform 3, or antispinward to platform 5.
[going port - failed]

>up
[going up]

Inside the Hub
You float weightless in the middle of a cylinder. A ladder rotates around you, leading up or down or maybe out.

A yellow cable waves from a small panel.

[going up - succeeded]

* * *

>gonear platform 3
Platform 3
A mesh platform about two thirds of the way towards the hub. You can continue spinward or antispinward.

You feel much lighter here, and you are very aware of how the station rotates, but everything is okay as long as you don't look down.

There is a red circuit breaker here.

>d
You slide down the pylon.

Sector 3: Forest
Trees, a house, and a church. A red pylon stretches up from the ground to the hub of the station. You can walk spinward or antispinward.

* * *

>gonear platform 5
Platform 5
A mesh platform about two thirds of the way towards the hub. You can continue spinward or antispinward.

>d
You slide down the pylon.

Sector 5: Forest
The school house is nestled among the trees. A pylon stretches up from the same grove to the hub of the station. You can walk spinward or antispinward.

* * *

>gonear read
There seems to be no such object anywhere in the model world.

>gonear red
(the red circuit breaker)
Platform 3
It's a mesh platform about two thirds of the way towards the hub. You feel much lighter here, and you are very aware of how the station rotates, but everything is okay as long as you don't look down. You can continue spinward or antispinward.

There is a red circuit breaker here.

>d
You slide down the pylon.

Sector 3: Forest
Trees, a house, and a church. A red pylon stretches up from the ground to the hub of the station. You can walk spinward or antispinward.

>undo
Platform 3
[Previous turn undone.]

>asw
Platform 1
It's a mesh platform about two thirds of the way towards the hub. You feel much lighter here, and you are very aware of how the station rotates, but everything is okay as long as you don't look down. You can continue spinward or antispinward.

>d
The only exit is spinward to platform 3.

>asw
The only exit is spinward to platform 3.

>d
The only exit is spinward to platform 3.

>sw
Platform 3
It's a mesh platform about two thirds of the way towards the hub. You feel much lighter here, and you are very aware of how the station rotates, but everything is okay as long as you don't look down. You can continue spinward or antispinward.

There is a red circuit breaker here.

* * *

>gonear red
Which do you mean, the pylon, the red circuit breaker, or the red cable?

>asw
Platform 1
A mesh platform about two thirds of the way towards the hub. You can continue spinward or antispinward, or go up a ladder into the hub.

>sw
You feel much lighter here, and you are very aware of how the station rotates, but everything is okay as long as you don't look down.

>look down
The pylon descends into a forest below you.

* * *

>asw
Platform 1
A mesh platform about two thirds of the way towards the hub. You can continue spinward or antispinward, or go up a ladder into the hub.

>u
Inside the Hub
You float weightless in the middle of a cylinder. A ladder rotates around you, leading up or down or maybe out.

>d
You struggle a little to make sure you are heading legs first and follow the ladder.

Platform 1
A mesh platform about two thirds of the way towards the hub. You can continue spinward or antispinward, or go up a ladder into the hub.

>actions
Actions listing on.

>down
[going down]
The only exit is outside to platform 1.
[going down - failed]

* * *

>d
You struggle a little to make sure you are heading legs first and follow the ladder.

Platform 1
A mesh platform about two thirds of the way towards the hub. You can continue spinward or antispinward, or go up a ladder into the hub.

>trace
[Trace on.]

>look
[Parsing for the verb 'look' (5 lines)]
[line 0 * -> Look]
[Line successfully parsed]
Platform 1
A mesh platform about two thirds of the way towards the hub. You can continue spinward or antispinward, or go up a ladder into the hub.

>asw
Platform 5
A mesh platform about two thirds of the way towards the hub. You can continue spinward or antispinward.

* * *

>asw
Platform 3
A mesh platform about two thirds of the way towards the hub. You can continue spinward or antispinward.

There is a red circuit breaker here.

>look
[Parsing for the verb 'look' (5 lines)]
[line 0 * -> Look]
[Line successfully parsed]
Platform 3
A mesh platform about two thirds of the way towards the hub. You can continue spinward or antispinward.

There is a red circuit breaker here.

>trace
[Parsing for the verb 'trace' (4 lines)]
[line 0 * -> TraceOn]
[Line successfully parsed]
[Trace on.]

>trace on
[Parsing for the verb 'trace' (4 lines)]
[line 0 * -> TraceOn]
[line 1 * number -> TraceLevel]
[line 2 * 'on' -> TraceOn]
[Line successfully parsed]
[Trace on.]

>trace high
[Parsing for the verb 'trace' (4 lines)]
[line 0 * -> TraceOn]
[line 1 * number -> TraceLevel]
[line 2 * 'on' -> TraceOn]
[line 3 * 'off' -> TraceOff]
I didn't understand that number.

>grace 5
[Parsing for the verb 'no.verb' (1 lines)]
[line 0 * noun=Routine(463752) -> Enter]
That's not a verb I recognize.

>asw
Platform 1
A mesh platform about two thirds of the way towards the hub. You can continue spinward or antispinward, or go up a ladder into the hub.

* * *

>x ladder
A ladder leads up into the hub.

>showme
Inside the Hub - room
    ladder - open door
    yourself - person
        scanner
        green jumpsuit (worn)
            pocket (part of green jumpsuit) - open container

>showme ladder
ladder - open door
location: in Inside the Hub
singular-named, improper-named; unlit, inedible, fixed in place, scenery; open, openable, unlocked
list grouping key: none
printed name: "ladder"
printed plural name: "doors"
indefinite article: none
description: "A ladder leads up into the hub."
initial appearance: none
other side: Platform 1

>close ladder
You close the ladder.

>lock ladder
That's not a verb I recognize.

* * *

>u
Inside the Hub
You float weightless in the middle of a cylinder. A ladder rotates around you, leading up or down or maybe out.

>x ladder
The ladder moves with the station, rotating around you four times every minute.

* * *

>u
Inside the Hub
You float weightless in the middle of a cylinder. A ladder rotates around you, leading up or down or maybe out.

>drop all
scanner: Dropped.

>look
Inside the Hub
You are weightless, so instead of up and down, you think of the ladder as leading "out."

the scanneryourself

* * *

>u
Inside the Hub
You float weightless in the middle of a cylinder. A ladder rotates around you, leading up or down or maybe out.

>look
Inside the Hub
You are weightless, so instead of up and down, you think of the ladder as leading "out."

yourself

>d
There are no obvious exits.

>u
There are no obvious exits.

>look
Inside the Hub
A ladder leads up into the hub.

* * *

>look
Inside the Hub
You are weightless, so instead of up and down, you think of the ladder as leading "out."

yourself

>out
But you aren't in anything at the moment.

>d
There are no obvious exits.

* * *

>asw
Platform 1
A mesh platform about two thirds of the way towards the hub. You can continue spinward or antispinward, or go up a ladder into the hub.

>x ladder
A ladder leads up into the hub.

>u
(first opening the ladder)

Inside the Hub
You float weightless in the middle of a cylinder. A ladder rotates around you, leading up or down or maybe out.

>x ladder
A ladder leads up into the hub.

>d
You feel that you shouldn't leave the ladder behind in case it floats off.

* * *

>gonear red
Which do you mean, the pylon, the red circuit breaker, or the red cable?

>cable
Inside the Hub
You float weightless in the middle of a cylinder. A ladder rotates around you, leading up or down or maybe out.

A yellow cable flaps from a small panel.

>d
You struggle a little to make sure you are heading legs first and follow the ladder.

Platform 1
A mesh platform about two thirds of the way towards the hub. You can continue spinward or antispinward, or go up a ladder into the hub.

>u
Inside the Hub
You float weightless in the middle of a cylinder. A ladder rotates around you, leading up or down or maybe out.

A yellow cable flaps from a small panel.

>take red cable
That seems to be a part of the panel.

>plug red cable into yellow cable
The yellow cable has no socket.

>showme red cable
red cable - thing
    RF plug (part of red cable) - RF plug
    RF plug (part of red cable) - RF plug
location: part of the panel in Inside the Hub
singular-named, improper-named; unlit, inedible, portable, machinelike, floating-exceptioned
list grouping key: none
printed name: "red cable"
printed plural name: none
indefinite article: none
description: "A red RF cable."
initial appearance: "A red cable flaps from a small panel."

>showme yellow cable
yellow cable - thing
    RF plug (part of yellow cable) - RF plug
    RF plug (part of yellow cable) - RF plug
location: in Inside the Hub
singular-named, improper-named; unlit, inedible, portable, machinelike, floating-exceptioned
list grouping key: none
printed name: "yellow cable"
printed plural name: none
indefinite article: none
description: "A yellow RF cable."
initial appearance: "A yellow cable flaps from a small panel."

* * *

>gonear red
Which do you mean, the pylon, the red circuit breaker, or the red cable?

>d
You slide down the pylon.

Sector 3: Forest
Trees, a house, and a church. A red pylon stretches up from the ground to the hub of the station. You can walk spinward or antispinward.

* * *

>undo
Platform 3
[Previous turn undone.]

>look
Platform 3
A mesh platform about two thirds of the way towards the hub. You can continue spinward or antispinward.

You feel much lighter here, and you are very aware of how the station rotates, but everything is okay as long as you don't look down.

There is a red circuit breaker here.

>asw
Platform 1
A mesh platform about two thirds of the way towards the hub. You can continue spinward or antispinward.

>asw
Platform 5
A mesh platform about two thirds of the way towards the hub. You can continue spinward or antispinward.

* * *

>look
Platform 3
A mesh platform about two thirds of the way towards the hub. You can continue spinward or antispinward.

There is a red circuit breaker here.

>x hb
You can't see any such thing.

>x hub
The station rotates around the hub, still a good way above you, which extends out to hold solar panels to the port and mirrors on the starboard side.

>x platform
You are on a circular platform suspended  about two thirds of the way up the pylons to the hub.

* * *

>gonear red
Which do you mean, the pylon, the red circuit breaker, or the red cable?

>drop platform
maintenance platform is already here.

* * *

>gonear red
Which do you mean, the pylon, the red circuit breaker, or the red cable?

>enter pylon
You slide down the pylon.

Sector 3: Forest
Trees, a house, and a church. A red pylon stretches up from the ground to the hub of the station. You can walk spinward or antispinward.

>undo
Platform 3
[Previous turn undone.]

>go pylon
You slide down the pylon.

Sector 3: Forest
Trees, a house, and a church. A red pylon stretches up from the ground to the hub of the station. You can walk spinward or antispinward.

>undo
Platform 3
[Previous turn undone.]

>jump down
I only understood you as far as wanting to jump.

>ations
That's not a verb I recognize.

>actions
Actions listing on.

>jump
[jumping]
Pseudogravity is definitely weaker up here.
[jumping - failed]

>jump down
I only understood you as far as wanting to jump.

>go to ground
You can't see any such thing.

>go ground
[entering the ground]
[(1) going down]
You slide down the pylon.

Sector 3: Forest
Trees, a house, and a church. A red pylon stretches up from the ground to the hub of the station. You can walk spinward or antispinward.

[(1) going down - succeeded]

[entering the ground - succeeded]

>go to the north
You can't see any such thing.

>gonear red
(the pylon)
[(1) looking]
Sector 3: Forest
Trees, a house, and a church. A red pylon stretches up from the ground to the hub of the station. You can walk spinward or antispinward.

[(1) looking - succeeded]

>sw
[going spinward]
You walk a little ways to the next sector.

Sector 4: Crops
Your home is here among the crops. You can walk spinward or antispinward.

[going spinward - succeeded]

>sw
[going spinward]
You walk a little ways to the next sector.

Sector 5: Forest
The school house is nestled among the trees. A pylon stretches up from the same grove to the hub of the station. You can walk spinward or antispinward.

[going spinward - succeeded]

>sw
[going spinward]
You walk a little ways to the next sector.

Sector 6: Hydroponics
Your people preferred to grow things the old fashioned way, but in truth the majority of your fruit and vegetables came from this sector when the machines still worked. You can walk spinward or antispinward.

There is a secured hatch in the ground.

[going spinward - succeeded]

>gonear red
(the red circuit breaker)
[(1) looking]
Platform 3
It's a mesh platform about two thirds of the way towards the hub. You feel much lighter here, and you are very aware of how the station rotates, but everything is okay as long as you don't look down. You can continue spinward or antispinward.

There is a red circuit breaker here.

[(1) looking - succeeded]

>sw
[going spinward]

Platform 5
It's a mesh platform about two thirds of the way towards the hub. You feel much lighter here, and you are very aware of how the station rotates, but everything is okay as long as you don't look down. You can continue spinward or antispinward.

[going spinward - succeeded]

>sw
[going spinward]

Platform 1
It's a mesh platform about two thirds of the way towards the hub. You feel much lighter here, and you are very aware of how the station rotates, but everything is okay as long as you don't look down. You can continue spinward or antispinward.

[going spinward - succeeded]

>sw
[going spinward]

Platform 3
It's a mesh platform about two thirds of the way towards the hub. You feel much lighter here, and you are very aware of how the station rotates, but everything is okay as long as you don't look down. You can continue spinward or antispinward.

There is a red circuit breaker here.

[going spinward - succeeded]

* * *

>gonear red
Which do you mean, the pylon, the red circuit breaker, or the red cable?

>go ground
You slide down the pylon.

Sector 3: Forest
Trees, a house, and a church. A red pylon stretches up from the ground to the hub of the station. You can walk spinward or antispinward.

>undo
Platform 3
[Previous turn undone.]

>enter ground
You slide down the pylon.

Sector 3: Forest
Trees, a house, and a church. A red pylon stretches up from the ground to the hub of the station. You can walk spinward or antispinward.

>sw
You walk a little ways to the next sector.

Sector 4: Crops
Your home is here among the crops. You can walk spinward or antispinward.

* * *

>sw
You walk a little ways to the next sector.

Sector 1: Crops
You still maintain the crops here. There is a small graveyard and the barn remains from when this was the livestock sector. A pylon stretches up from the ground to the hub of the station. You can walk spinward or antispinward.

There is a secured hatch in the ground.

>gonear red
(the red circuit breaker)
Platform 3
It's a mesh platform about two thirds of the way towards the hub. You feel much lighter here, and you are very aware of how the station rotates, but everything is okay as long as you don't look down. You can continue spinward or antispinward.

There is a red circuit breaker here.

>x pylon
You can't see any such thing.

* * *

>gonear red
Which do you mean, the pylon, the red circuit breaker, or the red cable?

>look
Platform 3
A mesh platform about two thirds of the way towards the hub. You can continue spinward or antispinward.

You feel much lighter here, and you are very aware of how the station rotates, but everything is okay as long as you don't look down..

There is a red circuit breaker here.

>asw
Platform 1
A mesh platform about two thirds of the way towards the hub. You can continue spinward or antispinward.

>sw
Platform 3
A mesh platform about two thirds of the way towards the hub. You can continue spinward or antispinward.

There is a red circuit breaker here.

* * *

>gonear red
Which do you mean, the pylon, the red circuit breaker, or the red cable?

>look down
The pylon descends into a forest below you.

>look up
The station rotates around the hub, still a good way above you, which extends out to hold solar panels to the port and mirrors on the starboard side.

>d
You slide down the pylon.

Sector 3: Forest
Trees, a house, and a church. A red pylon stretches up from the ground to the hub of the station. You can walk spinward or antispinward.

* * *

>look down
The pylon descends into a forest below you.

>sw
Platform 5
It's a mesh platform about two thirds of the way towards the hub. You feel much lighter here, and you are very aware of how the station rotates, but everything is okay as long as you don't look down. You can continue spinward or antispinward.

>look down
The pylon descends into a forest below you.

>sw
Platform 1
It's a mesh platform about two thirds of the way towards the hub. You feel much lighter here, and you are very aware of how the station rotates, but everything is okay as long as you don't look down. You can continue spinward or antispinward.

>ook down
That's not a verb I recognize.

>look down
The pylon descends into a field of crops below you.

* * *

>gonear red
Which do you mean, the pylon, the red circuit breaker, or the red cable?

>look up
The station rotates around the hub, still a good way above you, which extends out to hold solar panels to the port and mirrors on the starboard side.

>x station
You can't see any such thing.

>x panel
The primary source of station power.

>x panels
The primary source of station power.

>x mirror
The mirrors reflect sunlight into the station.

>x mirror
The mirrors reflect sunlight into the station.

>u
You can't go up, but you can go down to sector 3, spinward to platform 5, or antispinward to platform 1.

>look
Platform 3
A mesh platform about two thirds of the way towards the hub. You can continue spinward or antispinward.

You feel much lighter here, and you are very aware of how the station rotates, but everything is okay as long as you don't look down.

There is a red circuit breaker here.

* * *

>asw
Platform 5
A mesh platform about two thirds of the way towards the hub. You can continue spinward or antispinward.

>aws
That's not a verb I recognize.

>asw
Platform 3
A mesh platform about two thirds of the way towards the hub. You can continue spinward or antispinward.

There is a red circuit breaker here.

>p
You can't go port, but you can go down to sector 3, spinward to platform 5, or antispinward to platform 1.

>s
You can't go starboard, but you can go down to sector 3, spinward to platform 5, or antispinward to platform 1.

* * *

>gonear red
Which do you mean, the pylon, the red circuit breaker, or the red cable?

>sw
Platform 5
A mesh platform about two thirds of the way towards the hub. You can continue spinward or antispinward.

>asw
Platform 3
A mesh platform about two thirds of the way towards the hub. You can continue spinward or antispinward.

There is a red circuit breaker here.

>sw
Platform 5
A mesh platform about two thirds of the way towards the hub. You can continue spinward or antispinward.

* * *

>asw
Platform 3
A mesh platform about two thirds of the way towards the hub. You can continue spinward or antispinward.

There is a red circuit breaker here.

>restart
Are you sure you want to restart?

* * *

>sw
Platform 5
A mesh platform about two thirds of the way towards the hub. You can continue spinward or antispinward.

>sw
Platform 1
A mesh platform about two thirds of the way towards the hub. You can continue spinward or antispinward, or go up a ladder into the hub.

>sw
Platform 3
It's a mesh platform about two thirds of the way towards the hub. You feel much lighter here, and you are very aware of how the station rotates, but everything is okay as long as you don't look down. You can continue spinward or antispinward.

There is a red circuit breaker here.

>sw
Platform 5
It's a mesh platform about two thirds of the way towards the hub. You feel much lighter here, and you are very aware of how the station rotates, but everything is okay as long as you don't look down. You can continue spinward or antispinward.

>d
You slide down the pylon.

Sector 5: Forest
The school house is nestled among the trees. A pylon stretches up from the same grove to the hub of the station. You can walk spinward or antispinward.

>x hub
The station rotates around the hub, which extends out to hold solar panels on the port and mirrors on the starboard side. On the inside, there is a maintenance platform about two thirds of the way up the pylons.

>x platform
A circular platform connects the pylons about two thirds of the way up.

>touch platform
You are too far away to do that.

* * *

>sw
Platform 1
A mesh platform about two thirds of the way towards the hub. You can continue spinward or antispinward, or go up a ladder into the hub.

>u
Inside the Hub
You are weightless, so instead of up and down, you think of the ladder as leading "out."

>out
jdskjfksd.

* * *

>gonear red
Which do you mean, the pylon, the red circuit breaker, or the red cable?

>turn off red
That's already off.

>turn on red
You reach up and switch the circuit breaker on.

[Your score has just gone up by one point.]

>look through hatch
You can't see any such thing.

>restart
Are you sure you want to restart?

>yes
You awake. You are lonely, so lonely. It was a thousand days ago today. All alone these thousand days. Your parents were the last. No, your father was the last. He held on for nearly a hundred days longer. No, you are the last. Alone. Adrift.

But maybe it isn't hopeless. There must still be other people in other worlds, and you think you know how to get there.

Today is the day.

Founder's Mercy
A Space Story by Thomas Insel
Release 1 / Serial number 181201 / Inform 7 build 6M62 (I6/v6.33 lib 6/12N) SD
Type "about" for credits or "hint" for assistance.

Home
The room where you've slept your entire life. You can go out towards the crops.

There is a secured hatch in the floor.

>look through hatch
You find nothing of interest.

>exits
The obvious exits are down and outside.

[Type "exits off" to disable the status line exit list and "exits on" to turn it back on.]

* * *

>gonear red
Which do you mean, the pylon, the red circuit breaker, or the red cable?

>turn on breake
You can't see any such thing.

>turn on breaker
You reach up and switch the circuit breaker on.

You switch the red circuit breaker on.

[Your score has just gone up by one point.]

* * *

>gonear red
Which do you mean, the pylon, the red circuit breaker, or the red cable?

>up
You can't go up, but you can go down to sector 3, spinward to platform 5, or antispinward to platform 1.

>asw
Platform 1
A mesh platform about two thirds of the way towards the hub. You can continue spinward or antispinward, or go up a ladder into the hub.

>p
You can't go port, but you can go up to inside the hub, down to sector 1, inside to inside the hub, spinward to platform 3, or antispinward to platform 5.

>up
Inside the Hub
You are weightless, so instead of up and down, you think of the ladder as leading "out."

>drop all
scanner: Dropped.

* * *

>gonear red
Which do you mean, the pylon, the red circuit breaker, or the red cable?

>x hub
The station rotates around the hub, still a good way above you, which extends out to hold solar panels to the port and mirrors on the starboard side.

>d
You slide down the pylon.

Sector 3: Forest
Trees, a house, and a church. A red pylon stretches up from the ground to the hub of the station. You can walk spinward or antispinward.

>x hub
The station rotates around the hub, which extends out to hold solar panels to the port and mirrors on the starboard side. On the inside, there is a maintenance platform about two thirds of the way up the pylons.

>x platform
A circular platform connects the pylons about two thirds of the way up.

>gonear red
(the pylon)
Sector 3: Forest
Trees, a house, and a church. A red pylon stretches up from the ground to the hub of the station. You can walk spinward or antispinward.

>x platform
A circular platform connects the pylons about two thirds of the way up.

>gonear red breaker
Platform 3
It's a mesh platform about two thirds of the way towards the hub. You feel much lighter here, and you are very aware of how the station rotates, but everything is okay as long as you don't look down. You can continue spinward or antispinward.

There is a red circuit breaker here.

>x platform
You can't see any such thing.

>touch platform
You can't see any such thing.

>touch room
You can't see any such thing.

* * *

>gonear red
Which do you mean, the pylon, the red circuit breaker, or the red cable?

>x platform
You are on a circular platform that connects the pylons about two thirds of the way up to the hub.

>x hub
The station rotates around the hub, still a good way above you, which extends out to hold solar panels to the port and mirrors on the starboard side.

>x ground
You can't see any such thing.

>look down
You see nothing unexpected in that direction.

>d
You slide down the pylon.

Sector 3: Forest
Trees, a house, and a church. A red pylon stretches up from the ground to the hub of the station. You can walk spinward or antispinward.

* * *

>gonear red
Which do you mean, the pylon, the red circuit breaker, or the red cable?

>x pulon
You can't see any such thing.

>x pylon
The pylon stretches up from  the ground, to the maintenance platform, and finally the hub.

>x hub
The station rotates around the hub, still a good way above you, which extends out to hold solar panels to the port and mirrors on the starboard side.

>x ground
The pylon descends into the forest below you.

>x pylon
The pylon stretches up from  the ground, to the maintenance platform, and finally the hub.

>x forest
(the green jumpsuit)
You have worn modest jumpsuits like this since you were small. Originally, the colors had meanings: forest green for farmers, navy blue for technicians, and so on, but that distinction died even before the population.

It features a single large pocket, currently empty.

>go ground
You slide down the pylon.

Sector 3: Forest
Trees, a house, and a church. A red pylon stretches up from the ground to the hub of the station. You can walk spinward or antispinward.

* * *

>gonear red breaker
Platform 3
A mesh platform about two thirds of the way towards the hub. You can continue spinward or antispinward.

You feel much lighter here, and you are very aware of how the station rotates, but everything is okay as long as you don't look down.

There is a red circuit breaker here.

>asw
Platform 1
A mesh platform about two thirds of the way towards the hub. You can continue spinward or antispinward, or go up a ladder into the hub.

>x ground
The pylon descends to the crops below you.

>go ground
You slide down the pylon.

Sector 1: Crops
You still maintain the crops here. There is a small graveyard and the barn remains from when this was the livestock sector. A pylon stretches up from the ground to the hub of the station. You can walk spinward or antispinward.

There is a secured hatch in the ground.

* * *

>gonear school
(School)
School
A broken learning machine remains in a corner, but mostly the older farmers took turns leading the class. There is a desk, and a chalkboard hangs on one wall.

On the desk is a clean eraser.

>out
But you aren't in anything at the moment.

* * *

>gonear sector 3
Sector 3: Forest
Trees, a house, and a church. A red pylon stretches up from the ground to the hub of the station. You can walk spinward or antispinward.

>u
The red pylon is designated for climbing, but you can't get a grip.

>purloin boots
[Purloined.]

* * *

>wear boots
You put on the pair of gravity boots.

>u
With the boots, you are able to climb up the pylon. As you get closer to the hub, gravity decreases, and the climb becomes easier.

Platform 3
A mesh platform about two thirds of the way towards the hub. You can continue spinward or antispinward.

You feel much lighter here, and you are very aware of how the station rotates, but everything is okay as long as you don't look down.

There is a red circuit breaker here.

>d
You climb down the pylon.

Sector 3: Forest
Trees, a house, and a church. A red pylon stretches up from the ground to the hub of the station. You can walk spinward or antispinward.

>u
With the boots, you are able to climb up the pylon. As you get closer to the hub, gravity decreases, and the climb becomes easier.

Platform 3
A mesh platform about two thirds of the way towards the hub. You can continue spinward or antispinward.

There is a red circuit breaker here.

>d
You climb down the pylon.

Sector 3: Forest
Trees, a house, and a church. A red pylon stretches up from the ground to the hub of the station. You can walk spinward or antispinward.

>drop boots
(first taking the pair of gravity boots off)
Dropped.

>u
The red pylon is designated for climbing, but you can't get a grip.

>look
Sector 3: Forest
Trees, a house, and a church. A red pylon stretches up from the ground to the hub of the station. You can walk spinward or antispinward.

You can see a pair of gravity boots here.

>gonear platform 3
Platform 3
A mesh platform about two thirds of the way towards the hub. You can continue spinward or antispinward.

There is a red circuit breaker here.

>asw
Platform 1
A mesh platform about two thirds of the way towards the hub. You can continue spinward or antispinward, or go up a ladder into the hub.

>u
Inside the Hub
You float weightless in the middle of a cylinder. A ladder rotates around you, leading up or down or maybe out.

A yellow cable waves from a small panel.

* * *

>gonear sector 5
Sector 5: Forest
The school house is nestled among the trees. A pylon stretches up from the same grove to the hub of the station. You can walk spinward or antispinward.

>gonear platform 5
Platform 5
A mesh platform about two thirds of the way towards the hub. You can continue spinward or antispinward.

>d
You slide down the pylon.

>look
Sector 5: Forest
The school house is nestled among the trees. A pylon stretches up from the same grove to the hub of the station. You can walk spinward or antispinward.

* * *

>gonear sensor
Pod Bay
There are four berths for transit pods. Unfortunately, all are empty.

A secured hatch leads starboard.

An atmosphere sensor is on the wall, slowly flashing amber.

Someone left an emergency communications unit on the floor, presumably after removing it to free up pod space.

This is troubling. You counted. You were sure there would be one pod left. There are none.

[Your score has just gone up by two points.]

>scan sensor
Machine functional. Pressure is 80 kPa, O normal, CO high at 0.10%. No immediate danger.

>get sensor
That's fixed in place.

>l
Pod Bay
There are four berths for transit pods. Unfortunately, all are empty.

A secured hatch leads starboard.

An atmosphere sensor is on the wall, slowly flashing amber.

Someone left an emergency communications unit on the floor, presumably after removing it to free up pod space.

No pods left ... you consider despair.

>scan unit
Machine functional. No audio connection. No RF connection.

* * *

>gonear sensor
Pod Bay
There are four berths for transit pods. Unfortunately, all are empty.

A secured hatch leads starboard.

An atmosphere sensor is on the wall, slowly flashing amber.

Someone left an emergency communications unit on the floor, presumably after removing it to free up pod space.

This is troubling. You counted. You were sure there would be one pod left. There are none.

[Your score has just gone up by two points.]

>x sesnor
You can't see any such thing.

>x sensor
x.

>scan sensor
Machine functional. Pressure is 80 kPa, O normal, CO 0.10%

* * *

>gonear stack
There seems to be no such object anywhere in the model world.

>gonear pile
Pod Bay
There are four berths for transit pods. Unfortunately, all are empty.

A secured door leads starboard.

There is a pile of clutter. It looks like equipment removed to free up space in the transit pods.

This is troubling. You counted. You were sure there would be one pod left. There are none.

[Your score has just gone up by two points.]

>x pile
There are an atmosphere sensor, an emergency communications unit, and some unremarkable junk.

>take all from pile
That can't contain things.

>gonear crate
Supply Vault
This room is dim, quiet, and stuffy. There is still one crate of machine parts left.

There is a secured hatch in the ceiling.

You can also see a pair of gravity boots here.

>search crate
You find an instruction module and a pressure regulation module.

No pods left ... you consider despair.

>g
Miscellaneous parts, none useful.

* * *

>gonear tan
Church
Before everyone left or died, you celebrated every sabbath here. The altar stands against one wall, and an organ and an audio unit stand against the other.

On the altar is The Founder's Testament.

A gray cable connects the organ and the audio unit.

>x able
You can't see any such thing.

>x organ
It's really just a keyboard in a fancy box with a socket to connect it to an audio unit.

The organ has nothing plugged into it.

* * *

>gonear yello
There seems to be no such object anywhere in the model world.

>gonear yellow
Inside the Hub
You float weightless in the middle of a cylinder. A ladder rotates around you, leading up or down or maybe out.

A yellow cable flaps from a small panel.

>get cable
Taken.

>d
The yellow cable is permanently attached to the panel, so you can't leave while carrying it.

>drop cable
The yellow cable is permanently attached to the panel, so you can't leave while carrying it.

>d
The yellow cable is permanently attached to the panel, so you can't leave while carrying it.

* * *

>gonear yellow
Port End
A yellow cable waves from a small panel.

I beg your pardon?

>d
"L" = list of things: {ladder, yourself, panel, yellow cable}
"L" = list of things: {}

You struggle a little to make sure you are heading legs first and follow the ladder.

Platform 1
A mesh platform about two thirds of the way towards the hub. You can continue spinward or antispinward, or go up a ladder into the hub.

* * *

>gonear yellow
Port End
A yellow cable waves from a small panel.

>d
You make sure you are heading legs first and follow the ladder.

Platform 1
A mesh platform about two thirds of the way towards the hub. You can continue spinward or antispinward, or go up a ladder into the hub.

>showme yellow
yellow cable - thing
    RF plug (part of yellow cable) - RF plug
    RF plug (part of yellow cable) - RF plug
location: in Inside the Hub
singular-named, improper-named; unlit, inedible, portable, machinelike, floating-exceptioned
list grouping key: none
printed name: "yellow cable"
printed plural name: none
indefinite article: none
description: "A yellow RF cable."
initial appearance: "A yellow cable flaps from a small panel."

* * *

>d
You make sure you are heading legs first and follow the ladder.

Platform 1
A mesh platform about two thirds of the way towards the hub. You can continue spinward or antispinward, or go up a ladder into the hub.

>u
Inside the Hub
You float weightless in the middle of a cylinder. A ladder rotates around you, leading up or down or maybe out.

A yellow cable waves from a small panel.

>get yellow
Taken.

>d
The yellow cable is permanently attached to the panel, so you must drop it before leaving.

>d
The yellow cable is permanently attached to the panel, so you must drop it before leaving.

* * *

>u
Inside the Hub
You float weightless in the middle of a cylinder. A ladder rotates around you, leading up or down or maybe out.

A yellow cable waves from a small panel.

>x me
As virtuous as ever.

>get cable
Taken.

* * *

>d
You make sure you are heading legs first and follow the ladder.

Platform 1
A mesh platform about two thirds of the way towards the hub. You can continue spinward or antispinward, or go up a ladder into the hub.

>x cabe
You can't see any such thing.

>x cable
A yellow RF cable.

It is plugged into a panel.

* * *

>d
You make sure you are heading legs first and follow the ladder.

Platform 1
A mesh platform about two thirds of the way towards the hub. You can continue spinward or antispinward, or go up a ladder into the hub.

>x me
As virtuous as ever.

>u
Inside the Hub
You float weightless in the middle of a cylinder. A ladder rotates around you, leading up or down or maybe out.

A yellow cable flaps from a small panel.

>get all
yellow cable: Taken.

>i
You are carrying:
  a yellow cable (plugged into a panel)
  a scanner
  a green jumpsuit (being worn)

>d
The yellow cable is permanently attached to the panel, so you must drop it before leaving.

* * *

>gonear yellow
Port End
A yellow cable waves from a small panel.

>get yallow
You can't see any such thing.

>x yellow
A yellow RF cable.

It is plugged into an antenna panel.

>look
Inside the Hub
You float weightless in the middle of a cylinder. A ladder rotates around you, leading up or down or maybe out.

A yellow cable waves from a small panel.

>unplug yellow from panel
The yellow cable is permanently attached to the panel.

* * *

>gonear yellow
Port End
A yellow cable waves from a small panel.

>get yellow
Taken.

>d
*** Couldn't remove: the value yellow cable was not present in the list {} ***

*** Run-time problem P50: Attempt to use list item which does not exist.

The yellow cable is permanently attached to the panel, so you can't leave while carrying it.

>drop yellow
You drop the yellow cable and it floats nearby.

>d
You struggle a little to make sure you are heading legs first and follow the ladder.

Platform 1
A mesh platform about two thirds of the way towards the hub. You can continue spinward or antispinward, or go up a ladder into the hub.

* * *

>get yellow
Taken.

>out
The yellow cable is permanently attached to the panel, so you must drop it before leaving.

>g
The yellow cable is permanently attached to the panel, so you must drop it before leaving.

>pull yellow
(from the antenna panel)
The yellow cable is permanently attached to the panel.

>push yellow
Nothing obvious happens.

* * *

>get yellow
Taken.

>unplug yellow
(from the panel)
No.

* * *

>gonear yellow
Port End
A yellow cable waves from a small panel.

>i
You are carrying:
  a scanner
  a green jumpsuit (being worn)

>rop scanner
That's not a verb I recognize.

>drop scanner
Dropped.

>asw
The only exit is starboard to inside the hub.

>s
Inside the Hub
You float weightless in the middle of a cylinder. A ladder rotates around you, leading up or down or maybe out.

>l
Inside the Hub
You float weightless in the middle of a cylinder. A ladder rotates around you, leading up or down or maybe out.

* * *

>gonear yellow
Port End
A yellow cable waves from a small panel.

>look
Inside the Hub
You float weightless in the middle of a cylinder. A ladder rotates around you, leading up or down or maybe out.

A yellow cable flaps from a small panel.

>x yellow
A yellow RF cable.

It is not plugged into anything.

>get yellow
Taken.

>scan panel
Machine is functional.

>scan cable
Cable is functional.

>x plug
(the yellow cable)
A yellow RF cable.

It is not plugged into anything.

>purloin gray
[Purloined.]

>x plug
Which do you mean, the gray cable, an USB plug, the yellow cable, or a RF plug?

>gray
A one meter USB 7.2 cable with a Type-F plug at each end.

It is plugged into the organ and an audio unit.

* * *

>gonear yellow
Port End
A yellow cable waves from a small panel.

>purloin comms
[Purloined.]

>x comms
A portable emergency communications unit. Normally, its sockets would be for audio and antenna connections in a pod, but you will need to find another way.

The emergency communications unit has nothing plugged into it.

>plug yellow into comms
You plug the yellow cable into the emergency communications unit.

>x comms
A portable emergency communications unit. Normally, its sockets would be for audio and antenna connections in a pod, but you will need to find another way.

The emergency communications unit has a yellow cable plugged into it.

>scanner, scan comms
Machine functional. No Audio connection. No RF connection.
.

* * *

>gonear yellow
Port End
A yellow cable waves from a small panel.

>purloin scanner
[Purloined.]

>purloin comms
[Purloined.]

>scan comms
Machine functional. No Audio connection. No RF connection.

>plug yellow into comms
You plug the yellow cable into the emergency communications unit.

>scan comms
Machine functional. No Audio connection. RF connection.

>d
The yellow cable pulls out of the emergency communications unit.

You struggle a little to make sure you are heading legs first and follow the ladder.

Platform 1
A mesh platform about two thirds of the way towards the hub. You can continue spinward or antispinward, or go up a ladder into the hub.

>i
You are carrying:
  the emergency communications unit
  a scanner
  a green jumpsuit (being worn)

* * *

>gonear yellow
Port End
A yellow cable waves from a small panel.

>s
The only exit is outside to platform 1.

>d
"L" = list of things: {ladder, yourself, panel, yellow cable}
 the ladder"item" = thing: ladder
 the panel"item" = thing: panel
"L" = list of things: {yellow cable}
You feel that you shouldn't leave the yellow cable behind in case it floats off.

* * *

>gonear yellow
Port End
A yellow cable waves from a small panel.

>showme mL
There seems to be no such object anywhere in the model world.

>showme L
There seems to be no such object anywhere in the model world.

>d
"L" = list of things: {ladder, yourself, panel, yellow cable}
"item" = thing: ladder
"item" = thing: panel
"L" = list of things: {yellow cable}
You feel that you shouldn't leave the yellow cable behind in case it floats off.

* * *

>gonear yellow
Port End
A yellow cable waves from a small panel.

>unplug yellow
(from the panel)
The yellow cable is permanently attached to the panel.

>unplug yellow from panel
The yellow cable is permanently attached to the panel.

>unplug yellow from socket
You cannot specify a particular socket when unplugging something.

* * *

>unplug yellow
(from the panel)
The yellow cable is permanently attached to the panel.

>x panel
You see nothing special about the panel.

The panel has a yellow cable plugged into it.

>showme panel
(the panel)
panel - thing
    RF socket (part of panel) - RF socket
location: in Inside the Hub
singular-named, improper-named; unlit, inedible, fixed in place, scenery, machinelike
list grouping key: none
printed name: "panel"
printed plural name: none
indefinite article: none
description: none
initial appearance: none

* * *

>gonear yellow
Port End
A yellow cable waves from a small panel.

>x panel
Panel.

>z
Time passes.

>x panel
Panel.
The antenna panel has nothing plugged into it.

* * *

>z
Time passes.

>z
Time passes.

>gonear audio
Church
Before everyone left or died, you celebrated every sabbath here. The altar stands against one wall, and an organ and a portable audio unit stand against the other.

On the altar is The Founder's Testament.

A gray cable connects the organ to the audio unit.

>x audio
The audio unit incorporates a speaker, a microphone, and a socket you would use to connect it to another device. It contains a power module.

The audio unit has a gray cable plugged into it.

>x organ
It's really just a keyboard in a fancy box with a socket to connect it to an audio unit.
The organ has a gray cable plugged into it.

* * *

>gonear yellow
Port End
A yellow cable waves from a small panel.

>x rf
(the yellow cable)
A yellow RF cable. It is plugged into an antenna panel.

* * *

>gonear yelow
There seems to be no such object anywhere in the model world.

>gonear yellow
Inside the Hub
You float weightless in the middle of a cylinder. A ladder rotates around you, leading up or down or maybe out.

A yellow cable flaps from a small panel.

>ut
That's not a verb I recognize.

>out
"L" = list of things: {ladder, yourself, panel, yellow cable}
 the ladder"item" = thing: ladder
 yourself"item" = thing: yourself
 the panel"item" = thing: panel
 the yellow cable"item" = thing: yellow cable
"L" = list of things: {ladder, panel, yellow cable}
You feel that you shouldn't leave the ladder behind in case it floats off.

* * *

>goto church
That's not a verb I recognize.

>go near church
You can't see any such thing.

>gonear church
(Church)
(nothing)
Church
Before everyone left or died, you celebrated every sabbath here. The altar stands against one wall, and an organ and a portable audio unit stand against the other.

On the altar is The Founder's Testament.

A gray cable connects the organ to the audio unit.

>get cable
(gray cable)
Taken.

>in
The only exit is outside to sector 3.

>out
(nothing)The gray cable pulls out from the organ.
The gray cable pulls out from the audio unit.

(outside)
Sector 3: Forest
Trees, a house, and a church. A red pylon stretches up from the ground to the hub of the station. You can walk spinward or antispinward.

* * *

>gonear church
(Church)
Church
Before everyone left or died, you celebrated every sabbath here. The altar stands against one wall, and an organ and a portable audio unit stand against the other.

On the altar is The Founder's Testament.

A gray cable connects the organ to the audio unit.

>get acble
You can't see any such thing.

>get gray
Taken.

>out
The gray cable pulls out of the organ.
The gray cable pulls out of the audio unit.

Sector 3: Forest
Trees, a house, and a church. A red pylon stretches up from the ground to the hub of the station. You can walk spinward or antispinward.

>undo
Church
[Previous turn undone.]

>get audio
Taken.

>out
The gray cable pulls out of the organ.

Sector 3: Forest
Trees, a house, and a church. A red pylon stretches up from the ground to the hub of the station. You can walk spinward or antispinward.

>undo
Church
[Previous turn undone.]

* * *

>drop cable
Dropped.

>out
The gray cable pulls out of the audio unit.

Sector 3: Forest
Trees, a house, and a church. A red pylon stretches up from the ground to the hub of the station. You can walk spinward or antispinward.

* * *

>gonear church
(Church)
Church
Before everyone left or died, you celebrated every sabbath here. The altar stands against one wall, and an organ and a portable audio unit stand against the other.

On the altar is The Founder's Testament.

A gray cable connects the organ to the audio unit.

>get cable
(gray cable)
Taken.

>in
(inside)The gray cable pulls out from the organ.
The gray cable pulls out from the audio unit.

The only exit is outside to sector 3.

>x cable
(gray cable)
A one meter USB 7.2 cable with a Type-F plug at each end.

It is not plugged into anything.

>out
(nothing)
(outside)
Sector 3: Forest
Trees, a house, and a church. A red pylon stretches up from the ground to the hub of the station. You can walk spinward or antispinward.

>out
(nothing)
But you aren't in anything at the moment.

>in
(inside)
You can enter the church or the house.

>in
(inside)
You can enter the church or the house.

* * *

>get cable
(gray cable)
Taken.

>out
Sector 3: Forest
Trees, a house, and a church. A red pylon stretches up from the ground to the hub of the station. You can walk spinward or antispinward.

>undo
Church
[Previous turn undone.]

* * *

>i
You are carrying:
  a gray cable (plugged into the organ and an audio unit)
  a scanner
  a green jumpsuit (being worn)

>out
Sector 3: Forest
Trees, a house, and a church. A red pylon stretches up from the ground to the hub of the station. You can walk spinward or antispinward.

>i
You are carrying:
  a gray cable (plugged into the organ and an audio unit)
  a scanner
  a green jumpsuit (being worn)

>in
You can enter the church or the house.

>church
That's not a verb I recognize.

>go church
Church
Before everyone left or died, you celebrated every sabbath here. The altar stands against one wall, and an organ and a portable audio unit stand against the other.

On the altar is The Founder's Testament.

>i
You are carrying:
  a gray cable (plugged into the organ and an audio unit)
  a scanner
  a green jumpsuit (being worn)

* * *

>gonear church
(Church)
Church
Before everyone left or died, you celebrated every sabbath here. The altar stands against one wall, and an organ and a portable audio unit stand against the other.

On the altar is The Founder's Testament.

A gray cable connects the organ to the audio unit.

>i
You are carrying:
  a scanner
  a green jumpsuit (being worn)

>get cable
Taken.

>look
Church
Before everyone left or died, you celebrated every sabbath here. The altar stands against one wall, and an organ and a portable audio unit stand against the other.

On the altar is The Founder's Testament.

>look
Church
Before everyone left or died, you celebrated every sabbath here. The altar stands against one wall, and an organ and a portable audio unit stand against the other.

On the altar is The Founder's Testament.

>i
You are carrying:
  a gray cable (plugged into the organ and an audio unit)
  a scanner
  a green jumpsuit (being worn)

>out
(the usb plug in the gray cable)The gray cable pulls out from the organ (the tan socket).
(the usb plug in the gray cable)The gray cable pulls out from the audio unit (the beige socket).

Sector 3: Forest
Trees, a house, and a church. A red pylon stretches up from the ground to the hub of the station. You can walk spinward or antispinward.

>undo
Church
[Previous turn undone.]

* * *

>get audio
Taken.

>out
(the beige socket in the audio unit)(the usb plug in the gray cable)The gray cable pulls out from the organ (the tan socket).
(the usb plug in the gray cable)
Sector 3: Forest
Trees, a house, and a church. A red pylon stretches up from the ground to the hub of the station. You can walk spinward or antispinward.

>undo
Church
[Previous turn undone.]

>restart
Are you sure you want to restart?

* * *

>gonear church
(Church)
Church
Before everyone left or died, you celebrated every sabbath here. The altar stands against one wall, and an organ and a portable audio unit stand against the other.

On the altar is The Founder's Testament.

A gray cable connects the organ to the audio unit.

>purloin comms
[Purloined.]

>remove cable from organ
You unplug the gray cable from the organ.

>plug cable into comms
You plug the gray cable into the emergency communications unit.

>i
You are carrying:
  the emergency communications unit
  a scanner
  a green jumpsuit (being worn)

>get audio
Taken.

>i
You are carrying:
  an audio unit
  the emergency communications unit
  a scanner
  a green jumpsuit (being worn)

>x audio
The audio unit incorporates a speaker, a microphone, and a socket you would use to connect it to another device.

The audio unit has a gray cable plugged into it.

>x comms
A portable emergency communications unit with a single socket to connect it to a transit pod or other audio source.

The emergency communications unit has a gray cable plugged into it.

>look
Church
Before everyone left or died, you celebrated every sabbath here. The altar stands against one wall, and an organ stands against the other.

On the altar is The Founder's Testament.

You can also see a gray cable (plugged into the emergency communications unit and an audio unit) here.

>out
(the almond socket in the emergency communications unit)The emergency communications unit pulls out from the gray cable (the usb plug).
(the beige socket in the audio unit)The audio unit pulls out from the gray cable (the usb plug).

Sector 3: Forest
Trees, a house, and a church. A red pylon stretches up from the ground to the hub of the station. You can walk spinward or antispinward.

* * *

>gonear church
(Church)
Church
Before everyone left or died, you celebrated every sabbath here. The altar stands against one wall, and an organ and a portable audio unit stand against the other.

On the altar is The Founder's Testament.

A gray cable connects the organ to the audio unit.

>in
The only exit is outside to sector 3.

>in
The only exit is outside to sector 3.

>look
x.

Church
Before everyone left or died, you celebrated every sabbath here. The altar stands against one wall, and an organ and a portable audio unit stand against the other.

On the altar is The Founder's Testament.

A gray cable connects the organ to the audio unit.

* * *

>goto ladder
That's not a verb I recognize.

>gonear ladder
Platform 1
A mesh platform about two thirds of the way towards the hub. You can continue spinward or antispinward, or go up a ladder into the hub.

>u
Inside the Hub
You are weightless, so instead of up and down, you think of the ladder as leading "out."

>drop scanner
That floats.

>look
Inside the Hub
You are weightless, so instead of up and down, you think of the ladder as leading "out."

You can see a scanner floating here.

* * *

>hatch, open
You can't talk to the floor hatch.

* * *

>help
Your objective is simply to leave the station and find other people.

You can start by looking around and leaving your initial location.

By the way, it should be impossible to put this story into an unwinnable state, so feel free to explore and experiment.

If you are having trouble getting started, I suggest reading A Beginner's Guide to Interactive Fiction by Stephen Granade and Emily Short, available at:

  https://brasslantern.org/players/howto/beginnersguide.html

[You can type "hint" any time for contextual assistance. If you prefer not to be tempted, you can type "hints off" to disable hints.]

>gonear red
(the red circuit breaker)
Platform 3
A mesh platform about two thirds of the way towards the hub. You can continue spinward or antispinward.

You feel much lighter here, and you are very aware of how the station rotates, but everything is okay as long as you don't look down.

There is a red circuit breaker here.

>asw
Platform 1
A mesh platform about two thirds of the way towards the hub. You can continue spinward or antispinward, or go up a ladder into the hub.

>u
Inside the Hub
You are weightless, so instead of up and down, you think of the ladder as leading "out."

>out
jdskjfksd.

Platform 1
A mesh platform about two thirds of the way towards the hub. You can continue spinward or antispinward, or go up a ladder into the hub.

* * *

>hey scanner, help
Recognized commands are "help", "open", and "scan".

[You can ask the scanner for a list of commands by typing "scanner, help" and give it voice commands by typing phrases such as "scanner, scan SOMETHING" or "scanner, open SOMETHING" where SOMETHING is a visible object.]

>hey scanner, help me
Recognized commands are "help", "open", and "scan".

[You can ask the scanner for a list of commands by typing "scanner, help" and give it voice commands by typing phrases such as "scanner, scan SOMETHING" or "scanner, open SOMETHING" where SOMETHING is a visible object.]

* * *

>hint
Your objective is simply to leave the station and find other people.

You can start by looking around and leaving your initial location.

By the way, it should be impossible to put this story into an unwinnable state, so feel free to explore and experiment.

If you are having trouble getting started, I suggest reading A Beginner's Guide to Interactive Fiction by Stephen Granade and Emily Short, available at:

  https://brasslantern.org/players/howto/beginnersguide.html

[You can type "hint" any time for contextual assistance. If you prefer not to be tempted, you can type "hints off" to disable hints.]

>hint
You can start by looking around and leaving your initial location.

>look
Home
The room where you've slept your entire life. You can go out to your crops.

There is a secured hatch in the floor.

>help
You can start by looking around and leaving your initial location.

>hint
You can start by looking around and leaving your initial location.

* * *

>look
Home
The room where you've slept your entire life. You can go out to your crops.

There is a secured hatch in the floor.

>out
Sector 4: Crops
Your home is here among the crops. You can walk spinward or antispinward.

>look
Sector 4: Crops
Your home is here among the crops. You can walk spinward or antispinward.

>hint
You can start by looking around and leaving your initial location.

* * *

>i
You are carrying:
  a scanner
  a green jumpsuit (being worn)

>gonear ladder
There seems to be no such object anywhere in the model world.

>gonear the ladder
I only understood you as far as wanting to gonear Inside the Hub.

>onear red
That's not a verb I recognize.

>gonear red
(the red circuit breaker)
Platform 3
A mesh platform about two thirds of the way towards the hub. You can continue spinward or antispinward.

You feel much lighter here, and you are very aware of how the station rotates, but everything is okay as long as you don't look down.

There is a red circuit breaker here.

* * *

>asw
Platform 1
A mesh platform about two thirds of the way towards the hub. You can continue spinward or antispinward, or go up a ladder into the hub.

>x laddre
You can't see any such thing.

>x ladder
You can't see any such thing.

* * *

>i
You are carrying:
  a scanner
  a green jumpsuit (being worn)

>x me
As virtuous as ever.

>x jumpsuit
You have worn modest jumpsuits like this since you were small. Originally, the colors had meanings: forest green for farmers, navy blue for technicians, and so on, but that distinction died even before the population.

It features a single large pocket, currently empty.

>i
You are carrying:
  a scanner
  a green jumpsuit (being worn)

>say hellp
[To communicate in this story, type "CHARACTER, MESSAGE" where CHARACTER is someone or something and MESSAGE is what you want to say.]

>say hellp
[To communicate in this story, type "CHARACTER, MESSAGE" where CHARACTER is someone or something and MESSAGE is what you want to say.]

>play me
I don't even know what that means.

>play suit
That isn't something you can play.

>play doll
You can't see any such thing.

* * *

>in
X.
(inside)
You can't go inside, but you can go down to the cellar or outside to sector 4.

* * *

>l
Home
The room where you've slept your entire life. You can go out towards the crops.

There is a secured hatch in the floor.

>drop all
scanner: Dropped.

>ook
That's not a verb I recognize.

>look
Home
The room where you've slept your entire life. You can go out towards the crops.

There is a secured hatch in the floor.

You can also see a scanner here.

* * *

>get scanner
Taken.

>gonear ladder
Platform 1
A mesh platform about two thirds of the way towards the hub. You can continue spinward or antispinward, or go up a ladder into the hub.

* * *

>u
Inside the Hub
You are weightless, so instead of up and down, you think of the ladder as leading "out."

>look
Inside the Hub
You are weightless, so instead of up and down, you think of the ladder as leading "out."

>drop scanner
Dropped.

* * *

>d
You struggle a little to make sure you are heading legs first and follow the ladder.

Platform 1
A mesh platform about two thirds of the way towards the hub. You can continue spinward or antispinward, or go up a ladder into the hub.

>u
Inside the Hub
You are weightless, so instead of up and down, you think of the ladder as leading "out."

You can see a scanner floating here.

>analyze
(the green jumpsuit)
examining the green jumpsuit:
You have worn modest jumpsuits like this since you were small. Originally, the colors had meanings: forest green for farmers, navy blue for technicians, and so on, but that distinction died even before the population.

It features a single large pocket, currently empty.

looking under the green jumpsuit:
You find nothing of interest.

searching the green jumpsuit:
You find nothing of interest.

listening to the green jumpsuit:
You hear nothing unexpected.

smelling the green jumpsuit:
You smell nothing unexpected.

attacking the green jumpsuit:
The Founder said that violence is never the answer.

buying the green jumpsuit:
Nothing is on sale.

climbing the green jumpsuit:
Little is to be achieved by that.

pulling the green jumpsuit:
Nothing obvious happens.

pushing the green jumpsuit:
Nothing obvious happens.

turning the green jumpsuit:
Nothing obvious happens.

pushing the green jumpsuit to outside:
The green jumpsuit cannot be pushed from place to place.

opening the green jumpsuit:
It isn't something you can open.

entering the green jumpsuit:
That's not something you can enter.

getting off the green jumpsuit:
But you aren't on the green jumpsuit at the moment.

closing the green jumpsuit:
It isn't something you can close.

taking the green jumpsuit:
You already have that.

switching on the green jumpsuit:
It isn't something you can switch.

switching off the green jumpsuit:
It isn't something you can switch.

wearing the green jumpsuit:
You're already wearing that!

taking off the green jumpsuit:
Your nudity is pure and innocent, but still a little cold and uncomfortable.

(no other people in the location; can't test throwing at.)

(no other people in the location; can't test showing to.)

(no other people in the location; can't test giving to.)

touching the green jumpsuit:
You feel nothing unexpected.

rubbing the green jumpsuit:
You rub the green jumpsuit.

waving the green jumpsuit:
You wave the green jumpsuit.

squeezing the green jumpsuit:
You achieve nothing by this.

burning the green jumpsuit:
There is no open flame on the station.

cutting the green jumpsuit:
The Founder said that violence is never the answer.

tying the green jumpsuit to yourself:
You would achieve nothing by this.

swinging the green jumpsuit:
There's nothing sensible to swing here.

tasting the green jumpsuit:
You taste nothing unexpected.

drinking the green jumpsuit:
There's nothing suitable to drink here.

eating the green jumpsuit:
That's plainly inedible.

dropping the green jumpsuit:
Dropped.

* * *

>look
Home (on the blanket)
The room where you've slept your entire life. The crops are outside.

There is a secured hatch in the floor.

>get up
You get off the blanket.

Home
The room where you've slept your entire life. The crops are outside.

There is a secured hatch in the floor.

You can also see a blanket here.

>look
Home
The room where you've slept your entire life. The crops are outside.

There is a secured hatch in the floor.

You can also see a blanket here.

>x blanket
Home.

* * *

>look
Home (on the blanket)
The room where you've slept your entire life. The crops are outside.

There is a secured hatch in the floor.

>u
You can't go up, but you can go down to the cellar or outside to sector 4.

>gonear ladder
Platform 1
A mesh platform about two thirds of the way towards the hub. You can continue spinward or antispinward, or go up a ladder into the hub.

* * *

>x ladder
The ladder moves with the station, rotating around you four times every minute.

>u
You struggle a little to make sure you are heading legs first and follow the ladder.

Platform 1
A mesh platform about two thirds of the way towards the hub. You can continue spinward or antispinward, or go up a ladder into the hub.

* * *

>look
Home (on the blanket)
The room where you've slept your entire life. The crops are outside.

There is a secured hatch in the floor.

>x hatch
The hatch in the floor is secured shut, as you were trained, to protect against decompression.

>d
(first opening the floor hatch)
You scramble down through the hatch and close it behind yourself.

Cellar
Your decompression shelter and space for storage such as the increasingly empty shelves of canned vegetables.

There is a secured hatch in the ceiling.

>x sheltr
You can't see any such thing.

>x space
You can't see any such thing.

>x shelves
Almost a hundred jars of canned vegetables are on the makeshift shelves that line the wall. So is your emergency mask.

>x vegetables
Mostly tomatoes, green beans, carrots, and okra. Without a new source of salt or acid, too much of your recent harvests has been left to spoil.

>x mask
You wore this mask when there were regular decompression drills.

* * *

>i
You are carrying:
  an emergency mask
  a scanner
  a green jumpsuit (being worn)

>look
Cellar
Your decompression shelter and space for storage such as the increasingly empty shelves of canned vegetables.

There is a secured hatch in the ceiling.

>x shelves
Almost a hundred jars of canned vegetables are on the makeshift shelves that line the wall.

>analyze shelf
examining the shelves:
Almost a hundred jars of canned vegetables are on the makeshift shelves that line the wall.

looking under the shelves:
You find nothing of interest.

searching the shelves:
There is nothing on the shelves.

listening to the shelves:
You hear nothing unexpected.

smelling the shelves:
You smell nothing unexpected.

attacking the shelves:
The Founder said that violence is never the answer.

buying the shelves:
Nothing is on sale.

climbing the shelves:
Little is to be achieved by that.

pulling the shelves:
They are fixed in place.

pushing the shelves:
They are fixed in place.

turning the shelves:
They are fixed in place.

pushing the shelves to up:
The shelves cannot be pushed from place to place.

opening the shelves:
They aren't something you can open.

entering the shelves:
They're not something you can enter.

getting off the shelves:
But you aren't on the shelves at the moment.

closing the shelves:
They aren't something you can close.

taking the shelves:
They're hardly portable.

switching on the shelves:
They aren't something you can switch.

switching off the shelves:
They aren't something you can switch.

wearing the shelves:
(first taking the shelves)
They're hardly portable.

taking off the shelves:
You aren't wearing the shelves.

touching the shelves:
You feel nothing unexpected.

rubbing the shelves:
You rub the shelves.

waving the shelves:
But you aren't holding those.

squeezing the shelves:
You achieve nothing by this.

burning the shelves:
There is no open flame on the station.

cutting the shelves:
The Founder said that violence is never the answer.

tying the shelves to the ceiling hatch:
You would achieve nothing by this.

swinging the shelves:
There's nothing sensible to swing here.

tasting the shelves:
You taste nothing unexpected.

drinking the shelves:
There's nothing suitable to drink here.

eating the shelves:
They're plainly inedible.

dropping the shelves:
The shelves are already here.

* * *

>look
Home (on the blanket)
The room where you've slept your entire life. The crops are outside.

There is a secured hatch in the floor.

>x me
As virtuous as ever.

>purloin comms
[Purloined.]

* * *

>x comms
A portable emergency communications unit. Normally, its sockets would be for audio and antenna connections in a pod, but you will need to find another way.

The emergency communications unit has nothing plugged into it.

>x sockets
You can't use multiple objects with that verb.

* * *

>look
Home (on the blanket)
The room where you've slept your entire life. The crops are outside.

There is a secured hatch in the floor.

>x room
You can't see any such thing.

>x slept
You can't see any such thing.

>d
(first opening the floor hatch)

Cellar
Your decompression shelter and space for some increasingly empty shelves of canned vegetables.

There is an open hatch in the ceiling.

>x shelter
You can't see any such thing.

>x shelves
Almost a hundred jars of canned vegetables are on the makeshift shelves that line the wall. So is your emergency mask.

>x empty shelves
You can't see any such thing.

>x makeshift
You can't see any such thing.

>x emergency amsk
I only understood you as far as wanting to examine the emergency mask.

>x emergency mask
You wore this mask when there were regular decompression drills.

>u
Home
The room where you've slept your entire life. You can go out towards the crops.

There is an open hatch in the floor.

>u
You can't go that way. The obvious exits are down (to cellar) and outside.

>out
Sector 4: Crops
Your home is here among the crops. You can walk spinward or antispinward.

>x crops
Greens, carrots, and potatoes.

>sw
You walk a little ways to the next sector.

Sector 5: Forest
The school house is nestled among the trees. A pylon stretches up from the same grove to the hub of the station. You can walk spinward or antispinward.

>x school
Little and red, the traditional markings of a school building.

>x pyloin
You can't see any such thing.

>x pylon
Made of smooth metal, it connects the ground to the hub of the station many meters above.

>x grove
The community grew trees for tradition, and they help with air processing.

>sw
You walk a little ways to the next sector.

Sector 6: Hydroponics
Your people preferred to grow things the old fashioned way, but in truth the majority of your fruit and vegetables came from this sector when the machines still worked. You can walk spinward or antispinward.

There is a secured hatch in the ground.

>x fruit
You can't see any such thing.

>x machines
You were thoroughly trained in hydroponics maintenance, but fixing these machines is beyond you.

>sw
You walk a little ways to the next sector.

Sector 1: Crops
You still maintain the crops here. There is a small graveyard and the barn remains from when this was the livestock sector. A pylon stretches up from the ground to the hub of the station. You can walk spinward or antispinward.

There is a secured hatch in the ground.

>x pylon
Made of smooth metal, it connects the ground to the hub of the station many meters above.

>x small
You can't see any such thing.

>x small graveyard
You can't see any such thing.

>sw
You walk a little ways to the next sector.

Sector 2: Aquaculture
A deep pond is used as part of the water filtration system and for raising fish. You can walk spinward or antispinward.

>x water
Something to do with water filtration, and there are still some fish.

>sw
You walk a little ways to the next sector.

Sector 3: Forest
Trees, a house, and a church. A red pylon stretches up from the ground to the hub of the station. You can walk spinward or antispinward.

You have walked the entire ring. Everything is as expected, much is not working. Now, it's time to leave: the pods are below Sector 1.

>x trees
The community grew trees for tradition, and they help with air processing.

>x grove
The community grew trees for tradition, and they help with air processing.

>look
Sector 3: Forest
Trees, a house, and a church. A red pylon stretches up from the ground to the hub of the station. You can walk spinward or antispinward.

>sw
You walk a little ways to the next sector.

Sector 4: Crops
Your home is here among the crops. You can walk spinward or antispinward.

>asw
You walk a little ways to the next sector.

Sector 3: Forest
Trees, a house, and a church. A red pylon stretches up from the ground to the hub of the station. You can walk spinward or antispinward.

>go house
House
Two families lived here, but not recently.

Someone has left a doll on the well swept floor.

>x doll
Wearing a brown jumpsuit and faceless, because we are all alike in the Founder's eyes.

>out
Sector 3: Forest
Trees, a house, and a church. A red pylon stretches up from the ground to the hub of the station. You can walk spinward or antispinward.

* * *

>in
You can enter the church or the house.

>x church
A small white building with a steeple.

>look
Sector 3: Forest
Trees, a house, and a church. A red pylon stretches up from the ground to the hub of the station. You can walk spinward or antispinward.

>go church
Church
Before everyone left or died, you celebrated every sabbath here. The altar stands against one wall, and an organ and an audio unit stand against the other.

On the altar is The Founder's Testament.

A gray cable connects the organ and the audio unit.

>x altar
Really just a table.

On the altar is The Founder's Testament.

>x organ
It's really just a keyboard in a fancy box with a socket to connect it to an audio unit.

The organ has a gray cable plugged into it.

>x audio
The audio unit incorporates a speaker, a microphone, and a socket you would use to connect it to another device.

The audio unit has a gray cable plugged into it.

>remove gray from audio
You unplug the gray cable from the audio unit.

>x audio
The audio unit incorporates a speaker, a microphone, and a socket you would use to connect it to another device.

The audio unit has nothing plugged into it.

>version
Founder's Mercy
A Space Story by Thomas Insel
Release 1 / Serial number 181201 / Inform 7 build 6M62 (I6/v6.33 lib 6/12N) SD
Type "about" for credits or "hint" for assistance.
Identification number: //BCC61E7F-CE8E-4C25-9E9D-5550D1138D8C//
Interpreter version 0.5.2 / VM 3.1.2 / Library serial number 080126
Standard Rules version 3/120430 by Graham Nelson
Unicode Character Names by Graham Nelson
Exit Lister version 11 by Eric Eve
Plugs and Sockets version 4/170924 by Sean Turner
Object Response Tests version 7 by Juhana Leinonen

* * *

>look through hatch
The floor hatch is secured.

>look through door
You can't see any such thing.

* * *

>look through hatch
The floor hatch is secured.

>open hatch
You open the floor hatch.

>look through hatch
Through the floor hatch is the cellar (down).

>d
Cellar
Your decompression shelter and space for some increasingly empty shelves of canned vegetables.

There is an open hatch in the ceiling.

>look through hatch
Through the ceiling hatch is your home (up).

* * *

>ltree
That's not a verb I recognize.

>rtree
Barn
    the plow
Cellar
    the shelves + canned vegetables and emergency mask 
Center Platform
    the red circuit breaker
Church
    the altar + Founder's Testament 
    the organ & tan socket
    the audio unit + power module & beige socket
    the gray cable & usb plug and usb plug
Home
    yourself + green jumpsuit, pocket, and scanner 
House
    the doll
Pod Bay
    the berths
    the emergency communications unit & almond socket
Pod Control
    the space suit
    the brass plate
    the status display
    the atmosphere pump + power module and pressure regulation module 
School
    the learning machine + instruction module and power module 
    the desk + clean eraser 
    the chalkboard
Sector 1: Crops
    the pylon
    the crops
    the graveyard
Sector 2: Aquaculture
    the pond
    the fish
Sector 3: Forest
    the pylon
    the trees
Sector 4: Crops
    the vegetables
Sector 5: Forest
    the pylon
    the trees
Sector 6: Hydroponics
    the hydroponics machines
Supply Vault
    the crate of machine parts
    the pair of gravity boots
(Nowhere)
    the green circuit breaker
    the instruction module
    the junk repository
    the laser beam
    the light-meter
    the pressure regulation module

>showme light-meter
There seems to be no such object anywhere in the model world.

>showme junk repository
junk repository - open container
    instruction module - instruction module
    pressure regulation module - pressure regulation module
location: out of play
singular-named, improper-named; unlit, inedible, portable; opaque, open, unopenable, unlocked
list grouping key: none
printed name: "junk repository"
printed plural name: "containers"
indefinite article: none
description: none
initial appearance: none
carrying capacity: 100

>showme shelf
shelves - supporter
    canned vegetables
    emergency mask
location: in Cellar
plural-named, improper-named; unlit, inedible, fixed in place, scenery; list grouping key: none
printed name: "shelves"
printed plural name: "supporters"
indefinite article: none
description: "Almost a hundred jars of canned vegetables are on the makeshift shelves that line the wall. So is your emergency mask."
initial appearance: none
carrying capacity: 100

>showme instruction module
instruction module - instruction module
location: in the learning machine in School
singular-named, improper-named; unlit, inedible, portable
list grouping key: none
printed name: "instruction module"
printed plural name: "instruction modules"
indefinite article: none
description: none
initial appearance: none
status: faulty

>gonear learning
School
A broken learning machine remains in a corner, but mostly the older farmers took turns leading the class. There is a desk, and a chalkboard hangs on one wall.

On the desk is a clean eraser.

>scanner, open learning
Opening.

The learning machine swings open, revealing a power module and an instruction module.

[Your score has just gone up by one point.]

>scanner, scan instruction
Module is faulty.

>rtree
Barn
    the plow
Cellar
    the shelves + canned vegetables and emergency mask 
Center Platform
    the red circuit breaker
Church
    the altar + Founder's Testament 
    the organ & tan socket
    the audio unit + unscanned power module & beige socket
    the gray cable & usb plug and usb plug
Home
House
    the doll
Pod Bay
    the berths
    the emergency communications unit & almond socket
Pod Control
    the space suit
    the brass plate
    the status display
    the atmosphere pump + unscanned power module and unscanned pressure regulation module 
School
    yourself + green jumpsuit, pocket, and scanner 
    the learning machine + faulty instruction module and unscanned power module 
    the desk + clean eraser 
    the chalkboard
Sector 1: Crops
    the pylon
    the crops
    the graveyard
Sector 2: Aquaculture
    the pond
    the fish
Sector 3: Forest
    the pylon
    the trees
Sector 4: Crops
    the vegetables
Sector 5: Forest
    the pylon
    the trees
Sector 6: Hydroponics
    the hydroponics machines
Supply Vault
    the crate of machine parts
    the pair of gravity boots
(Nowhere)
    the green circuit breaker
    the unscanned instruction module
    the junk repository
    the laser beam
    the light-meter
    the unscanned pressure regulation module

>showme unscanned instruction module
unscanned instruction module - instruction module
location: in the junk repository out of play
singular-named, improper-named; unlit, inedible, portable
list grouping key: none
printed name: "instruction module"
printed plural name: "instruction modules"
indefinite article: none
description: none
initial appearance: none
status: faulty

* * *

>ntree
the light-meter
the green circuit breaker
the junk repository
the instruction module
the pressure regulation module
the laser beam

* * *

>onear red
That's not a verb I recognize.

* * *

>asw
Platform 1
A mesh platform about two thirds of the way towards the hub. You can continue spinward or antispinward, or go up a ladder into the hub.

>u
Inside the Hub
You are weightless, so instead of up and down, you think of the ladder as leading "out."

one.

>i
You are carrying:
  a scanner
  a green jumpsuit (being worn)

* * *

>drop scanner
Dropped.

>look
Inside the Hub
You are weightless, so instead of up and down, you think of the ladder as leading "out."

one.

>d
You struggle a little to make sure you are heading legs first and follow the ladder.

Platform 1
A mesh platform about two thirds of the way towards the hub. You can continue spinward or antispinward, or go up a ladder into the hub.

>u
Inside the Hub
You are weightless, so instead of up and down, you think of the ladder as leading "out."

one.

>get scanner
Taken.

* * *

>open hatch
You open the floor hatch.

>look through hatch
The cellar is down through the floor hatch.

>d
Cellar
Your decompression shelter and space for some increasingly empty shelves of canned vegetables.

There is an open hatch in the ceiling.

>look through hatch
Your home is up through the ceiling hatch.

* * *

>look through hatch
The cellar is down through the floor hatch.

>gonear red
(the red circuit breaker)
Center Platform
It's a mesh platform a little below the hub. You feel much lighter here, and you are very aware of how the station rotates, but everything is okay as long as you don't look down.

You can just reach a red circuit breaker on the hub.

>turn red on
You reach up and switch the circuit breaker on.

[Your score has just gone up by one point.]

>gonear pond
Sector 2: Aquaculture
A deep pond is used as part of the water filtration system and for raising fish. You can walk spinward or antispinward.

>purloin mask
[Purloined.]

>wear mask
You put on the emergency mask.

>go pond
With the air from the emergency mask, you breathe comfortably as you step into the pond. At the bottom, you find a green circuit breaker and flip it on.

[Your score has just gone up by two points.]

>gonear display
Pod Control
This room serves as an airlock for the pod bay, and holds an old space suit and various machinery such as the atmosphere pump. There is a brass plate on the wall.

There is a secured hatch in the ceiling.

Beside the secured port hatch, a status display shows an error message.

>scanner, open pump
You can't talk to the scanner while wearing the mask.

>remove mask
You take off the emergency mask.

>scanner, open pump
Opening.

The atmosphere pump swings open, revealing a power module and a pressure regulation module.

>purloin all presure
There seems to be no such object anywhere in the model world.

>purloin all pressure
[Purloined.]

>purloin all power
[Purloined.]

>u
(first opening the ceiling hatch)

Sector 1: Crops
You still maintain the crops here. There is a small graveyard and the barn remains from when this was the livestock sector. A pylon stretches up from the ground to the hub of the station. You can walk spinward or antispinward.

There is an open hatch in the ground.

>purloin all power
[Purloined.]

>d
Pod Control
This room serves as an airlock for the pod bay, and holds an old space suit and various machinery such as the atmosphere pump. There is a brass plate on the wall.

There is an open hatch in the ceiling.

Beside the secured port hatch, a status display shows an error message.

The atmosphere pump is open and empty.

>rop all
That's not a verb I recognize.

>drop all
power module: Dropped.
pressure regulation module: Dropped.
emergency mask: Dropped.
scanner: Dropped.

>u
Sector 1: Crops
You still maintain the crops here. There is a small graveyard and the barn remains from when this was the livestock sector. A pylon stretches up from the ground to the hub of the station. You can walk spinward or antispinward.

There is an open hatch in the ground.

>purloin all pressure
[Purloined.]
[Purloined.]

>purloin all power
[Purloined.]
[Purloined.]
[Purloined.]

>d
Pod Control
This room serves as an airlock for the pod bay, and holds an old space suit and various machinery such as the atmosphere pump. There is a brass plate on the wall.

There is an open hatch in the ceiling.

Beside the secured port hatch, a status display shows an error message.

The atmosphere pump is open and empty.

You can also see a scanner and an emergency mask here.

>i
You are carrying:
  three power modules
  two pressure regulation modules
  a green jumpsuit (being worn)

>scan pressure
You must be carrying the scanner to use it.

>get scanner
(putting the pressure regulation module into your pocket to make room)
You're carrying too many things already.

>scan pressure
You must be carrying the scanner to use it.

>drop all
power module: Dropped.
power module: Dropped.
power module: Dropped.
pressure regulation module: Dropped.

>all
That's not a verb I recognize.

>get all
pressure regulation module: Taken.
power module: Taken.
power module: Taken.
power module: (putting the pressure regulation module into your pocket to make room)
Taken.
scanner: (putting the power module into your pocket to make room)
Taken.
emergency mask: (putting the power module into your pocket to make room)
Taken.

>scanner, scan all power
Search error: cannot find all power.

[You can ask the scanner for a list of commands by typing "scanner, help" and give it voice commands by typing phrases such as "scanner, scan SOMETHING" or "scanner, open SOMETHING" where SOMETHING is a visible object.]

>scanner, scan power
Module is functional.

>put functional power in pump
You put the functional power module into the atmosphere pump.

>scanner, scan regulator
Module is functional.

>put functional regulator in pump
(first taking the functional pressure regulation module)
You put the functional pressure regulation module into the atmosphere pump.

>close pump
You close the atmosphere pump and it begins to hum.

It is time to say goodbye to the station. You are ready to leave in a pod.

[Your score has just gone up by one point.]

>open port
(the wall hatch)
It seems to be locked.

>look
Pod Control
This room serves as an airlock for the pod bay, and holds an old space suit and various machinery such as the atmosphere pump. There is a brass plate on the wall.

There is an open hatch in the ceiling.

Beside the secured port hatch, a status display shows an error message.

>close ceiling
You close the ceiling hatch.

>search port
(the wall hatch)
The wall hatch is secured.

>open port
(the wall hatch)
You open the wall hatch.

>search port
(the wall hatch)
The pod bay is port through the wall hatch.

>port
You close the hatch behind yourself.

Pod Bay
There are four berths for transit pods. Unfortunately, all are empty.

A secured hatch leads starboard.

Someone left an emergency communications unit on the floor.

This is troubling. You counted. You were sure there would be one pod left. There are none.

[Your score has just gone up by two points.]

>open hatch
You open the wall hatch.

>look through hatch
Pod control is starboard through the wall hatch.

>s
You close the hatch behind yourself.

Pod Control
This room serves as an airlock for the pod bay, and holds an old space suit and various machinery such as the atmosphere pump. There is a brass plate on the wall.

Beside the secured port hatch, a status display glows green.

There is a secured hatch in the ceiling.

No pods left ... you consider despair.

>out
But you aren't in anything at the moment.

>s
You can't go starboard, but you can go up to sector 1 or port to the pod bay.

So what if you can't escape in a pod. You will just need to bring a pod here. Time to get the communications module working.

>port
(first opening the wall hatch)
You close the hatch behind yourself.

Pod Bay
There are four berths for transit pods. Unfortunately, all are empty.

A secured hatch leads starboard.

Someone left an emergency communications unit on the floor.

>u
The only exit is starboard to pod control.

>look
Pod Bay
There are four berths for transit pods. Unfortunately, all are empty.

A secured hatch leads starboard.

Someone left an emergency communications unit on the floor.

>exits
The only exit is starboard to pod control.

>ceiling hatch
That's not a verb I recognize.

>open ceiling hatch
You can't see any such thing.

>s
(first opening the wall hatch)
You close the hatch behind yourself.

Pod Control
This room serves as an airlock for the pod bay, and holds an old space suit and various machinery such as the atmosphere pump. There is a brass plate on the wall.

Beside the secured port hatch, a status display glows green.

There is a secured hatch in the ceiling.

>up
(first opening the ceiling hatch)

Sector 1: Crops
You still maintain the crops here. There is a small graveyard and the barn remains from when this was the livestock sector. A pylon stretches up from the ground to the hub of the station. You can walk spinward or antispinward.

There is an open hatch in the ground.

>d
Pod Control
This room serves as an airlock for the pod bay, and holds an old space suit and various machinery such as the atmosphere pump. There is a brass plate on the wall.

There is an open hatch in the ceiling.

Beside the secured port hatch, a status display shows an error message.

* * *

>out
You get off the blanket.

Home
The room where you've slept your entire life. The crops are outside.

There is a secured hatch in the floor.

The homespun blanket which you use as your bed is arranged on the ground.

>asw
You walk a little ways to the next sector.

Sector 3: Forest
Trees, a house, and a church. A red pylon stretches up from the ground to the hub of the station. You can walk spinward or antispinward.

>asw
You walk a little ways to the next sector.

Sector 2: Aquaculture
A deep pond is used as part of the water filtration system and for raising fish. You can walk spinward or antispinward.

>asw
You walk a little ways to the next sector.

Sector 1: Crops
You still maintain the crops here. There is a small graveyard and the barn remains from when this was the livestock sector. A pylon stretches up from the ground to the hub of the station. You can walk spinward or antispinward.

There is a secured hatch in the ground.

>sw
You walk a little ways to the next sector.

Sector 2: Aquaculture
A deep pond is used as part of the water filtration system and for raising fish. You can walk spinward or antispinward.

>u
You can't go up, but you can go spinward to sector 3 or antispinward to sector 1.

>asw
You walk a little ways to the next sector.

Sector 1: Crops
You still maintain the crops here. There is a small graveyard and the barn remains from when this was the livestock sector. A pylon stretches up from the ground to the hub of the station. You can walk spinward or antispinward.

There is a secured hatch in the ground.

>u
The pylon is slick metal with no obvious handholds.

>gonear red
(the red circuit breaker)
Platform 3
It's a mesh platform about two thirds of the way towards the hub. You feel much lighter here, and you are very aware of how the station rotates, but everything is okay as long as you don't look down. You can continue spinward or antispinward.

There is a red circuit breaker here.

>asw
Platform 1
It's a mesh platform about two thirds of the way towards the hub. You feel much lighter here, and you are very aware of how the station rotates, but everything is okay as long as you don't look down. You can continue spinward or antispinward.

>d
You slide down the pylon.

Sector 1: Crops
You still maintain the crops here. There is a small graveyard and the barn remains from when this was the livestock sector. A pylon stretches up from the ground to the hub of the station. You can walk spinward or antispinward.

There is a secured hatch in the ground.

* * *

>u
The pylon is slick metal with no obvious handholds.

>gonear rd
There seems to be no such object anywhere in the model world.

>gonear red
(the red circuit breaker)
Platform 3
It's a mesh platform about two thirds of the way towards the hub. You feel much lighter here, and you are very aware of how the station rotates, but everything is okay as long as you don't look down. You can continue spinward or antispinward.

There is a red circuit breaker here.

* * *

>asw
Platform 1
It's a mesh platform about two thirds of the way towards the hub. You feel much lighter here, and you are very aware of how the station rotates, but everything is okay as long as you don't look down. You can continue spinward or antispinward.

>drop scaner
You can't see any such thing.

>drop scanner
You drop the scanner and it spirals off to the ground below.

>d
You slide down the pylon.

Sector 1: Crops
You still maintain the crops here. There is a small graveyard and the barn remains from when this was the livestock sector. A pylon stretches up from the ground to the hub of the station. You can walk spinward or antispinward.

There is a secured hatch in the ground.

>sw
You walk a little ways to the next sector.

Sector 2: Aquaculture
A deep pond is used as part of the water filtration system and for raising fish. You can walk spinward or antispinward.

You can see a scanner here.

>get scanner
Taken.

>gonear red
(the red circuit breaker)
Platform 3
It's a mesh platform about two thirds of the way towards the hub. You feel much lighter here, and you are very aware of how the station rotates, but everything is okay as long as you don't look down. You can continue spinward or antispinward.

There is a red circuit breaker here.

>l
Platform 3
It's a mesh platform about two thirds of the way towards the hub. You feel much lighter here, and you are very aware of how the station rotates, but everything is okay as long as you don't look down. You can continue spinward or antispinward.

There is a red circuit breaker here.

>sw
You can't go spinward, but you can go down to sector 3 or antispinward to platform 1.

>asw
Platform 1
It's a mesh platform about two thirds of the way towards the hub. You feel much lighter here, and you are very aware of how the station rotates, but everything is okay as long as you don't look down. You can continue spinward or antispinward.

>look
Platform 1
It's a mesh platform about two thirds of the way towards the hub. You feel much lighter here, and you are very aware of how the station rotates, but everything is okay as long as you don't look down. You can continue spinward or antispinward.

>n
You have heard of compass directions like north, but they don't make any sense here. Instead, you can go spinward, antispinward, port, and starboard. When you look spinward, port is left and starboard is right.

[You can use the abbreviations "sw", "asw", "p", and "s". You can also go "up", "down", "in", and "out" where appropriate. Type "exits" if you get confused about geography.]

>sw
Platform 3
It's a mesh platform about two thirds of the way towards the hub. You feel much lighter here, and you are very aware of how the station rotates, but everything is okay as long as you don't look down. You can continue spinward or antispinward.

There is a red circuit breaker here.

>asw
Platform 1
It's a mesh platform about two thirds of the way towards the hub. You feel much lighter here, and you are very aware of how the station rotates, but everything is okay as long as you don't look down. You can continue spinward or antispinward.

>asw
You can't go antispinward, but you can go down to sector 1 or spinward to platform 3.

* * *

>asw
You walk a little ways to the next sector.

Sector 3: Forest
Trees, a house, and a church. A red pylon stretches up from the ground to the hub of the station. You can walk spinward or antispinward.

>church
Church
Before everyone left or died, you celebrated every sabbath here. The altar stands against one wall, and an organ and a portable audio unit stand against the other.

On the altar is The Founder's Testament.

A gray cable connects the organ to the audio unit.

>undo
Sector 3: Forest
[Previous turn undone.]

>in
You can enter the church or the house.

* * *

>undo
Sector 3: Forest
[Previous turn undone.]

>house
That's not a verb I recognize.

* * *

>asw
You walk a little ways to the next sector.

Sector 3: Forest
Trees, a house, and a church. A red pylon stretches up from the ground to the hub of the station. You can walk spinward or antispinward.

>in
You can enter the church or the house.

>go church
Church
Before everyone left or died, you celebrated every sabbath here. The altar stands against one wall, and an organ and a portable audio unit stand against the other.

On the altar is The Founder's Testament.

A gray cable connects the organ to the audio unit.

>get unit
That is attached to the wall.

>x unit
The audio unit incorporates a speaker, a microphone, and a socket you would use to connect it to another device.

The audio unit has a gray cable plugged into it.

* * *

>go church
Church
Before everyone left or died, you celebrated every sabbath here. The altar stands against one wall, and an organ and a portable audio unit stand against the other.

On the altar is The Founder's Testament.

A gray cable connects the organ to the audio unit.

>i
You are carrying:
  a scanner
  a green jumpsuit (being worn)

* * *

>i
You are carrying:
  an audio unit
  a scanner
  a green jumpsuit (being worn)

>x unit
The audio unit incorporates a speaker, a microphone, and a socket you would use to connect it to another device.

The audio unit has a gray cable plugged into it.

>x cable
A one meter USB 7.2 cable with a Type-F plug at each end.

It is plugged into the organ and an audio unit.

>out
The audio unit pulls out from the gray cable.

Sector 3: Forest
Trees, a house, and a church. A red pylon stretches up from the ground to the hub of the station. You can walk spinward or antispinward.

>i
You are carrying:
  an audio unit
  a scanner
  a green jumpsuit (being worn)

>x unit
The audio unit incorporates a speaker, a microphone, and a socket you would use to connect it to another device.

The audio unit has nothing plugged into it.

>in
You can enter the church or the house.

* * *

>church
That's not a verb I recognize.

>go church
Church
Before everyone left or died, you celebrated every sabbath here. The altar stands against one wall, and an organ stands against the other.

On the altar is The Founder's Testament.

You can also see a gray cable (plugged into the organ) here.

>out
Sector 3: Forest
Trees, a house, and a church. A red pylon stretches up from the ground to the hub of the station. You can walk spinward or antispinward.

* * *

>in
You can enter the church or the house.

>showme cable
gray cable - thing
    usb plug (part of gray cable) - usb plug
    usb plug (part of gray cable) - usb plug
location: in Church
singular-named, improper-named; unlit, inedible, portable, handled, machinelike
list grouping key: none
printed name: "gray cable"
printed plural name: none
indefinite article: none
description: "A one meter USB 7.2 cable with a Type-F plug at each end."
initial appearance: "A gray cable connects the organ to the audio unit."

>get cable
You can't see any such thing.

>go church
Church
Before everyone left or died, you celebrated every sabbath here. The altar stands against one wall, and an organ stands against the other.

On the altar is The Founder's Testament.

You can also see a gray cable (plugged into the organ) here.

>get cable
Taken.

>showme cable
gray cable - thing
    usb plug (part of gray cable) - usb plug
    usb plug (part of gray cable) - usb plug
location: carried by yourself in Church
singular-named, improper-named; unlit, inedible, portable, handled, machinelike
list grouping key: none
printed name: "gray cable"
printed plural name: none
indefinite article: none
description: "A one meter USB 7.2 cable with a Type-F plug at each end."
initial appearance: "A gray cable connects the organ to the audio unit."

>in
The gray cable pulls out from the organ.

The only exit is outside to sector 3.

* * *

>asw
You walk a little ways to the next sector.

Sector 3: Forest
Trees, a house, and a church. A red pylon stretches up from the ground to the hub of the station. You can walk spinward or antispinward.

>purloin boots
[Purloined.]

* * *

>u
With the boots, you are able to climb up the pylon. As you get closer to the hub, gravity decreases, and the climb becomes easier.

Platform 3
A mesh platform about two thirds of the way towards the hub. You can continue spinward or antispinward.

You feel much lighter here, and you are very aware of how the station rotates, but everything is okay as long as you don't look down.

There is a red circuit breaker here.

>asw
Platform 1
A mesh platform about two thirds of the way towards the hub. You can continue spinward or antispinward.

>sw
You feel much lighter here, and you are very aware of how the station rotates, but everything is okay as long as you don't look down.

>look
Platform 3
A mesh platform about two thirds of the way towards the hub. You can continue spinward or antispinward.

There is a red circuit breaker here.

* * *

>d
You climb down the pylon.

Sector 3: Forest
Trees, a house, and a church. A red pylon stretches up from the ground to the hub of the station. You can walk spinward or antispinward.

>undo
Center Platform 3
[Previous turn undone.]

>undo
Sector 3: Forest
[Previous turn undone.]

>u
It isn't easy, but with the boots, you make a long climb towards the hub.

Center Platform 3
It's a mesh platform about two thirds of the way towards the hub. You feel much lighter here, and you are very aware of how the station rotates, but everything is okay as long as you don't look down.

There is a red circuit breaker here.

>d
You climb down the pylon.

Sector 3: Forest
Trees, a house, and a church. A red pylon stretches up from the ground to the hub of the station. You can walk spinward or antispinward.

>i
You are carrying:
  a pair of gravity boots (being worn)
  a scanner
  a green jumpsuit (being worn)

>x pylons
Made of smooth metal, anodized red, it connects the ground to the hub of the station many meters above.

>sw
You walk a little ways to the next sector.

Sector 4: Crops
Your home is here among the crops. You can walk spinward or antispinward.

>x pylons
Spinward and antispinward from here, you can see pylons connecting the ground to the hub.

>x hub
The station rotates around the hub, which extends out to hold solar panels on the port and mirrors on the starboard side. On the inside, there is a maintenance platform about two thirds of the way up the pylons.

* * *

>u
With the boots, you are able to climb up the pylon. As you get closer to the hub, gravity decreases, and the climb becomes easier.

Platform 3
A mesh platform about two thirds of the way towards the hub. You can continue spinward or antispinward.

You feel much lighter here, and you are very aware of how the station rotates, but everything is okay as long as you don't look down.

There is a red circuit breaker here.

>look
Platform 3
A mesh platform about two thirds of the way towards the hub. You can continue spinward or antispinward.

There is a red circuit breaker here.

* * *

>u
With the boots, you are able to climb up the pylon. As you get closer to the hub, gravity decreases, and the climb becomes easier.

Platform 3
A mesh platform about two thirds of the way towards the hub. You can continue spinward or antispinward.

You feel much lighter here, and you are very aware of how the station rotates, but everything is okay as long as you don't look down.

There is a red circuit breaker here.

>x breaker
The red circuit breaker is currently switched off.

* * *

>asw
You walk a little ways to the next sector.

Sector 3: Forest
Trees, a house, and a church. A red pylon stretches up from the ground to the hub of the station. You can walk spinward or antispinward.

>u
The red pylon is designated for climbing, but you can't get a grip.

>u
The red pylon is designated for climbing, but you can't get a grip.

* * *

>purloin boots
[Purloined.]

>u
The red pylon is designated for climbing, but you can't get a grip.

>wear boots
You put on the pair of gravity boots.

>u
It isn't easy, but with the boots, you make a long climb towards the hub.

It isn't easy, but with the boots, you make a long climb towards the hub.

Platform 3
A mesh platform about two thirds of the way towards the hub. You can continue spinward or antispinward.

You feel much lighter here, and you are very aware of how the station rotates, but everything is okay as long as you don't look down.

There is a red circuit breaker here.

>d
You climb down the pylon.

Sector 3: Forest
Trees, a house, and a church. A red pylon stretches up from the ground to the hub of the station. You can walk spinward or antispinward.

>u
It isn't easy, but with the boots, you make a long climb towards the hub.

Platform 3
A mesh platform about two thirds of the way towards the hub. You can continue spinward or antispinward.

There is a red circuit breaker here.

>d
You climb down the pylon.

Sector 3: Forest
Trees, a house, and a church. A red pylon stretches up from the ground to the hub of the station. You can walk spinward or antispinward.

* * *

>u
The red pylon is designated for climbing, but you can't get a grip.

>wear boots
You can't see any such thing.

>purloin boots
[Purloined.]

* * *

>wear boots
You put on the pair of gravity boots.

>u
ONE.

* * *

>out
You get off the blanket.

Home
The room where you've slept your entire life. The crops are outside.

There is a secured hatch in the floor.

The homespun blanket which you use as your bed is arranged on the ground.

>drop home
The home is already here.

>search home
You would need to enter the home to do that.

* * *

>drop home
The home is already here.

>x home
You were told it was built to look like a log cabin on Old Earth.

>search home
You would need to enter the home to do that.

* * *

>out
You get off the blanket.

Home
The room where you've slept your entire life. The crops are outside.

There is a secured hatch in the floor.

The homespun blanket which you use as your bed is arranged on the ground.

>drop pylons
The pylons are already here.

>drop mirrors
You are too far away to do that.

>actions
Actions listing on.

>drop mirrors
[dropping the mirrors]
You are too far away to do that.
[dropping the mirrors - failed]

>drop pylons
[dropping the pylons]
The pylons are already here.
[dropping the pylons - failed the can't drop what's already dropped rule]

* * *

>out
You get off the blanket.

Home
The room where you've slept your entire life. The crops are outside.

There is a secured hatch in the floor.

The homespun blanket which you use as your bed is arranged on the ground.

>home
Home
The room where you've slept your entire life. You can go out to your crops.

There is a secured hatch in the floor.

>out
Sector 4: Crops
Your home is here among the crops. You can walk spinward or antispinward.

* * *

>asw
You walk a little ways to the next sector.

Sector 3: Forest
Trees, a house, and a church. A red pylon stretches up from the ground to the hub of the station. You can walk spinward or antispinward.

>hosue
That's not a verb I recognize.

>house
House
Two families lived here, but not recently.

Someone has left a doll on the well swept floor.

* * *

>out
Sector 3: Forest
Trees, a house, and a church. A red pylon stretches up from the ground to the hub of the station. You can walk spinward or antispinward.

>scanner, jkjk
Syntax error: command not in vocabulary.

[You can ask the scanner for a list of commands by typing "scanner, help" and give it voice commands by typing phrases such as "scanner, scan SOMETHING" or "scanner, open SOMETHING" where SOMETHING is a visible object.]

>church
Church
Before everyone left or died, you celebrated every sabbath here. The altar stands against one wall, and an organ and a portable audio unit stand against the other.

On the altar is The Founder's Testament.

A gray cable connects the organ to the audio unit.

* * *

>out
Sector 3: Forest
Trees, a house, and a church. A red pylon stretches up from the ground to the hub of the station. You can walk spinward or antispinward.

>asw
You walk a little ways to the next sector.

Sector 2: Aquaculture
A deep pond is used as part of the water filtration system and for raising fish. You can walk spinward or antispinward.

* * *

>asw
You walk a little ways to the next sector.

Sector 1: Crops
You still maintain the crops here. There is a small graveyard and the barn remains from when this was the livestock sector. A pylon stretches up from the ground to the hub of the station. You can walk spinward or antispinward.

There is a secured hatch in the ground.

>barn
Barn
Not fancy: livestock on one side and feed on the other, but nothing remains of either. There is a plow near the entrance.

>oout
That's not a verb I recognize.

>out
Sector 1: Crops
You still maintain the crops here. There is a small graveyard and the barn remains from when this was the livestock sector. A pylon stretches up from the ground to the hub of the station. You can walk spinward or antispinward.

There is a secured hatch in the ground.

>asw
You walk a little ways to the next sector.

Sector 6: Hydroponics
Your people preferred to grow things the old fashioned way, but in truth the majority of your fruit and vegetables came from this sector when the machines still worked. You can walk spinward or antispinward.

There is a secured hatch in the ground.

>asw
You walk a little ways to the next sector.

Sector 5: Forest
The school house is nestled among the trees. A pylon stretches up from the same grove to the hub of the station. You can walk spinward or antispinward.

You have walked the entire ring. Everything is as expected, much is not working. Now, it's time to leave: the pods are below Sector 1.

>school
School House
A broken learning machine remains in a corner, but mostly the older farmers took turns leading the class. There is a desk, and a chalkboard hangs on one wall.

On the desk is a clean eraser.

* * *

>out
Sector 5: Forest
The school house is nestled among the trees. A pylon stretches up from the same grove to the hub of the station. You can walk spinward or antispinward.

>house
I didn't understand that sentence.

>school house
School House
A broken learning machine remains in a corner, but mostly the older farmers took turns leading the class. There is a desk, and a chalkboard hangs on one wall.

On the desk is a clean eraser.

>scanner, jsdkjfkld
Syntax error: command not in vocabulary.

* * *

>out
Sector 4: Crops
Your home is here among the crops. You can walk spinward or antispinward.

>the home
Home
The room where you've slept your entire life. You can go out towards the crops.

There is a secured hatch in the floor.

>out
Sector 4: Crops
Your home is here among the crops. You can walk spinward or antispinward.

>a home
Home
The room where you've slept your entire life. You can go out towards the crops.

There is a secured hatch in the floor.

>gonear red breaker
Center Platform
It's a mesh platform a little below the hub. You feel much lighter here, and you are very aware of how the station rotates, but everything is okay as long as you don't look down.

You can just reach a red circuit breaker on the hub.

>look down
You see nothing unexpected in that direction.

>x pylon
You can't see any such thing.

>d
You slide down the pylon.

Sector 3: Forest
Trees, a house, and a church. A red pylon stretches up from the ground to the hub of the station. You can walk spinward or antispinward.

>x pylon
Made of smooth metal, anodized red, it connects the ground to the hub of the station many meters above.

>x hub
The station rotates around the hub, which extends out to hold solar panels on the port and mirrors on the starboard side. On the inside, there is a mesh maintenance platform.

* * *

>out
You get off the blanket.

Home
The room where you've slept your entire life. The crops are outside.

There is a secured hatch in the floor.

The homespun blanket which you use as your bed is arranged on the ground.

>in
You can't go inside, but you can go down to the cellar or outside to sector 4.

>d
(down)

* * *

>in
You can't go inside, but you can go down to the cellar or outside to sector 4.

>x pylons
You can't see any such thing.

>out
Sector 4: Crops
Your home is here among the crops. You can walk spinward or antispinward.

>x pylons
Spinward and antispinward from here, you can see pylons connecting the ground to the hub.

>sw
You walk a little ways to the next sector.

Sector 5: Forest
The school house is nestled among the trees. A pylon stretches up from the same grove to the hub of the station. You can walk spinward or antispinward.

>x pylons
(the pylon)
Made of smooth metal, it connects the ground to the hub of the station many meters above. You can see similar pylons spinward and antispinward.

* * *

>out
You get off the blanket.

Home
The room where you've slept your entire life. The crops are outside.

There is a secured hatch in the floor.

The homespun blanket which you use as your bed is arranged on the ground.

>look in home
Your home is inside through the home.

>search home
Your home is inside through the home.

* * *

>out
You get off the blanket.

Home
The room where you've slept your entire life. The crops are outside.

There is a secured hatch in the floor.

The homespun blanket which you use as your bed is arranged on the ground.

>look up
The station rotates around the hub, which extends out to hold solar panels to the port and mirrors on the starboard side. On the inside, there is a maintenance platform about two thirds of the way up the pylons.

>look down
You see nothing unexpected in that direction.

>gonear red
(the red circuit breaker)
Platform 3
It's a mesh platform about two thirds of the way towards the hub. You feel much lighter here, and you are very aware of how the station rotates, but everything is okay as long as you don't look down. You can continue spinward or antispinward.

There is a red circuit breaker here.

>look down
DOWN.

>look up
The station rotates around the hub, still a good way above you, which extends out to hold solar panels to the port and mirrors on the starboard side.

>x ground
DOWN.

>touch ground
You are too far away to do that.

>go ground
You are too far away to do that.

>actions
Actions listing on.

>go ground
[entering the ground]
You are too far away to do that.
[entering the ground - failed]

* * *

>out
You get off the blanket.

Home
The room where you've slept your entire life. The crops are outside.

There is a secured hatch in the floor.

The homespun blanket which you use as your bed is arranged on the ground.

>out
But you aren't in anything at the moment.

>port
You can't go that way. The obvious exits are inside (to home), spinward and antispinward.

* * *

>out
But you aren't in anything at the moment.

>sw
You walk a little ways to the next sector.

Sector 5: Forest
The school house is nestled among the trees. A pylon stretches up from the same grove to the hub of the station. You can walk spinward or antispinward.

>go school
School House
A broken learning machine remains in a corner, but mostly the older farmers took turns leading the class. There is a desk, and a chalkboard hangs on one wall.

On the desk is a clean eraser.

>out
Sector 5: Forest
The school house is nestled among the trees. A pylon stretches up from the same grove to the hub of the station. You can walk spinward or antispinward.

>asw
You walk a little ways to the next sector.

Sector 4: Crops
Your home is here among the crops. You can walk spinward or antispinward.

* * *

>asw
You walk a little ways to the next sector.

Sector 3: Forest
Trees, a house, and a church. A red pylon stretches up from the ground to the hub of the station. You can walk spinward or antispinward.

>go church
Church
Before everyone left or died, you celebrated every sabbath here. The altar stands against one wall, and an organ and a portable audio unit stand against the other.

On the altar is The Founder's Testament.

A gray cable connects the organ to the audio unit.

* * *

>get unit
That is attached to the wall.

>get portable audio unit
That is attached to the wall.

* * *

>out
You get off the blanket.

Home
The room where you've slept your entire life. The crops are outside.

There is a secured hatch in the floor.

The homespun blanket which you use as your bed is arranged on the ground.

>port
The exits are inside to your home, spinward to sector 5, and antispinward to sector 3.

>starboard
The exits are inside to your home, spinward to sector 5, and antispinward to sector 3.

>outside
The exits are inside to your home, spinward to sector 5, and antispinward to sector 3.

* * *

>out
You get off the blanket.

Home
The room where you've slept your entire life. The crops are outside.

There is a secured hatch in the floor.

The homespun blanket which you use as your bed is arranged on the ground.

>search home
You would need to enter the home to do that.

>x home
You were told it was built to look like a log cabin on Old Earth.

>drop home
The home is already here.

* * *

>out
You get off the blanket.

Home
The room where you've slept your entire life. The crops are outside.

There is a secured hatch in the floor.

The homespun blanket which you use as your bed is arranged on the ground.

>sw
You walk a little ways to the next sector.

Sector 5: Forest
The school house is nestled among the trees. A pylon stretches up from the same grove to the hub of the station. You can walk spinward or antispinward.

* * *

>sw
You walk a little ways to the next sector.

Sector 1: Crops
You still maintain the crops here. There is a small graveyard and the barn remains from when this was the livestock sector. A pylon stretches up from the ground to the hub of the station. You can walk spinward or antispinward.

There is a secured hatch in the ground.

>sw
You walk a little ways to the next sector.

Sector 2: Aquaculture
A deep pond is used as part of the water filtration system and for raising fish. You can walk spinward or antispinward.

* * *

>sw
You walk a little ways to the next sector.

Sector 3: Forest
Trees, a house, and a church. A red pylon stretches up from the ground to the hub of the station. You can walk spinward or antispinward.

You have walked the entire ring. Everything is as expected, much is not working. Now, it's time to leave: the pods are below Sector 1.

>purloin boots
[Purloined.]

* * *

>u
It isn't easy, but with the boots, you make a long climb towards the hub.

It isn't easy, but with the boots, you make a long climb towards the hub.

Platform 3
A mesh platform about two thirds of the way towards the hub. You can continue spinward or antispinward.

You feel much lighter here, and you are very aware of how the station rotates, but everything is okay as long as you don't look down.

There is a red circuit breaker here.

>actions
Actions listing on.

>d
[going down]
You climb down the pylon.

Sector 3: Forest
Trees, a house, and a church. A red pylon stretches up from the ground to the hub of the station. You can walk spinward or antispinward.

[going down - succeeded]

>u
[going up]
It isn't easy, but with the boots, you make a long climb towards the hub.

Platform 3
A mesh platform about two thirds of the way towards the hub. You can continue spinward or antispinward.

There is a red circuit breaker here.

[going up - succeeded]

>d
[going down]
You climb down the pylon.

Sector 3: Forest
Trees, a house, and a church. A red pylon stretches up from the ground to the hub of the station. You can walk spinward or antispinward.

[going down - succeeded]

* * *

>u
[going up]
It isn't easy, but with the boots, you make a long climb towards the hub.

Platform 3
A mesh platform about two thirds of the way towards the hub. You can continue spinward or antispinward.

There is a red circuit breaker here.

[going up - succeeded]

>restart
[restarting the game]
Are you sure you want to restart?

>yes
You awake. You are lonely, so lonely. It was a thousand days ago today. All alone these thousand days. Your parents were the last. No, your father was the last. He held on for nearly a hundred days longer. No, you are the last. Alone. Adrift.

But maybe it isn't hopeless. There must still be other people in other worlds, and you think you know how to get there.

Today is the day.

Founder's Mercy
A Space Story by Thomas Insel
Release 1 / Serial number 181204 / Inform 7 build 6M62 (I6/v6.33 lib 6/12N) SD
Type "about" for credits or "hint" for assistance.

Home
The room where you've slept your entire life. You can go out towards the crops.

There is a secured hatch in the floor.

>out
Sector 4: Crops
Your home is here among the crops. You can walk spinward or antispinward.

* * *

>asw
You walk a little ways to the next sector.

Sector 3: Forest
Trees, a house, and a church. A red pylon stretches up from the ground to the hub of the station. You can walk spinward or antispinward.

>actions
Actions listing on.

>u
[going up]
The red pylon is designated for climbing, but you can't get a grip.
[going up - ended without result]

>purloin boots
[Purloined.]

* * *

>wear boots
[wearing the pair of gravity boots]
You put on the pair of gravity boots.
[wearing the pair of gravity boots - succeeded]

>u
[going up]
It isn't easy, but with the boots, you make a long climb towards the hub.

[(1) climbing the pylon]
[(2) going up]
It isn't easy, but with the boots, you make a long climb towards the hub.

Platform 3
A mesh platform about two thirds of the way towards the hub. You can continue spinward or antispinward.

You feel much lighter here, and you are very aware of how the station rotates, but everything is okay as long as you don't look down.

There is a red circuit breaker here.

[(2) going up - succeeded]

[(1) climbing the pylon - succeeded]

[going up - succeeded]

* * *

>sw
You walk a little ways to the next sector.

Sector 5: Forest
The school house is nestled among the trees. A pylon stretches up from the same grove to the hub of the station. You can walk spinward or antispinward.

>u
The pylon is slick metal with no obvious handholds.

>sw
You walk a little ways to the next sector.

Sector 6: Hydroponics
Your people preferred to grow things the old fashioned way, but in truth the majority of your fruit and vegetables came from this sector when the machines still worked. You can walk spinward or antispinward.

There is a secured hatch in the ground.

* * *

>sw
You walk a little ways to the next sector.

Sector 1: Crops
You still maintain the crops here. There is a small graveyard and the barn remains from when this was the livestock sector. A pylon stretches up from the ground to the hub of the station. You can walk spinward or antispinward.

There is a secured hatch in the ground.

>u
The pylon is slick metal with no obvious handholds.

>sw
You walk a little ways to the next sector.

Sector 2: Aquaculture
A deep pond is used as part of the water filtration system and for raising fish. You can walk spinward or antispinward.

* * *

>sw
You walk a little ways to the next sector.

Sector 5: Forest
The school house is nestled among the trees. A pylon stretches up from the same grove to the hub of the station. You can walk spinward or antispinward.

>x forest
The community grew trees for tradition, and they help with air processing.

>sw
You walk a little ways to the next sector.

Sector 6: Hydroponics
Your people preferred to grow things the old fashioned way, but in truth the majority of your fruit and vegetables came from this sector when the machines still worked. You can walk spinward or antispinward.

There is a secured hatch in the ground.

* * *

>out
You get off the blanket.

Home
The room where you've slept your entire life. The crops are outside.

There is a secured hatch in the floor.

The homespun blanket which you use as your bed is arranged on the ground.

>touch mirror
You are too far away to do that.

>touch pylons
You feel nothing unexpected.

* * *

>out
You get off the blanket.

Home
The room where you've slept your entire life. The crops are outside.

There is a secured hatch in the floor.

The homespun blanket which you use as your bed is arranged on the ground.

>touch pylons
You feel nothing unexpected.

* * *

>out
You get off the blanket.

Home
The room where you've slept your entire life. The crops are outside.

There is a secured hatch in the floor.

The homespun blanket which you use as your bed is arranged on the ground.

>trace
[Trace on.]

>out
[Parsing for the verb 'out' (1 lines)]
[line 0 * -> Exit]
[Line successfully parsed]
But you aren't in anything at the moment.

[** Programming error: tried to read (something) **]

>z
[Parsing for the verb 'z' (1 lines)]
[line 0 * -> Wait]
[Line successfully parsed]
Time passes.

[** Programming error: tried to read (something) **]

>showme pump
[Parsing for the verb 'showme' (2 lines)]
[line 0 * -> ShowMe]
[line 1 * scope=Routine(355557) -> ShowMe]
[Line successfully parsed]
atmosphere pump - machine
    power module - power module
    pressure regulation module - pressure regulation module
location: in Pod Control
singular-named, improper-named; unlit, inedible, fixed in place, scenery; opaque, open, unopenable, unlocked
list grouping key: none
printed name: "atmosphere pump"
printed plural name: "machines"
indefinite article: none
description: "The atmosphere pump is a smooth featureless machine."
initial appearance: none
carrying capacity: 2

>look
[Parsing for the verb 'look' (5 lines)]
[line 0 * -> Look]
[Line successfully parsed]
Sector 4: Crops
Your home is here among the crops. You can walk spinward or antispinward.

[** Programming error: tried to read (something) **]

* * *

>out
You get off the blanket.

Home
The room where you've slept your entire life. The crops are outside.

There is a secured hatch in the floor.

The homespun blanket which you use as your bed is arranged on the ground.

>w
You have heard of compass directions like west, but they don't make any sense here. Instead, you can go spinward, antispinward, port, and starboard. When you look spinward, port is left and starboard is right.

[You can use the abbreviations "sw", "asw", "p", and "s". You can also go "up", "down", "in", and "out" where appropriate. Type "exits" if you get confused about geography.]

>asw
You walk a little ways to the next sector.

Sector 3: Forest
Trees, a house, and a church. A red pylon stretches up from the ground to the hub of the station. You can walk spinward or antispinward.

* * *

>asw
You walk a little ways to the next sector.

Sector 2: Aquaculture
A deep pond is used as part of the water filtration system and for raising fish. You can walk spinward or antispinward.

>swim in pond
You can't hold your breath long enough to make that worthwhile.

>swim
You can't hold your breath long enough to make that worthwhile.

* * *

>w
You have heard of compass directions like west, but they don't make any sense here. Instead, you can go spinward, antispinward, port, and starboard. When you look spinward, port is left and starboard is right.

[You can use the abbreviations "sw", "asw", "p", and "s". You can also go "up", "down", "in", and "out" where appropriate. Type "exits" if you get confused about geography.]

>sw
You walk a little ways to the next sector.

Sector 5: Forest
The school house is nestled among the trees. A pylon stretches up from the same grove to the hub of the station. You can walk spinward or antispinward.

>asw
You walk a little ways to the next sector.

Sector 4: Crops
Your home is here among the crops. You can walk spinward or antispinward.

* * *

>asw
You walk a little ways to the next sector.

Sector 3: Forest
Trees, a house, and a church. A red pylon stretches up from the ground to the hub of the station. You can walk spinward or antispinward.

>home
That's not a verb I recognize.

>house
House
Two families lived here, but not recently.

Someone has left a doll on the well swept floor.

>x doll
Wearing a brown jumpsuit and faceless, because we are all alike in the Founder's eyes. This doll was yours once, but you passed it on with other childish things when you were old enough to help in the fields.

* * *

>out
You get off the blanket.

Home
The room where you've slept your entire life. The crops are outside.

There is a secured hatch in the floor.

The homespun blanket which you use as your bed is arranged on the ground.

>x bdp
Spinward and antispinward from here, you can see pylons connecting the ground to the hub.

>dorp bdp
That's not a verb I recognize.

>drop bdp
You will need to go to the next sector to do that.

* * *

>out
You get off the blanket.

Home
The room where you've slept your entire life. The crops are outside.

There is a secured hatch in the floor.

The homespun blanket which you use as your bed is arranged on the ground.

>x home
You were told it was built to look like a log cabin on Old Earth.

* * *

>out
You get off the blanket.

Home
The room where you've slept your entire life. The crops are outside.

There is a secured hatch in the floor.

The homespun blanket which you use as your bed is arranged on the ground.

>x mirror
The mirrors reflect sunlight into the station.

>x pylons
Spinward and antispinward from here, you can see pylons connecting the ground to the hub.

>touch pylons
You feel nothing unexpected.

>climb pylons
Little is to be achieved by that.

* * *

>out
You get off the blanket.

Home
The room where you've slept your entire life. The crops are outside.

There is a secured hatch in the floor.

The homespun blanket which you use as your bed is arranged on the ground.

>x pylons
Spinward and antispinward from here, you can see pylons connecting the ground to the hub.

>touch pylons
You will need to go to the next sector to do that.

>climb pylons
Little is to be achieved by that.

>touch mirrors
You are too far away to do that.

>touch mirror
You are too far away to do that.

>showme pylons
(the pylons)
pylons - backdrop
location: in Sector 4: Crops
singular-named, improper-named; unlit, inedible, fixed in place, scenery
list grouping key: none
printed name: "pylons"
printed plural name: "backdrops"
indefinite article: none
description: "Spinward and antispinward from here, you can see pylons connecting the ground to the hub."
initial appearance: none

>drop pylons
The pylons is already here.

>drop pylon
You can't see any such thing.

* * *

>touch pylons
You will need to go to the next sector to do that.

>sw
You walk a little ways to the next sector.

Sector 5: Forest
The school house is nestled among the trees. A pylon stretches up from the same grove to the hub of the station. You can walk spinward or antispinward.

>touch pylons
You feel nothing unexpected.

* * *

>out
You get off the blanket.

Home
The room where you've slept your entire life. The crops are outside.

There is a secured hatch in the floor.

The homespun blanket which you use as your bed is arranged on the ground.

>z
Time passes.

[** Programming error: tried to read (something) **]

* * *

>port
You can't go that way. Hello.

>exits
Hello.

[Type "exits off" to disable the status line exit list and "exits on" to turn it back on.]

* * *

>pull pile
You can't see any such thing.

>gonear pile
Pod Bay
There are four berths for transit pods. Unfortunately, all are empty.

A secured hatch leads starboard.

There is a pile of clutter. It looks like equipment removed to free up space in the transit pods.

This is troubling. You counted. You were sure there would be one pod left. There are none.

[Your score has just gone up by two points.]

>pull pile
That isn't practical.

>get pile
You should try taking something specific instead.

* * *

>purloin comms
[Purloined.]

>i
You are carrying:
  an emergency communications unit
  a scanner
  a green jumpsuit (being worn)

>put comms in pocket
You put the emergency communications unit into the pocket.

>i
You are carrying:
  a scanner
  a green jumpsuit (being worn)

Your jumpsuit pocket contains:
  an emergency communications unit

>x pocket
In the pocket is an emergency communications unit.

>look in pocket
In the pocket is an emergency communications unit.

>x jumpsuit
You have worn modest jumpsuits like this since you were small. Originally, the colors had meanings: forest green for farmers, navy blue for technicians, and so on, but that distinction died even before the population.

The pocket contains an emergency communications unit.

>look
Home
The room where you've slept your entire life. The crops are outside.

There is a secured hatch in the floor.

* * *

>put
What do you want to put on?

>out
Sector 4: Crops
Your home is here among the crops. You can walk spinward or antispinward.

* * *

>asw
You walk a little ways to the next sector.

Sector 3: Forest
Trees, a house, and a church. A red pylon stretches up from the ground to the hub of the station. You can walk spinward or antispinward.

>exits
The exits are starboard to house, port to church, spinward to sector 4, and antispinward to sector 2.

>house
House
Two families lived here, but not recently.

Someone has left a doll on the well swept floor.

* * *

>out
Sector 3: Forest
Trees, a house, and a church. A red pylon stretches up from the ground to the hub of the station. You can walk spinward or antispinward.

>x
What do you want to examine?

>exits
The exits are starboard to house, port to church, spinward to sector 4, and antispinward to sector 2.

* * *

>put blanket in pocket
It's a large pocket, but not large enough to hold a blanket.

>i
You are carrying:
  a scanner
  a green jumpsuit (being worn)

>get up
You get off the blanket.

Home
The room where you've slept your entire life. The crops are outside.

There is a secured hatch in the floor.

You can also see a blanket here.

* * *

>put scanner on blanket
You put the scanner on the blanket.

>take blanket
You need to take everything off of the blanket first.

>get scanner
Taken.

>get blanket
Taken.

>put scanner in blanket
That can't contain things.

>put scanner on blanket
You put the scanner on the blanket.

>undo
Home
[Previous turn undone.]

* * *

>remove jumpsuit
Your nudity is pure and innocent, but still a little cold and uncomfortable.

>look
Home
The room where you've slept your entire life. You can go out towards the crops.

There is a secured hatch in the floor.

>d
(first opening the floor hatch)

Cellar
Your decompression shelter and space for some increasingly empty shelves of canned vegetables.

There is an open hatch in the ceiling.

>look
Cellar
Your decompression shelter and space for some increasingly empty shelves of canned vegetables.

There is an open hatch in the ceiling.

>i
You are carrying:
  a scanner
  a green jumpsuit

>wear suit
You put on the green jumpsuit.

>i
You are carrying:
  a scanner
  a green jumpsuit (being worn)

>x jumpsuit
You have worn modest jumpsuits like this since you were small. Originally, the colors had meanings: green for farmers, blue for technicians, and so on, but that distinction died even before the population.

It features a single large pocket, currently empty.

>out
But you aren't in anything at the moment.

>gonear tree
Sector 3: Forest
Trees, a house, and a church. A red pylon stretches up from the ground to the hub of the station. You can walk spinward or antispinward.

>x forest
The community grew trees for tradition, and they help with air processing.

>x trees
The community grew trees for tradition, and they help with air processing.

* * *

>rooms
That's not a verb I recognize.

>exits
The obvious exits are down (to the cellar) and outside (to sector 4).

[Type "exits off" to disable the status line exit list and "exits on" to turn it back on.]

>exits
The obvious exits are down (to the cellar) and outside (to sector 4).

>rooms
Center Platform - the center platform
Sector 1: Crops - sector 1
Barn - 
Pod Control - 
Pod Bay - 
Sector 2: Aquaculture - sector 2
Sector 3: Forest - sector 3
Church - the church
House - the house
Sector 4: Crops - sector 4
Home - your home
Cellar - the cellar
Sector 5: Forest - sector 5
School - 
Sector 6: Hydroponics - sector 6
Supply Vault -

* * *

>exits
The obvious exits are down (to the cellar) and outside (to sector 4).

[Type "exits off" to disable the status line exit list and "exits on" to turn it back on.]

>out
Sector 4: Crops
Your home is here among the crops. You can walk spinward or antispinward.

* * *

>exits
The obvious exits are inside (to your home), spinward (to sector 5), and antispinward (to sector 3).

>asw
You walk a little ways to the next sector.

Sector 3: Forest
Trees, a house, and a church. A red pylon stretches up from the ground to the hub of the station. You can walk spinward or antispinward.

>exits
The obvious exits are starboard (to the house), port (to the church), spinward (to sector 4), and antispinward (to sector 2).

>asw. exits
You walk a little ways to the next sector.

Sector 2: Aquaculture
A deep pond is used as part of the water filtration system and for raising fish. You can walk spinward or antispinward.

The obvious exits are spinward (to sector 3) and antispinward (to sector 1).

>asw. exits
You walk a little ways to the next sector.

Sector 1: Crops
You still maintain the crops here. There is a small graveyard and the barn remains from when this was the livestock sector. A pylon stretches up from the ground to the hub of the station. You can walk spinward or antispinward.

There is a secured hatch in the ground.

The obvious exits are down (to pod control), inside (to the barn), spinward (to sector 2), and antispinward (to sector 6).

>rooms
Center Platform - the center platform
Sector 1: Crops - sector 1
Barn - the barn
Pod Control - 
Pod Bay - 
Sector 2: Aquaculture - sector 2
Sector 3: Forest - sector 3
Church - the church
House - the house
Sector 4: Crops - sector 4
Home - your home
Cellar - the cellar
Sector 5: Forest - sector 5
School House - the school house
Sector 6: Hydroponics - sector 6
Supply Vault -

* * *

>rooms
That's not a verb I recognize.

>out
Sector 4: Crops
Your home is here among the crops. You can walk spinward or antispinward.

* * *

>asw
You walk a little ways to the next sector.

Sector 2: Aquaculture
A deep pond is used as part of the water filtration system and for raising fish. You can walk spinward or antispinward.

>sw
You walk a little ways to the next sector.

Sector 3: Forest
Trees, a house, and a church. A red pylon stretches up from the ground to the hub of the station. You can walk spinward or antispinward.

>exits
The obvious exits are starboard to the house, port to the church, spinward to sector 4, and antispinward to sector 2.

[Type "exits off" to disable the status line exit list and "exits on" to turn it back on.]

>rooms
That's not a verb I recognize.

>exits
The obvious exits are starboard to the house, port to the church, spinward to sector 4, and antispinward to sector 2.

>out
But you aren't in anything at the moment.

>s
House
Two families lived here, but not recently.

Someone has left a doll on the well swept floor.

>p
Sector 3: Forest
Trees, a house, and a church. A red pylon stretches up from the ground to the hub of the station. You can walk spinward or antispinward.

>st
That's not a verb I recognize.

>d
You can't go that way. The obvious exits are starboard to the house, port to the church, spinward to sector 4, and antispinward to sector 2.

* * *

>rooms
That's not a verb I recognize.

>rtree
Barn
    plow
Cellar
    shelves + canned vegetables and emergency mask 
Center Platform
    red circuit breaker
Church
    altar + Founder's Testament 
    organ & tan socket
    audio unit + power module & beige socket
    gray cable & usb plug and usb plug
Home
    yourself + green jumpsuit, pocket, and scanner 
House
    doll
Pod Bay
    berths
    emergency communications unit & almond socket
Pod Control
    space suit
    brass plate
    status display
    atmosphere pump + power module and pressure regulation module 
School House
    learning machine + instruction module and power module 
    desk + clean eraser 
    chalkboard
Sector 1: Crops
    pylon
    crops
    graveyard
Sector 2: Aquaculture
    pond
    fish
Sector 3: Forest
    pylon
    trees
Sector 4: Crops
    vegetables
Sector 5: Forest
    pylon
    trees
Sector 6: Hydroponics
    hydroponics machines
Supply Vault
    crate of machine parts
    pair of gravity boots
(Nowhere)
    green circuit breaker
    instruction module
    junk repository
    laser beam
    pressure regulation module

>x hatch
The floor hatch is closed.

>open hatch
You open the floor hatch.

>x hatch
The floor hatch is open.

>look through hatch
You can see the cellar through the floor hatch.

>x cellar
You can't see any such thing.

* * *

>rooms
That's not a verb I recognize.

>x vault
You can't see any such thing.

* * *

>rtree
Barn
    plow
Cellar
    shelves + canned vegetables and emergency mask 
Center Platform
    red circuit breaker
Church
    altar + Founder's Testament 
    organ & tan socket
    audio unit + power module & beige socket
    gray cable & usb plug and usb plug
Home
    yourself + green jumpsuit, pocket, and scanner 
House
    doll
Pod Bay
    berths
    emergency communications unit & almond socket
Pod Control
    space suit
    brass plate
    status display
    atmosphere pump + power module and pressure regulation module 
School
    learning machine + instruction module and power module 
    desk + clean eraser 
    chalkboard
Sector 1: Crops
    pylon
    crops
    graveyard
Sector 2: Aquaculture
    pond
    fish
Sector 3: Forest
    pylon
    trees
Sector 4: Crops
    vegetables
Sector 5: Forest
    pylon
    trees
Sector 6: Hydroponics
    hydroponics machines
Supply Vault
    crate of machine parts
    pair of gravity boots
(Nowhere)
    green circuit breaker
    instruction module
    junk repository
    laser beam
    light-meter
    pressure regulation module

>gonear learning
School
A broken learning machine remains in a corner, but mostly the older farmers took turns leading the class. There is a desk, and a chalkboard hangs on one wall.

On the desk is a clean eraser.

>look
School
A broken learning machine remains in a corner, but mostly the older farmers took turns leading the class. There is a desk, and a chalkboard hangs on one wall.

On the desk is a clean eraser.

>scanner, open learning
Opening.

The learning machine swings open, revealing a power module and an instruction module.

[Your score has just gone up by one point.]

* * *

>s
You can't go the starboard, but you can go down to the cellar or outside to sector 4.

>d
(first opening the floor hatch)

Cellar
Your decompression shelter and space for some increasingly empty shelves of canned vegetables.

There is an open hatch in the ceiling.

>s
The only exit is up to your home.

>up
Home
The room where you've slept your entire life. You can go out towards the crops.

There is an open hatch in the floor.

>out
Sector 4: Crops
Your home is here among the crops. You can walk spinward or antispinward.

>s
You can't go the starboard, but you can go inside to your home, spinward to sector 5, or antispinward to sector 3.

>p
You can't go the port, but you can go inside to your home, spinward to sector 5, or antispinward to sector 3.

>u
You can't go the up, but you can go inside to your home, spinward to sector 5, or antispinward to sector 3.

* * *

>say boo
[[To communicate in this story, type "CHARACTER, MESSAGE" where CHARACTER is someone or something and MESSAGE is what you want to say.]]

* * *

>say hello
[To communicate in this story, type "CHARACTER, MESSAGE" where CHARACTER is someone or something and MESSAGE is what you want to say.]

>north
You have heard of compass directions like north, but they don't make any sense here. Instead, you can go spinward, antispinward, port, and starboard. When you look spinward, port is left and starboard is right.

[You can use the abbreviations "sw", "asw", "p", and "s". You can also go "up", "down", "in", and "out" where appropriate. Type "exits" if you get confused about geography.]

>scanner, help
Recognized commands are "help", "open", and "scan".
[You can ask the scanner for a list of commands by typing "scanner, help" and give it voice commands by typing phrases such as "scanner, scan SOMETHING" or "scanner, open SOMETHING" where SOMETHING is a visible object.]

>g
Recognized commands are "help", "open", and "scan".
[You can ask the scanner for a list of commands by typing "scanner, help" and give it voice commands by typing phrases such as "scanner, scan SOMETHING" or "scanner, open SOMETHING" where SOMETHING is a visible object.]

>g
Recognized commands are "help", "open", and "scan".
[You can ask the scanner for a list of commands by typing "scanner, help" and give it voice commands by typing phrases such as "scanner, scan SOMETHING" or "scanner, open SOMETHING" where SOMETHING is a visible object.]

>scanner, jksjdkfjd
Syntax error: command not in vocabulary.

>scanner, jksjdkfjd
Syntax error: command not in vocabulary.
[You can ask the scanner for a list of commands by typing "scanner, help" and give it voice commands by typing phrases such as "scanner, scan SOMETHING" or "scanner, open SOMETHING" where SOMETHING is a visible object.]

>scanner, jksjdkfjd
Syntax error: command not in vocabulary.

>scanner, go north
Syntax error: command not in vocabulary.

>scanner, go north
Syntax error: command not in vocabulary.

[You can ask the scanner for a list of commands by typing "scanner, help" and give it voice commands by typing phrases such as "scanner, scan SOMETHING" or "scanner, open SOMETHING" where SOMETHING is a visible object.]

>scanner, go north
Syntax error: command not in vocabulary.

>scanner, go north
Syntax error: command not in vocabulary.

>scanner, jkjkjkdsfjk
Syntax error: command not in vocabulary.

>scanner, jkjkjkdsfjk
Syntax error: command not in vocabulary.

>scanner,jdskfjkd
Syntax error: command not in vocabulary.

>scanner,jdskfjkd
Syntax error: command not in vocabulary.

>scanner, up
Syntax error: command not in vocabulary.

>scanner, up
Syntax error: command not in vocabulary.

>scanner, open me
No electronic technology detected.

>scanner, open me
No electronic technology detected.

>look
Home
The room where you've slept your entire life. You can go out towards the crops.

There is a secured hatch in the floor.

>scanner, help
Recognized commands are "help", "open", and "scan".
[You can ask the scanner for a list of commands by typing "scanner, help" and give it voice commands by typing phrases such as "scanner, scan SOMETHING" or "scanner, open SOMETHING" where SOMETHING is a visible object.]

* * *

>g
Recognized commands are "help", "open", and "scan".
[You can ask the scanner for a list of commands by typing "scanner, help" and give it voice commands by typing phrases such as "scanner, scan SOMETHING" or "scanner, open SOMETHING" where SOMETHING is a visible object.]

>turn scanner on
The scanner is automatically on and listening whenever you are carrying it.

>g
The scanner is automatically on and listening whenever you are carrying it.

>g
The scanner is automatically on and listening whenever you are carrying it.

>g
The scanner is automatically on and listening whenever you are carrying it.

[You can ask the scanner for a list of commands by typing "scanner, help" and give it voice commands by typing phrases such as "scanner, scan SOMETHING" or "scanner, open SOMETHING" where SOMETHING is a visible object.]

>g
The scanner is automatically on and listening whenever you are carrying it.

I beg your pardon?

* * *

>say jkdsjfk
(to the scanner)
Syntax error: command not in vocabulary.
[You can ask the scanner for a list of commands by typing "scanner, help" and give it voice commands by typing phrases such as "scanner, scan SOMETHING" or "scanner, open SOMETHING" where SOMETHING is a visible object.]

>actions
Actions listing on.

>say jjjj
(to the scanner)
[answering the scanner that "jjjj"]
Syntax error: command not in vocabulary.
[answering the scanner that "jjjj" - failed]

* * *

>say jkjdskfj
[To communicate in this story, type "CHARACTER, MESSAGE" where CHARACTER is someone or something and MESSAGE is what you want to say.]

>north
You have heard of compass directions like north, but they don't make any sense here. Instead, you can go spinward, antispinward, port, and starboard. When you look spinward, port is left and starboard is right.

[You can use the abbreviations "sw", "asw", "p", and "s". You can also go "up", "down", "in", and "out" where appropriate. Type "exits" if you get confused about geography.]

* * *

>say xyzzy
You say that word out loud. Your mother would never have approved. Even with no one to listen, it feels a little wrong.

>ask machine about me
That's not a verb I recognize.

>ask jkjkdsf
That's not a verb I recognize.

>ask machine about me
That's not a verb I recognize.

* * *

>scan
Syntax error: no target.

[You can ask the scanner for a list of commands by typing "scanner, help" and give it voice commands by typing phrases such as "scanner, scan SOMETHING" or "scanner, open SOMETHING" where SOMETHING is a visible object.]

>d
(first opening the floor hatch)

Cellar
Your decompression shelter and space for some increasingly empty shelves of canned vegetables.

There is an open hatch in the ceiling.

>scan
Syntax error: no target.

>get mask
Taken.

* * *

>u
Home
The room where you've slept your entire life. You can go out towards the crops.

There is an open hatch in the floor.

>scan
That makes no sense without a scanner.

>d
Cellar
Your decompression shelter and space for some increasingly empty shelves of canned vegetables.

There is an open hatch in the ceiling.

You can also see a scanner here.

* * *

>scan
Syntax error: no target.

[You can ask the scanner for a list of commands by typing "scanner, help" and give it voice commands by typing phrases such as "scanner, scan SOMETHING" or "scanner, open SOMETHING" where SOMETHING is a visible object.]

>drop scanner
Dropped.

>scan
You must be carrying the scanner to use it.

>d
(first opening the floor hatch)

Cellar
Your decompression shelter and space for some increasingly empty shelves of canned vegetables.

There is an open hatch in the ceiling.

>scan
That makes no sense without a scanner.

>fg
That's not a verb I recognize.

* * *

>scanner, f
a.

0.
Syntax error: command not in vocabulary.
2.

[You can ask the scanner for a list of commands by typing "scanner, help" and give it voice commands by typing phrases such as "scanner, scan SOMETHING" or "scanner, open SOMETHING" where SOMETHING is a visible object.]
3.
4.

*** Run-time problem P39: Attempt to say a snippet value which is currently invalid: words 0 to 3.

>sdf
That's not a verb I recognize.

* * *

>scanner, fark
Syntax error: command not in vocabulary.

[You can ask the scanner for a list of commands by typing "scanner, help" and give it voice commands by typing phrases such as "scanner, scan SOMETHING" or "scanner, open SOMETHING" where SOMETHING is a visible object.]

>scanner, go north
Syntax error: command not in vocabulary.

* * *

>scanner, go north
Syntax error: command not in vocabulary.

[You can ask the scanner for a list of commands by typing "scanner, help" and give it voice commands by typing phrases such as "scanner, scan SOMETHING" or "scanner, open SOMETHING" where SOMETHING is a visible object.]

>scanner, go northsdf
Syntax error: command not in vocabulary.

>scanner, go northsdf
Syntax error: command not in vocabulary.

>scanner, go northsdf
Syntax error: command not in vocabulary.

[You can ask the scanner for a list of commands by typing "scanner, help" and give it voice commands by typing phrases such as "scanner, scan SOMETHING" or "scanner, open SOMETHING" where SOMETHING is a visible object.]

>scanner, go northsdf
Syntax error: command not in vocabulary.

* * *

>scanner, go w
Syntax error: command not in vocabulary2.

[You can ask the scanner for a list of commands by typing "scanner, help" and give it voice commands by typing phrases such as "scanner, scan SOMETHING" or "scanner, open SOMETHING" where SOMETHING is a visible object.]

>scanner, go w
Syntax error: command not in vocabulary2.

>scanner, go w
Syntax error: command not in vocabulary2.

>scanner, go w
Syntax error: command not in vocabulary2.

[You can ask the scanner for a list of commands by typing "scanner, help" and give it voice commands by typing phrases such as "scanner, scan SOMETHING" or "scanner, open SOMETHING" where SOMETHING is a visible object.]

* * *

>scanner, help
Recognized commands are "help", "open", and "scan".

[You can ask the scanner for a list of commands by typing "scanner, help" and give it voice commands by typing phrases such as "scanner, scan SOMETHING" or "scanner, open SOMETHING" where SOMETHING is a visible object.]

>drop scanner
Dropped.

* * *

>d
(first opening the floor hatch)

Cellar
Your decompression shelter and space for some increasingly empty shelves of canned vegetables.

There is an open hatch in the ceiling.

>scan
You must be carrying the scanner to use it.

>x scanner
You can't see any such thing.

>scan
You must be carrying the scanner to use it.

* * *

>scanner, help
You must be carrying the scanner to use it.

>scanner, jjkjsdf
You must be carrying the scanner to use it.

>d
(first opening the floor hatch)

Cellar
Your decompression shelter and space for some increasingly empty shelves of canned vegetables.

There is an open hatch in the ceiling.

>scanner, jelp
You seem to want to talk to someone, but I can't see whom.

>scanner, help
You seem to want to talk to someone, but I can't see whom.

>scan
You must be carrying the scanner to use it.

>u
Home
The room where you've slept your entire life. You can go out towards the crops.

There is an open hatch in the floor.

You can also see a scanner here.

>scan
You must be carrying the scanner to use it.

* * *

>scanner, help
Recognized commands are "help", "open", and "scan".

[You can ask the scanner for a list of commands by typing "scanner, help" and give it voice commands by typing phrases such as "scanner, scan SOMETHING" or "scanner, open SOMETHING" where SOMETHING is a visible object.]

>drop the scanner
Dropped.

>scanner, help
You must be carrying the scanner to use it.

* * *

>scanner, help
Recognized commands are "help", "open", and "scan".

[You can ask the scanner for a list of commands by typing "scanner, help" and give it voice commands by typing phrases such as "scanner, scan SOMETHING" or "scanner, open SOMETHING" where SOMETHING is a visible object.]

>g
Recognized commands are "help", "open", and "scan".
[You can ask the scanner for a list of commands by typing "scanner, help" and give it voice commands by typing phrases such as "scanner, scan SOMETHING" or "scanner, open SOMETHING" where SOMETHING is a visible object.]

* * *

>g
The scanner is automatically on and listening whenever you are carrying it.

>g
The scanner is automatically on and listening whenever you are carrying it.
[You can ask the scanner for a list of commands by typing "scanner, help" and give it voice commands by typing phrases such as "scanner, scan SOMETHING" or "scanner, open SOMETHING" where SOMETHING is a visible object.]

* * *

>scanner, help
Recognized commands are "help", "open", and "scan".

[You can ask the scanner for a list of commands by typing "scanner, help" and give it voice commands by typing phrases such as "scanner, scan SOMETHING" or "scanner, open SOMETHING" where SOMETHING is a visible object.]

>scan me
No modular technology detected.

>drop scanner
Dropped.

>scanner, help
You must be carrying the scanner to use it.
You must be carrying the scanner to use it.

Recognized commands are "help", "open", and "scan".

[You can ask the scanner for a list of commands by typing "scanner, help" and give it voice commands by typing phrases such as "scanner, scan SOMETHING" or "scanner, open SOMETHING" where SOMETHING is a visible object.]

>scanner, help
You must be carrying the scanner to use it.
You must be carrying the scanner to use it.

Recognized commands are "help", "open", and "scan".

[You can ask the scanner for a list of commands by typing "scanner, help" and give it voice commands by typing phrases such as "scanner, scan SOMETHING" or "scanner, open SOMETHING" where SOMETHING is a visible object.]

* * *

>scanner, help
Recognized commands are "help", "open", and "scan".

[You can ask the scanner for a list of commands by typing "scanner, help" and give it voice commands by typing phrases such as "scanner, scan SOMETHING" or "scanner, open SOMETHING" where SOMETHING is a visible object.]

>scanner, go west
Syntax error: command not in vocabulary2.

>scanner, go west
Syntax error: command not in vocabulary2.

>scanner, go west
Syntax error: command not in vocabulary2.

[You can ask the scanner for a list of commands by typing "scanner, help" and give it voice commands by typing phrases such as "scanner, scan SOMETHING" or "scanner, open SOMETHING" where SOMETHING is a visible object.]

>scanner, go west
Syntax error: command not in vocabulary2.

>drop scanner
Dropped.

>scanner, go west
You must be carrying the scanner to use it.

>scanner, go west
You must be carrying the scanner to use it.

>scanner, scan
You must be carrying the scanner to use it.

>g
You must be carrying the scanner to use it.

>g
You must be carrying the scanner to use it.

>get scanner
Taken.

>scanner, scan
Syntax error: no target.

>g
Syntax error: no target.

[You can ask the scanner for a list of commands by typing "scanner, help" and give it voice commands by typing phrases such as "scanner, scan SOMETHING" or "scanner, open SOMETHING" where SOMETHING is a visible object.]

>g
Syntax error: no target.

>g
Syntax error: no target.

>g
Syntax error: no target.

[You can ask the scanner for a list of commands by typing "scanner, help" and give it voice commands by typing phrases such as "scanner, scan SOMETHING" or "scanner, open SOMETHING" where SOMETHING is a visible object.]

>x scanner
The handheld voice-activated scanner you use when working on the station's machines.

>g
The handheld voice-activated scanner you use when working on the station's machines.

>g
The handheld voice-activated scanner you use when working on the station's machines.

>g
The handheld voice-activated scanner you use when working on the station's machines.

[You can ask the scanner for a list of commands by typing "scanner, help" and give it voice commands by typing phrases such as "scanner, scan SOMETHING" or "scanner, open SOMETHING" where SOMETHING is a visible object.]

>g
The handheld voice-activated scanner you use when working on the station's machines.

* * *

>scanner, help
Recognized commands are "help", "open", and "scan".

[You can ask the scanner for a list of commands by typing "scanner, help" and give it voice commands by typing phrases such as "scanner, scan SOMETHING" or "scanner, open SOMETHING" where SOMETHING is a visible object.]

>scanner, help
Recognized commands are "help", "open", and "scan".

[You can ask the scanner for a list of commands by typing "scanner, help" and give it voice commands by typing phrases such as "scanner, scan SOMETHING" or "scanner, open SOMETHING" where SOMETHING is a visible object.]

>scanner, go north
Syntax error: command not in vocabulary.

* * *

>scanner, help
Recognized commands are "help", "open", and "scan".

[You can ask the scanner for a list of commands by typing "scanner, help" and give it voice commands by typing phrases such as "scanner, scan SOMETHING" or "scanner, open SOMETHING" where SOMETHING is a visible object.]

>scanner, helpsdfsdf
Syntax error: command not in vocabulary.

>scanner, helpsdfsdf
Syntax error: command not in vocabulary.

[You can ask the scanner for a list of commands by typing "scanner, help" and give it voice commands by typing phrases such as "scanner, scan SOMETHING" or "scanner, open SOMETHING" where SOMETHING is a visible object.]

>scanner, helpsdfsdf
Syntax error: command not in vocabulary.

>scanner, help
Recognized commands are "help", "open", and "scan".

[You can ask the scanner for a list of commands by typing "scanner, help" and give it voice commands by typing phrases such as "scanner, scan SOMETHING" or "scanner, open SOMETHING" where SOMETHING is a visible object.]

* * *

>scanner, go north
Syntax error: command not in vocabulary.

[You can ask the scanner for a list of commands by typing "scanner, help" and give it voice commands by typing phrases such as "scanner, scan SOMETHING" or "scanner, open SOMETHING" where SOMETHING is a visible object.]

>scanner, jkjk
Syntax error: command not in vocabulary.

>scanner, jkjk
Syntax error: command not in vocabulary.

[You can ask the scanner for a list of commands by typing "scanner, help" and give it voice commands by typing phrases such as "scanner, scan SOMETHING" or "scanner, open SOMETHING" where SOMETHING is a visible object.]

>scanner, jkjk
Syntax error: command not in vocabulary.

* * *

>scanner, jkjk
Syntax error: command not in vocabulary.

[You can ask the scanner for a list of commands by typing "scanner, help" and give it voice commands by typing phrases such as "scanner, scan SOMETHING" or "scanner, open SOMETHING" where SOMETHING is a visible object.]

>scanner, fnor
Syntax error: command not in vocabulary.

>scanner, fnor
Syntax error: command not in vocabulary.

[You can ask the scanner for a list of commands by typing "scanner, help" and give it voice commands by typing phrases such as "scanner, scan SOMETHING" or "scanner, open SOMETHING" where SOMETHING is a visible object.]

>scanner, fnor
Syntax error: command not in vocabulary.

* * *

>scanner, help
Recognized commands are "help", "open", and "scan".

[You can ask the scanner for a list of commands by typing "scanner, help" and give it voice commands by typing phrases such as "scanner, scan SOMETHING" or "scanner, open SOMETHING" where SOMETHING is a visible object.]

>scanner, open me
No electronic technology detected.

>scanner, kjkjk
Syntax error: command not in vocabulary1.

>scanner, kjkjk
Syntax error: command not in vocabulary1.
[You can ask the scanner for a list of commands by typing "scanner, help" and give it voice commands by typing phrases such as "scanner, scan SOMETHING" or "scanner, open SOMETHING" where SOMETHING is a visible object.]

>scanner, kjkjk
Syntax error: command not in vocabulary1.

* * *

>scanner, kjkjk
Syntax error: command not in vocabulary1.
[You can ask the scanner for a list of commands by typing "scanner, help" and give it voice commands by typing phrases such as "scanner, scan SOMETHING" or "scanner, open SOMETHING" where SOMETHING is a visible object.]

>scanner, go up
Syntax error: command not in vocabulary2.

>scanner, go up
Syntax error: command not in vocabulary2.

>scanner, go up
Syntax error: command not in vocabulary2.

[You can ask the scanner for a list of commands by typing "scanner, help" and give it voice commands by typing phrases such as "scanner, scan SOMETHING" or "scanner, open SOMETHING" where SOMETHING is a visible object.]

>scanner, go up
Syntax error: command not in vocabulary2.

>scanner, help
Recognized commands are "help", "open", and "scan".

[You can ask the scanner for a list of commands by typing "scanner, help" and give it voice commands by typing phrases such as "scanner, scan SOMETHING" or "scanner, open SOMETHING" where SOMETHING is a visible object.]

>scanner, scan
Syntax error: no target.

>scanner, scan
Syntax error: no target.

>scanner, scan
Syntax error: no target.
[You can ask the scanner for a list of commands by typing "scanner, help" and give it voice commands by typing phrases such as "scanner, scan SOMETHING" or "scanner, open SOMETHING" where SOMETHING is a visible object.]

* * *

>drop scanner
Dropped.

>scanner, jelp
You must be carrying the scanner to use it.

>scanner, help
You must be carrying the scanner to use it.

* * *

>scanner, help
Recognized commands are "help", "open", and "scan".

[You can ask the scanner for a list of commands by typing "scanner, help" and give it voice commands by typing phrases such as "scanner, scan SOMETHING" or "scanner, open SOMETHING" where SOMETHING is a visible object.]

>turn scanner, on
You can't use multiple objects with that verb.

>turn scanner on
The scanner is automatically on and listening whenever you are carrying it.

* * *

>g
The scanner is automatically on and listening whenever you are carrying it.

>scanner, help
Recognized commands are "help", "open", and "scan".

[You can ask the scanner for a list of commands by typing "scanner, help" and give it voice commands by typing phrases such as "scanner, scan SOMETHING" or "scanner, open SOMETHING" where SOMETHING is a visible object.]

>g
Recognized commands are "help", "open", and "scan".

[You can ask the scanner for a list of commands by typing "scanner, help" and give it voice commands by typing phrases such as "scanner, scan SOMETHING" or "scanner, open SOMETHING" where SOMETHING is a visible object.]

>g
Recognized commands are "help", "open", and "scan".

[You can ask the scanner for a list of commands by typing "scanner, help" and give it voice commands by typing phrases such as "scanner, scan SOMETHING" or "scanner, open SOMETHING" where SOMETHING is a visible object.]

>scanner, scan mjkjk
Search error: cannot find mjkjk.

>scanner, scan mjkjk
Search error: cannot find mjkjk.

>scanner, scan mjkjk
Search error: cannot find mjkjk.

[You can ask the scanner for a list of commands by typing "scanner, help" and give it voice commands by typing phrases such as "scanner, scan SOMETHING" or "scanner, open SOMETHING" where SOMETHING is a visible object.]

>scanner, scan mjkjk
Search error: cannot find mjkjk.

>scanner, jkjsdkfjkd
Syntax error: command not in vocabulary1.

>scanner, jkjsdkfjkd
Syntax error: command not in vocabulary1.

[You can ask the scanner for a list of commands by typing "scanner, help" and give it voice commands by typing phrases such as "scanner, scan SOMETHING" or "scanner, open SOMETHING" where SOMETHING is a visible object.]

>scanner, jkjsdkfjkd
Syntax error: command not in vocabulary1.

* * *

>scanner, jkjsdkfjkd
Syntax error: command not in vocabulary1.

[You can ask the scanner for a list of commands by typing "scanner, help" and give it voice commands by typing phrases such as "scanner, scan SOMETHING" or "scanner, open SOMETHING" where SOMETHING is a visible object.]

>ask scanner about jkjk
Syntax error: command not in vocabulary1.

>ask scanner about jkjk
Syntax error: command not in vocabulary1.

>ask scanner about jkjk
Syntax error: command not in vocabulary1.

[You can ask the scanner for a list of commands by typing "scanner, help" and give it voice commands by typing phrases such as "scanner, scan SOMETHING" or "scanner, open SOMETHING" where SOMETHING is a visible object.]

>ask scanner about jkjk
Syntax error: command not in vocabulary1.

>x scanner
The handheld voice-activated scanner you use when working on the station's machines.

[You can ask the scanner for a list of commands by typing "scanner, help" and give it voice commands by typing phrases such as "scanner, scan SOMETHING" or "scanner, open SOMETHING" where SOMETHING is a visible object.]

>g
The handheld voice-activated scanner you use when working on the station's machines.

I beg your pardon?

* * *

I beg your pardon?

>g
The handheld voice-activated scanner you use when working on the station's machines.

>x scanner
The handheld voice-activated scanner you use when working on the station's machines.

[You can ask the scanner for a list of commands by typing "scanner, help" and give it voice commands by typing phrases such as "scanner, scan SOMETHING" or "scanner, open SOMETHING" where SOMETHING is a visible object.]

>scanner, go north
Syntax error: command not in vocabulary2.

>g
Syntax error: command not in vocabulary2.

>g
Syntax error: command not in vocabulary2.

>g
Syntax error: command not in vocabulary2.

[You can ask the scanner for a list of commands by typing "scanner, help" and give it voice commands by typing phrases such as "scanner, scan SOMETHING" or "scanner, open SOMETHING" where SOMETHING is a visible object.]

>g
Syntax error: command not in vocabulary2.

* * *

>scanner, jdkjk
Syntax error: command not in vocabulary.
2.

[You can ask the scanner for a list of commands by typing "scanner, help" and give it voice commands by typing phrases such as "scanner, scan SOMETHING" or "scanner, open SOMETHING" where SOMETHING is a visible object.]
3.

*** Run-time problem P39: Attempt to say a snippet value which is currently invalid: words 0 to 3.

>scanner, help
Recognized commands are "help", "open", and "scan".

[You can ask the scanner for a list of commands by typing "scanner, help" and give it voice commands by typing phrases such as "scanner, scan SOMETHING" or "scanner, open SOMETHING" where SOMETHING is a visible object.]

>actions
Actions listing on.

>scanner, jksjdkfjdf
[answering the scanner that "
[** Programming error: tried to read from -->-1 in the array "parse", which has entries 0 up to 60 **]
 scanner , jksjdkfjdf"]
Syntax error: command not in vocabulary.
2.
3.
[answering the scanner that "
[** Programming error: tried to read from -->-1 in the array "parse", which has entries 0 up to 60 **]
 scanner , jksjdkfjdf" - ended without result]

*** Run-time problem P39: Attempt to say a snippet value which is currently invalid: words 0 to 3.

* * *

>scanner, jk
Syntax error: command not in vocabulary.

[You can ask the scanner for a list of commands by typing "scanner, help" and give it voice commands by typing phrases such as "scanner, scan SOMETHING" or "scanner, open SOMETHING" where SOMETHING is a visible object.]

*** Run-time problem P39: Attempt to say a snippet value which is currently invalid: words 0 to 3.

* * *

>scanner, jkjk
Syntax error: command not in vocabulary.
[You can ask the scanner for a list of commands by typing "scanner, help" and give it voice commands by typing phrases such as "scanner, scan SOMETHING" or "scanner, open SOMETHING" where SOMETHING is a visible object.]

>scanner, jkjk
Syntax error: command not in vocabulary.

>scanner, jkjk
Syntax error: command not in vocabulary.
[You can ask the scanner for a list of commands by typing "scanner, help" and give it voice commands by typing phrases such as "scanner, scan SOMETHING" or "scanner, open SOMETHING" where SOMETHING is a visible object.]

>scanner, help
Recognized commands are "help", "open", and "scan".

[You can ask the scanner for a list of commands by typing "scanner, help" and give it voice commands by typing phrases such as "scanner, scan SOMETHING" or "scanner, open SOMETHING" where SOMETHING is a visible object.]

* * *

>scanner, jkjkjk
Syntax error: command not in vocabulary.

[You can ask the scanner for a list of commands by typing "scanner, help" and give it voice commands by typing phrases such as "scanner, scan SOMETHING" or "scanner, open SOMETHING" where SOMETHING is a visible object.]

*** Run-time problem P39: Attempt to say a snippet value which is currently invalid: words 0 to 3.

* * *

>scanner, jkjkjkjkj
a.

0.
Syntax error: command not in vocabulary.
2.

[You can ask the scanner for a list of commands by typing "scanner, help" and give it voice commands by typing phrases such as "scanner, scan SOMETHING" or "scanner, open SOMETHING" where SOMETHING is a visible object.]
3.
4.

*** Run-time problem P39: Attempt to say a snippet value which is currently invalid: words 0 to 3.

>ok scanner, jkjkjk
a.

0.
Syntax error: command not in vocabulary.
2.
3.
4.

*** Run-time problem P39: Attempt to say a snippet value which is currently invalid: words 0 to 4.

>trace
[Trace on.]

>scanner, jkjkjk
[Actor is the scanner in Home]
[Parsing for the verb 'no.verb' (1 lines)]
[line 0 * noun=Routine(468827) -> Enter]

a.

0.
Syntax error: command not in vocabulary.
2.
3.
4.

*** Run-time problem P39: Attempt to say a snippet value which is currently invalid: words 0 to 3.

* * *

>scanner, jkjsdfkjdfks
Syntax error: command not in vocabulary.

[You can ask the scanner for a list of commands by typing "scanner, help" and give it voice commands by typing phrases such as "scanner, scan SOMETHING" or "scanner, open SOMETHING" where SOMETHING is a visible object.]

>scanner, help
Recognized commands are "help", "open", and "scan".

[You can ask the scanner for a list of commands by typing "scanner, help" and give it voice commands by typing phrases such as "scanner, scan SOMETHING" or "scanner, open SOMETHING" where SOMETHING is a visible object.]

>ask scanner about me
Syntax error: command not in vocabulary.

* * *

>scanner, look
Syntax error: command not in vocabulary.

[You can ask the scanner for a list of commands by typing "scanner, help" and give it voice commands by typing phrases such as "scanner, scan SOMETHING" or "scanner, open SOMETHING" where SOMETHING is a visible object.]

>scanner, jkjkj
Syntax error: command not in vocabulary.

>gonear church
(Church)
Church
Before everyone left or died, you celebrated every sabbath here. The altar stands against one wall, and an organ and a portable audio unit stand against the other.

On the altar is The Founder's Testament.

A gray cable connects the organ to the audio unit.

* * *

>in
You can enter the church or the house.

>church
I didn't understand that sentence.

>church
I didn't understand that sentence.

>x church
A small white building with a steeple.

>actions
Actions listing on.

>church
I didn't understand that sentence.

* * *

>scanner, open me
No electronic technology detected.

>scanner, look
Syntax error: command not in vocabulary.

[You can ask the scanner for a list of commands by typing "scanner, help" and give it voice commands by typing phrases such as "scanner, scan SOMETHING" or "scanner, open SOMETHING" where SOMETHING is a visible object.]

>scanner, look
Syntax error: command not in vocabulary.

>scanner, look
Syntax error: command not in vocabulary.

>scanner, look
Syntax error: command not in vocabulary.

[You can ask the scanner for a list of commands by typing "scanner, help" and give it voice commands by typing phrases such as "scanner, scan SOMETHING" or "scanner, open SOMETHING" where SOMETHING is a visible object.]

* * *

>scanner, look
Syntax error: command not in vocabulary.

>scanner, help
Recognized commands are "help", "open", and "scan".

[You can ask the scanner for a list of commands by typing "scanner, help" and give it voice commands by typing phrases such as "scanner, scan SOMETHING" or "scanner, open SOMETHING" where SOMETHING is a visible object.]

* * *

>scanner, w
Syntax error: command not in vocabulary.

lb[You can ask the scanner for a list of commands by typing "scanner, help" and give it voice commands by typing phrases such as "scanner, scan SOMETHING" or "scanner, open SOMETHING" where SOMETHING is a visible object.]

>scanner, help
Recognized commands are "help", "open", and "scan".

[You can ask the scanner for a list of commands by typing "scanner, help" and give it voice commands by typing phrases such as "scanner, scan SOMETHING" or "scanner, open SOMETHING" where SOMETHING is a visible object.]

>scanner, jdskfljdkl
Syntax error: command not in vocabulary.

>scanner, jdskfljdkl
Syntax error: command not in vocabulary.
[You can ask the scanner for a list of commands by typing "scanner, help" and give it voice commands by typing phrases such as "scanner, scan SOMETHING" or "scanner, open SOMETHING" where SOMETHING is a visible object.]

* * *

>scanner, x me
Syntax error: command not in vocabulary.

[You can ask the scanner for a list of commands by typing "scanner, help" and give it voice commands by typing phrases such as "scanner, scan SOMETHING" or "scanner, open SOMETHING" where SOMETHING is a visible object.]

>xcanner, jkjkjk
You seem to want to talk to someone, but I can't see whom.

>scanner, jkjk
Syntax error: command not in vocabulary.

* * *

>script
Attempt to begin transcript failed.

>out
Sector 4: Crops
Your home is here among the crops. You can walk spinward or antispinward.

>x mirrors
The mirrors reflect sunlight into the station.

>touch mirros
You can't see any such thing.

>touch mirrors
You feel nothing unexpected.

>in
Home
The room where you've slept your entire life. You can go out towards the crops.

There is a secured hatch in the floor.

>showme s4h1
There seems to be no such object anywhere in the model world.

>showme hatch
(the floor hatch)
the floor hatch - floor hatch
location: in Home
singular-named, proper-named; unlit, inedible, fixed in place; closed, openable, unlocked, apparent
list grouping key: none
printed name: "the floor hatch"
printed plural name: "floor hatches"
indefinite article: none
description: "The hatch in the floor is secured shut, as you were trained, to protect against decompression."
initial appearance: "There is a secured hatch in the floor."
other side: Cellar

>drop hatch
the floor hatch is already here.

* * *

>search has
You can't see any such thing.

>open hatch
You open the floor hatch.

>search hatch
Through the floor hatch is the cellar.

* * *

>search hatch
CLOSED.

>open hatch
You open the floor hatch.

>search hatch
the cellar.

* * *

>showme
Home - room
    floor hatch - floor hatch
    yourself - person
        scanner
        green jumpsuit (worn)
            pocket (part of green jumpsuit) - open container

>showme home
(Home)
Home - room
    floor hatch - floor hatch
    yourself - person
        scanner
        green jumpsuit (worn)
            pocket (part of green jumpsuit) - open container
singular-named, proper-named; lighted, visited, familiar
list grouping key: none
printed name: "Home"
printed plural name: none
indefinite article: none
description: "The room where you've slept your entire life. You can go out to your crops."
destination name: "your home"

>gonear ladder
Platform 1
A mesh platform about two thirds of the way towards the hub. You can continue spinward or antispinward, or go up a ladder into the hub.

>showme
Platform 1 - room
    ground - backdrop
    pylon - backdrop
    maintenance platform - backdrop
    mirrors - backdrop
    solar panels - backdrop
    hub - backdrop
    yourself - person
        scanner
        green jumpsuit (worn)
            pocket (part of green jumpsuit) - open container
    ladder - open door

>showme platform i
There seems to be no such object anywhere in the model world.

>showme platform 1
Platform 1 - room
    ground - backdrop
    pylon - backdrop
    maintenance platform - backdrop
    mirrors - backdrop
    solar panels - backdrop
    hub - backdrop
    yourself - person
        scanner
        green jumpsuit (worn)
            pocket (part of green jumpsuit) - open container
    ladder - open door
singular-named, proper-named; lighted, visited, familiar
list grouping key: none
printed name: "Platform 1"
printed plural name: none
indefinite article: none
description: "A mesh platform about two thirds of the way towards the hub. You can continue spinward or antispinward, or go up a ladder into the hub."
map region: Platforms
destination name: none

>u
Inside the Hub
You float weightless in the middle of a cylinder. A ladder rotates around you, leading up or down or maybe out.

A yellow cable waves from a small panel.

>showme hub
(Inside the Hub)
Inside the Hub - room
    ladder - open door
    yourself - person
        scanner
        green jumpsuit (worn)
            pocket (part of green jumpsuit) - open container
    antenna panel - machine
        RF socket (part of antenna panel) - RF socket
    yellow cable - cable
        RF plug (part of yellow cable) - RF plug
        RF plug (part of yellow cable) - RF plug
singular-named, proper-named; lighted, visited, unfamiliar
list grouping key: none
printed name: "Inside the Hub"
printed plural name: none
indefinite article: none
description: "You float weightless in the middle of a cylinder. A ladder rotates around you, leading up or down or maybe out."
map region: Zero-G
destination name: none

>showme inside the hub
Inside the Hub - room
    ladder - open door
    yourself - person
        scanner
        green jumpsuit (worn)
            pocket (part of green jumpsuit) - open container
    antenna panel - machine
        RF socket (part of antenna panel) - RF socket
    yellow cable - cable
        RF plug (part of yellow cable) - RF plug
        RF plug (part of yellow cable) - RF plug
singular-named, proper-named; lighted, visited, unfamiliar
list grouping key: none
printed name: "Inside the Hub"
printed plural name: none
indefinite article: none
description: "You float weightless in the middle of a cylinder. A ladder rotates around you, leading up or down or maybe out."
map region: Zero-G
destination name: none

* * *

>showme hatch
(the floor hatch)
floor hatch - floor hatch
location: in Home
singular-named, improper-named; unlit, inedible, fixed in place; closed, openable, unlocked, apparent
list grouping key: none
printed name: "floor hatch"
printed plural name: "floor hatches"
indefinite article: none
description: "The floor hatch is closed."
initial appearance: "There is a secured hatch in the floor."
other side: Cellar

>showme home
(Home)
Home - room
    floor hatch - floor hatch
    yourself - person
        scanner
        green jumpsuit (worn)
            pocket (part of green jumpsuit) - open container
singular-named, proper-named; lighted, visited, apparent
list grouping key: none
printed name: "Home"
printed plural name: none
indefinite article: none
description: "The room where you've slept your entire life. You can go out towards the crops."
destination name: none

>d
(first opening the floor hatch)

Cellar
Your decompression shelter and space for some increasingly empty shelves of canned vegetables.

There is an open hatch in the ceiling.

>showme hatch
(the ceiling hatch)
ceiling hatch - floor hatch
location: in Cellar
singular-named, improper-named; unlit, inedible, fixed in place; open, openable, unlocked, apparent
list grouping key: none
printed name: "ceiling hatch"
printed plural name: "ceiling hatches"
indefinite article: none
description: "The ceiling hatch is open."
initial appearance: "There is an open hatch in the ceiling."
other side: Home

>u
Home
The room where you've slept your entire life. You can go out towards the crops.

There is an open hatch in the floor.

>showme hatch
(the floor hatch)
floor hatch - floor hatch
location: in Home
singular-named, improper-named; unlit, inedible, fixed in place; open, openable, unlocked, apparent
list grouping key: none
printed name: "floor hatch"
printed plural name: "floor hatches"
indefinite article: none
description: "The floor hatch is open."
initial appearance: "There is an open hatch in the floor."
other side: Cellar

* * *

>showme laser
laser beam - thing
location: out of play
singular-named, improper-named; unlit, inedible, fixed in place, scenery; dusty
list grouping key: none
printed name: "laser beam"
printed plural name: none
indefinite article: none
description: "The cloud of dust scatters the laser beam just enough that you can see it scan across the north passageway at seemingly random angles."
initial appearance: none

>gonear boots
Supply Vault
This room is dim, quiet, and stuffy. There is still one crate of machine parts left.

You see a laser beam scan across the exit.

There is a secured hatch in the ceiling.

You can also see a pair of gravity boots here.

>z
Time passes.

* * *

>swim
There's nothing to swim in.

>get
(the floor hatch)
That's fixed in place.

>get
(the floor hatch)
That's fixed in place.

>swim in hatch
You can't swim in the floor hatch.

* * *

>talk jsdjfk
[To communicate in this story, type "CHARACTER, MESSAGE" where CHARACTER is someone or something and MESSAGE is what you want to say.]

>talk
I didn't understand that sentence.

* * *

>talk to scanner
That's not a verb I recognize.

>talk to scanner
That's not a verb I recognize.

>say hello
(to the scanner)
Syntax error: command not in vocabulary.
[You can ask the scanner for a list of commands by typing "scanner, help" and give it voice commands by typing phrases such as "scanner, scan SOMETHING" or "scanner, open SOMETHING" where SOMETHING is a visible object.]

>say open door
(to the scanner)
Search error: cannot find door.

>say open me
(to the scanner)
Search error: cannot find me.

>say open hatch to scanner
Search error: cannot find hatch.
[You can ask the scanner for a list of commands by typing "scanner, help" and give it voice commands by typing phrases such as "scanner, scan SOMETHING" or "scanner, open SOMETHING" where SOMETHING is a visible object.]

>scanner, open hatch
No electronic technology detected.

>say open hatch
(to the scanner)
Search error: cannot find hatch.

* * *

>test cable
(Testing.)

>[1] gonear audio
Church
Before everyone left or died, you celebrated every sabbath here. The altar stands against one wall, and an organ and a portable audio unit stand against the other.

On the altar is The Founder's Testament.

A gray cable connects the organ to the audio unit.

>[2] get gray
Taken.

>[3] unplug gray from audio
You unplug the gray cable from the audio unit.

>[4] unplug gray from organ
You unplug the gray cable from the organ.

>[5] gonear ladder
Platform 1
A mesh platform about two thirds of the way towards the hub. You can continue spinward or antispinward, or go up a ladder into the hub.

>[6] u

Inside the Hub
You float weightless in the middle of a cylinder. A ladder rotates around you, leading up or down or maybe out.

>[7] plug gray into panel
You plug the gray cable into the panel.

>[8] unplug gray
(from the panel)
No.

>unplug gray from socket
You cannot specify a particular socket when unplugging something.

>x gray
A one meter USB 7.2 cable with a Type-F plug at each end.

It is plugged into a panel.

>showme cable
gray cable - thing
    usb plug (part of gray cable) - usb plug
    usb plug (part of gray cable) - usb plug
location: carried by yourself in Inside the Hub
singular-named, improper-named; unlit, inedible, portable, handled, machinelike
list grouping key: none
printed name: "gray cable"
printed plural name: none
indefinite article: none
description: "A one meter USB 7.2 cable with a Type-F plug at each end."
initial appearance: "A gray cable connects the organ to the audio unit."

>i
You are carrying:
  a gray cable (plugged into a panel)
  a scanner
  a green jumpsuit (being worn)

>unplug scanner from panel
But it isn't there now.

* * *

>u
You can't go up, but you can go down to the cellar or outside to sector 4.

>d
(first opening the floor hatch)

Cellar
Your decompression shelter and space for some increasingly empty shelves of canned vegetables.

There is an open hatch in the ceiling.

>d
The only exit is up to your home.

>s
The only exit is up to your home.

>p
The only exit is up to your home.

>u
Home
The room where you've slept your entire life. You can go out towards the crops.

There is an open hatch in the floor.

* * *

>out
Sector 4: Crops
Your home is here among the crops. You can walk spinward or antispinward.

>port
You can't go port, but you can go inside to your home, spinward to sector 5, or antispinward to sector 3.

* * *

>gonear ladder
Platform 1
A mesh platform about two thirds of the way towards the hub. You can continue spinward or antispinward, or go up a ladder into the hub.

>u
Inside the Hub
You are weightless, so instead of up and down, you think of the ladder as leading "out."

You can see  floating here.

*** Run-time problem P13: Tried to abandon an activity which wasn't going on.

* * *

>use md
Please try specific a more specific verb instead.

>exit
Sector 4: Crops
Your home is here among the crops. You can walk spinward or antispinward.

>in
Home
The room where you've slept your entire life. You can go out towards the crops.

There is a secured hatch in the floor.

* * *

>d
(first opening the floor hatch)

Cellar
Your decompression shelter and space for some increasingly empty shelves of canned vegetables.

There is an open hatch in the ceiling.

>exit
But you aren't in anything at the moment.

>out
But you aren't in anything at the moment.

>look
Cellar
Your decompression shelter and space for some increasingly empty shelves of canned vegetables.

There is an open hatch in the ceiling.

* * *

>wear blanket
(first getting off the blanket)
(first taking the blanket)
You put on the blanket.

>put scanner in blanket
That can't contain things.

>put scanner on blanket
Not while you are wearning the blanket.

>drop blanket
(first taking the blanket off)
Dropped.

* * *

>why
Hello

>why
Hello

* * *

>x blanket
Blanket.

>x blanket
Blanket.

>drop scanner
Dropped.

>x blanket
Blanket.

On the blanket is a scanner.

* * *

>x forest
You have worn modest jumpsuits like this since you were small. Originally, the colors had meanings: forest green for farmers, navy blue for technicians, and so on, but that distinction died even before the population.

It features a single large pocket, currently empty.

>out
Sector 4: Crops
Your home is here among the crops. You can walk spinward or antispinward.

* * *

>sw
You walk a little ways to the next sector.

Sector 5: Forest
The school house is nestled among the trees. A pylon stretches up from the same grove to the hub of the station. You can walk spinward or antispinward.

>x forest
(the green jumpsuit)
You have worn modest jumpsuits like this since you were small. Originally, the colors had meanings: forest green for farmers, navy blue for technicians, and so on, but that distinction died even before the population.

It features a single large pocket, currently empty.

* * *

>out
Sector 4: Crops
Your home is here among the crops. You can walk spinward or antispinward.

>x foret
You can't see any such thing.

>x forest
You have worn modest jumpsuits like this since you were small. Originally, the colors had meanings: forest green for farmers, navy blue for technicians, and so on, but that distinction died even before the population.

It features a single large pocket, currently empty.

>sw
You walk a little ways to the next sector.

Sector 5: Forest
The school house is nestled among the trees. A pylon stretches up from the same grove to the hub of the station. You can walk spinward or antispinward.

* * *

>x forest jump suit
You have worn modest jumpsuits like this since you were small. Originally, the colors had meanings: forest green for farmers, navy blue for technicians, and so on, but that distinction died even before the population.

It features a single large pocket, currently empty.

>x forest
You can't see any such thing.

>look
Home
The room where you've slept your entire life. You can go out towards the crops.

There is a secured hatch in the floor.

* * *

>x gray
You can't see any such thing.

>gonear gray
Church
Before everyone left or died, you celebrated every sabbath here. The altar stands against one wall, and an organ and a portable audio unit stand against the other.

On the altar is The Founder's Testament.

A gray cable connects the organ to the audio unit.

>x gray
A one meter USB 7.2 cable with a Type-F plug at each end. It is plugged into the organ and an audio unit.

>unplug gray
The gray cable is plugged into more than one thing.

[Try "unplug gray cable from SOMETHING".]

>unplug gray from audio
You unplug the gray cable from the audio unit.

>unplug gray from organ
You unplug the gray cable from the organ.

>x gray
A one meter USB 7.2 cable with a Type-F plug at each end. It is not plugged into anything.

>undo
Church
[Previous turn undone.]

>undo
Church
[Previous turn undone.]

>x gray
A one meter USB 7.2 cable with a Type-F plug at each end. It is plugged into the organ.

>unplug gray from organ
You unplug the gray cable from the organ.

* * *

>x gray
A one meter USB 7.2 cable with a Type-F plug at each end. It is not plugged into anything.

>x organ
It's really just a keyboard in a fancy box with a socket to connect it to an audio unit.

The organ has nothing plugged into it.

* * *

>x hatch
The floor hatch is closed.

>d
(first opening the floor hatch)

Cellar
Your decompression shelter and space for some increasingly empty shelves of canned vegetables.

There is an open hatch in the ceiling.

* * *

>x hatch
The floor hatch is closed.

>look
Home
The room where you've slept your entire life. You can go out towards the crops.

There is a secured hatch in the floor.

* * *

>x hatch
The floor hatch is closed.

>search hatch
CLOSED.

* * *

>open hatch
You open the floor hatch.

>search hatch
CLOSED.

>x hatch
The floor hatch is open.

* * *

>x home
You can't see any such thing.

>out
Sector 4: Crops
Your home is here among the crops. You can walk spinward or antispinward.

>x home
You were told it was built to look like a log cabin on Old Earth.

>search home
You would need to enter your home to do that.

>in
Home
The room where you've slept your entire life. You can go out towards the crops.

There is a secured hatch in the floor.

>open hatch
You open the floor hatch.

* * *

>look through hatch
The cellar is down through the floor hatch.

>x hatch
The floor hatch is open.

>d
Cellar
Your decompression shelter and space for some increasingly empty shelves of canned vegetables.

There is an open hatch in the ceiling.

* * *

>x me
As virtuous as ever.

>out
Sector 4: Crops
Your home is here among the crops. You can walk spinward or antispinward.

>d
You can't go down, but you can go inside to your home, spinward to sector 5, or antispinward to sector 3.

>u
You can't go up, but you can go inside to your home, spinward to sector 5, or antispinward to sector 3.

>out
But you aren't in anything at the moment.

>asw
You walk a little ways to the next sector.

Sector 3: Forest
Trees, a house, and a church. A red pylon stretches up from the ground to the hub of the station. You can walk spinward or antispinward.

* * *

>u
The red pylon is designated for climbing, but you can't get a grip.

>d
You can't go down, but you can go starboard to the house, port to the church, spinward to sector 4, or antispinward to sector 2.

>look through door
You can't see any such thing.

>x door
You can't see any such thing.

>look through hatch
You can't see any such thing.

* * *

>x panel
You can't see any such thing.

>gonear yellow
Inside the Hub
You float weightless in the middle of a cylinder. A ladder rotates around you, leading up or down or maybe out.

A yellow cable waves from a small panel.

>scan panel
Machine is functional.

>x panel
Panel.

The antenna panel has a yellow cable plugged into it.

>x yellow cable
A yellow RF cable.

It is plugged into an antenna panel.

>purloin gray
[Purloined.]

>d
The gray cable pulls out of the organ.
The gray cable pulls out of the audio unit.

You make sure you are heading legs first and follow the ladder.

Platform 1
A mesh platform about two thirds of the way towards the hub. You can continue spinward or antispinward, or go up a ladder into the hub.

>u
Inside the Hub
You float weightless in the middle of a cylinder. A ladder rotates around you, leading up or down or maybe out.

A yellow cable waves from a small panel.

>x gray
A one meter USB 7.2 cable with a Type-F plug at each end.

It is not plugged into anything.

* * *

>x scanner
The handheld voice-activated scanner you use when working on the station's machines.

[You can ask the scanner for a list of commands by typing "scanner, help" and give it voice commands by typing phrases such as "scanner, scan SOMETHING" or "scanner, open SOMETHING" where SOMETHING is a visible object.]

* * *

>g
The handheld voice-activated scanner you use when working on the station's machines.

>scanner, scan
Syntax error: no target.

[You can ask the scanner for a list of commands by typing "scanner, help" and give it voice commands by typing phrases such as "scanner, scan SOMETHING" or "scanner, open SOMETHING" where SOMETHING is a visible object.]

>scanner, scan
Syntax error: no target.

>scanner, scan
Syntax error: no target.

[You can ask the scanner for a list of commands by typing "scanner, help" and give it voice commands by typing phrases such as "scanner, scan SOMETHING" or "scanner, open SOMETHING" where SOMETHING is a visible object.]

>scanner, go north
Syntax error: command not in vocabulary.

* * *

>x xxx
You can't see any such thing.

>d
(first opening the floor hatch)

Cellar
Your decompression shelter and space for some increasingly empty shelves of canned vegetables.

There is an open hatch in the ceiling.

>x
What do you want to examine?

>x xxx
*** Run-time problem P47 (at paragraph 651 in the source text): Phrase applied to an incompatible kind of value.

You can't see any such thing.

* * *

>d
(first opening the floor hatch)

Cellar
Your decompression shelter and space for some increasingly empty shelves of canned vegetables.

There is an open hatch in the ceiling.

>x xxx
You can't see any such thing.

* * *

>z
Time passes.

You can't reach into Inside the Hub.

>z
Time passes.

You can't reach into Inside the Hub.

>out
Sector 4: Crops
Your home is here among the crops. You can walk spinward or antispinward.

>z
Time passes.