You awake. You are lonely, so lonely. It was a thousand days ago today. All alone these thousand days. Your parents were the last. No, your father was the last. He held on for nearly a hundred days longer. Now you are the last. Alone. Adrift.

But maybe it isn't hopeless. There must still be other people in other worlds, and you think you know how to get there.

Today is the day.

Founder's Mercy
A Space Story by Thomas Insel
Release 1 / Serial number 181211 / Inform 7 build 6M62 (I6/v6.33 lib 6/12N) SD
Type ABOUT for credits or HINT for assistance.

Home (on the blanket)
The room where you've slept your entire life. The crops are outside.

There is a secured hatch in the floor.

>* walkthrough
(Noted.)

* * *

>d
(first opening the floor hatch)

Supply Vault
This room is dim, quiet, and stuffy. There is still one crate of machine parts left.

There is an open hatch in the ceiling.

You can also see a pair of gravity boots here.

>search crate
You find an instruction module and a pressure regulation module.
(putting the dusty eraser into your pocket to make room)
(putting the power module into your pocket to make room)

>get boots
(putting the instruction module into your pocket to make room)
Taken.

>hit eraser
(first taking the dusty eraser)
(putting the pressure regulation module into your pocket to make room)
You fill the vault with a cloud of dust which scatters the laser beam that you can now see scanning across the hatch.

>u
You maneuver around the laser beam and pull yourself up through the ceiling hatch.

Sector 6: Hydroponics
Your people preferred to grow things the old fashioned way, but in truth the majority of your fruit and vegetables came from this sector when the machines still worked. You can walk spinward or antispinward.

There is an open hatch in the ground.

[Your score has just gone up by one point.]

* * *

>asw
Platform 1
A mesh platform about two thirds of the way towards the hub. You can continue spinward or antispinward, or go up a ladder into the hub.

>u
Gravity fades as you climb.

Inside the Hub
You float weightless in the middle of a cylinder. It is colder up here, and the light is all artifical but without an obvious source. A ladder rotates around you, leading up or down or maybe out, and a door leads to the port.

>wear mask
(first taking the emergency mask)
(putting the gray cable into your pocket to make room)
You put on the emergency mask.

>port
(first opening the starboard airlock door)

Airlock
There are port and starboard doors and a red button.

>push red button
The starboard door slams shut. You feel the air rush out of the airlock.

>port
(first opening the port airlock door)
You crawl through a narrow accessway.

Antenna Control
You float weightless at the port end of a cylinder. It is very cold and dark here in the near vacuum. A door leads starboard.

A yellow cable waves from a small panel.

[Your score has just gone up by two points.]

>plug yellow into comms
You plug the yellow cable into the emergency communications unit.

>scan comms
You can't talk to the scanner while wearing the mask.

>press 3
Calibrate to Delta/Plum.

* * *

>press 5
Calibrate to Beta/Cherry.

>press 2
Calibration successful.

The audio unit beeps and a synthesized voice says "Comms ready."

After a moment, it says "Launching automatic routines."

[Your score has just gone up by two points.]

>z
Time passes.

You hear a human speaking from the audio unit: "RWSS Founder's Mercy, this is OV-5570, over...

"There's really somebody there? We thought your station had been abandoned for kilodays...

"Standby...

"We can have a pod there in about a thousand minutes."

    *** You are not alone. ***

In that game you scored 10 out of a possible 10, in 68 turns.

Would you like to RESTART, RESTORE a saved game, QUIT, UNDO the last command, or read the CREDITS?

* * *

>plug yellow into comms
You plug the yellow cable into the emergency communications unit.

>z
Time passes.

You hear a human speaking from the audio unit: "RWSS Founder's Mercy, this is OV-5570, over...

"There's really somebody there? We thought your station had been abandoned for kilodays...

"Standby...

"We can have a pod there in about a thousand minutes."

    *** You are not alone. ***

In that game you scored 10 out of a possible 10, in 63 turns.

Would you like to RESTART, RESTORE a saved game, QUIT, UNDO the last command, or read the CREDITS?

>credits
About Founder's Mercy
Founder's Mercy is my second released Inform project, conceived and implemented in the last months of 2018.

Thanks to Graham Nelson, Andrew Plotkin, Emily Short, and everyone else who contributed to the Inform and Glulx ecosystem. Thanks also Juhana Leinonen for the Object Response Tests extension, and Sean Turner for the Plugs and Sockets extension. Exit listing code is inspired by Eric Eve's Exit Lister. The cover art is adapted from Figure 1.1 from NASA SP-413, Space Settlements: A Design Study, edited by Richard D. Johnson and Charles Holbrow, and available from The Internet Archive at https://archive.org/details/SpaceSettlementsADesignStudy1977 .

Please send your feedback, bug reports, and requests for help to tinsel@tinsel.org. You can always find the current version of this story at http://tinsel.org/IF/ .

This work is Copyright © 2019 Thomas Insel but may be freely shared according to the terms of the Creative Commons Attribution 4.0 International license (https://creativecommons.org/licenses/by/4.0/).

Would you like to RESTART, RESTORE a saved game, QUIT, UNDO the last command, or read the CREDITS?

* * *

>abou
That's not a verb I recognize.

>about
About Founder's Mercy
Founder's Mercy is my second released Inform project, conceived and implemented in the last months of 2018.

Thanks to Graham Nelson, Andrew Plotkin, Emily Short, and everyone else who contributed to the Inform and Glulx ecosystem. Thanks also Juhana Leinonen for the Object Response Tests extension, and Sean Turner for the Plugs and Sockets extension. Exit listing code is inspired by Eric Eve's Exit Lister. The cover art is adapted from Figure 1.1 from NASA SP-413, Space Settlements: A Design Study, edited by Richard D. Johnson and Charles Holbrow, and available from The Internet Archive at https://archive.org/details/SpaceSettlementsADesignStudy1977 .

Please send your feedback, bug reports, and requests for help to tinsel@tinsel.org. You can always find the current version of this story at http://tinsel.org/IF/ .

This work is Copyright © 2018 Thomas Insel but may be freely shared according to the terms of the Creative Commons Attribution 4.0 International license (https://creativecommons.org/licenses/by/4.0/).

* * *

>about
About Founder's Mercy
Founder's Mercy is my second released Inform project, conceived and implemented in the last months of 2018.

Thanks to Graham Nelson, Andrew Plotkin, Emily Short, and everyone else who contributed to the Inform and Glulx ecosystem. Thanks also Juhana Leinonen for the Object Response Tests extension, and Sean Turner for the Plugs and Sockets extension. Exit listing code is inspired by Eric Eve's Exit Lister. The cover art is adapted from Figure 1.1 from NASA SP-413, Space Settlements: A Design Study, edited by Richard D. Johnson and Charles Holbrow, and available from The Internet Archive at https://archive.org/details/SpaceSettlementsADesignStudy1977 .

Please send your feedback, bug reports, and requests for help to tinsel@tinsel.org. You can always find the current version of this story at http://tinsel.org/IF/ .

This work is Copyright © 2018 Thomas Insel but may be freely shared according to the terms of the Creative Commons Attribution 4.0 International license (https://creativecommons.org/licenses/by/4.0/).

* * *

>credits
About Founder's Mercy
Founder's Mercy is my second released Inform project, conceived and implemented in the last months of 2018.

Thanks to Graham Nelson, Andrew Plotkin, Emily Short, and everyone else who contributed to the Inform and Glulx ecosystem. Thanks also Juhana Leinonen for the Object Response Tests extension, and Sean Turner for the Plugs and Sockets extension. Exit listing code is inspired by Eric Eve's Exit Lister. Keypad code is inspired by Emily Short's Computers.

The cover art is adapted from Figure 1.1 from NASA SP-413, Space Settlements: A Design Study, edited by Richard D. Johnson and Charles Holbrow, and available from The Internet Archive at https://archive.org/details/SpaceSettlementsADesignStudy1977 .

Please send your feedback, bug reports, and requests for help to tinsel@tinsel.org. You can always find the current version of this story at http://tinsel.org/IF/ .

This work is Copyright © 2019 Thomas Insel but may be freely shared according to the terms of the Creative Commons Attribution 4.0 International license (https://creativecommons.org/licenses/by/4.0/).

* * *

>gonear audio
Church
Before everyone left or died, you celebrated every sabbath here. The altar stands against one wall, and an organ and a portable audio unit stand against the other.

On the altar is The Founder's Testament.

A gray cable connects the organ to the audio unit.

<not-functional | not-functional>.

>out
Sector 3: Forest
Trees, a house, and a church. A red pylon stretches up from the ground to the hub of the station. You can walk spinward or antispinward.

>purloin all power
[Purloined.]
[Purloined.]
[Purloined.]

>scan power
Module is functional.

>in
You can enter the church or the house.

>church
Church
Before everyone left or died, you celebrated every sabbath here. The altar stands against one wall, and an organ and a portable audio unit stand against the other.

On the altar is The Founder's Testament.

A gray cable connects the organ to the audio unit.

<not-functional | not-functional>.

>put functional power in audio
You put the functional power module into the audio unit.

<not-functional | organ>.
CHANGE.

>z
Time passes.

<organ | organ>.

* * *

>gonear audio
Church
Before everyone left or died, you celebrated every sabbath here. The altar stands against one wall, and an organ and a portable audio unit stand against the other.

On the altar is The Founder's Testament.

A gray cable connects the organ to the audio unit.

<not-functional | not-functional>.

>unplug gray
The gray cable is plugged into more than one thing.

[Try UNPLUG gray cable FROM SOMETHING.]

* * *

>gonear audio
Church
Before everyone left or died, you celebrated every sabbath here. The altar stands against one wall, and an organ and a portable audio unit stand against the other.

On the altar is The Founder's Testament.

A gray cable connects the organ to the audio unit.

<not-functional | not-functional>.

>z
Time passes.

<not-functional | not-functional>.

>z
Time passes.

<not-functional | not-functional>.

>out
Sector 3: Forest
Trees, a house, and a church. A red pylon stretches up from the ground to the hub of the station. You can walk spinward or antispinward.

* * *

>z
Time passes.

<organ | organ>.

>z
Time passes.

<organ | organ>.

* * *

>gonear display
Pod Control
This room serves as an airlock for the pod bay, and holds an old space suit and various machinery such as the atmosphere pump. There is a brass plate on the wall.

There is a secured hatch in the ceiling.

Beside the secured port door, a status display shows an error message.

>x display
Pod bay locked down
 1. Telemetry sensor array offline - reset breaker FM36-87/A @ hub platform
 2. Launch system cooling loop offline - open backup valve @ Sector 2
 3. Pod bay depressurized - scan and repair atmosphere pump

* * *

>gonear display
Pod Control
This room serves as an airlock for the pod bay, and holds an old space suit and various machinery such as the atmosphere pump. There is a brass plate on the wall.

There is a secured hatch in the ceiling.

Beside the secured port door, a status display shows an error message.

>x plaque
The plate reads:

    RWSS Founder's Mercy
    Laid down 2138, Launched 2141.
    "May His mercy shine upon us."

* * *

>gonear gray
Church
Before everyone left or died, you celebrated every sabbath here. The altar stands against one wall, and an organ and a portable audio unit stand against the other.

On the altar is The Founder's Testament.

A gray cable connects the organ to the audio unit.

>unplug gray
The gray cable is plugged into more than one thing.

[Try UNPLUG GRAY CABLE FROM SOMETHING.]

* * *

>gonear ladder
Platform 1
A mesh platform about two thirds of the way towards the hub. You can continue spinward or antispinward, or go up a ladder into the hub.

>purloin blanket and mask
[Purloined.]
[Purloined.]

>wear blanket
You put on the blanket.

>wear mask
You put on the emergency mask.

>u
Gravity fades as you climb.

Inside the Hub
You float weightless in the middle of a cylinder. It is colder up here, and the light is all artifical but without an obvious source. A ladder rotates around you, leading up or down or maybe out, and a door leads to the port.

>p
(first opening the starboard airlock door)

Airlock
There are port and starboard doors and a red button.

>push button
The starboard door slams shut. You feel the air rush out of the airlock.

>g
You feel the airlock pressurize.

>g
You feel the air rush out of the airlock.

>g
You feel the airlock pressurize.

* * *

>g
You feel the air rush out of the airlock.

>p
(first opening the port airlock door)
You pull yourself along a narrow accessway.

Antenna Control
You float weightless at the port end of a cylinder. It is very cold and dark here in the near vacuum. A door leads starboard.

A yellow cable waves from a small panel.

>s
You make your way back along the narrow accessway.

Airlock
There are port and starboard doors and a red button.

>push button
The port door slams shut. You feel the airlock pressurize.

>g
You feel the air rush out of the airlock.

>port
(first opening the port airlock door)
You pull yourself along a narrow accessway.

Antenna Control
You float weightless at the port end of a cylinder. It is very cold and dark here in the near vacuum. A door leads starboard.

A yellow cable waves from a small panel.

>drop blanket
(first taking the blanket off)
It is too cold here to even consider removing the blanket.

>i
You are carrying:
  an emergency mask (being worn)
  your blanket (being worn)
  a scanner
  a green jumpsuit (being worn)

>look
Antenna Control
You float weightless at the port end of a cylinder. It is very cold and dark here in the near vacuum. A door leads starboard.

A yellow cable waves from a small panel.

>purloin sensor
[Purloined.]

>x sensor
A small box with a large lamp that is slowly flashing red.

>s
You make your way back along the narrow accessway.

Airlock
There are port and starboard doors and a red button.

* * *

>push button
The port door slams shut. You feel the airlock pressurize.

>x sensor
A small box with a large lamp that is slowly flashing amber.

>scan sensor
You can't talk to the scanner while wearing the mask.

>remove mask
You take off the emergency mask.

>scan sensor
Machine functional. Pressure low at 80 kilopascals, O₂ normal, CO₂ high at 0.10%. No immediate danger.

>i
You are carrying:
  an atmosphere sensor
  an emergency mask
  your blanket (being worn)
  a scanner
  a green jumpsuit (being worn)

>x mask
You wore this mask when there were regular decompression drills.

* * *

>gonear organ
Church
Before everyone left or died, you celebrated every sabbath here. The altar stands against one wall, and an organ and a portable audio unit stand against the other.

On the altar is The Founder's Testament.

A gray cable connects the organ to the audio unit.

<not-functional | not-functional>.

>out
Sector 3: Forest
Trees, a house, and a church. A red pylon stretches up from the ground to the hub of the station. You can walk spinward or antispinward.

* * *

>scan power
Module is functional.

>church
Church
Before everyone left or died, you celebrated every sabbath here. The altar stands against one wall, and an organ and a portable audio unit stand against the other.

On the altar is The Founder's Testament.

A gray cable connects the organ to the audio unit.

<not-functional | not-functional>.

>put functional power in comms
You can't see any such thing.

>put functional power in audio
You put the functional power module into the audio unit.

<not-functional | organ>.
The audio unit beeps and a synthesized voice says "Organ ready."

>unplug cable
The gray cable is plugged into more than one thing.

[Try UNPLUG GRAY CABLE FROM SOMETHING.]

<organ | organ>.

>unplug cable from organ
You unplug the gray cable from the organ.

<organ | not-connected>.
The audio unit beeps and a synthesized voice says "No input."

* * *

>gonear organ
Church
Before everyone left or died, you celebrated every sabbath here. The altar stands against one wall, and an organ and a portable audio unit stand against the other.

On the altar is The Founder's Testament.

A gray cable connects the organ to the audio unit.

<not-functional | not-functional>.

>z
Time passes.

<not-functional | not-functional>.

>x audio
The audio unit incorporates a speaker, a microphone, and a socket you would use to connect it to another device. It contains a power module.

The audio unit has a gray cable plugged into it.

<not-functional | not-functional>.

>get power
Taken.

<not-functional | not-functional>.

>x power
It is a standardized power module.

<not-functional | not-functional>.

>scan power
Module is faulty.

<not-functional | not-functional>.

>purloin all power
(the faulty power module)
[Purloined.]

>out
Sector 3: Forest
Trees, a house, and a church. A red pylon stretches up from the ground to the hub of the station. You can walk spinward or antispinward.

>drop power
Dropped.

>in
You can enter the church or the house.

* * *

>church
Church
Before everyone left or died, you celebrated every sabbath here. The altar stands against one wall, and an organ and a portable audio unit stand against the other.

On the altar is The Founder's Testament.

A gray cable connects the organ to the audio unit.

<not-functional | not-functional>.

>purloin all power
[Purloined.]
[Purloined.]
[Purloined.]

>scan power
Which do you mean, an unscanned power module or the faulty power module?

>unscanned
Module is functional.

<not-functional | not-functional>.

>put functional power in audio
You put the functional power module into the audio unit.

<not-functional | organ>.

>unplug gray from audio
You unplug the gray cable from the audio unit.

<organ | not-connected>.

>z
Time passes.

<not-connected | not-connected>.

* * *

>z
Time passes.

<not-functional | not-functional>.

>z
Time passes.

< | >.
NF.
< | >.

>z
Time passes.

< | >.
< | >.

>z
Time passes.

< | >.
< | >.

* * *

>gonear pod control
Pod Control
This room serves as an airlock for the pod bay, and holds an old space suit and various machinery such as the atmosphere pump. There is a brass plate on the wall.

There is a secured hatch in the ceiling.

Beside the secured port door, a status display shows an error message.

>port
(first opening the bulkhead door)
It seems to be locked.

* * *

>gonear red button
Airlock
There are port and starboard doors and a red button.

>press button
You from your safety training not to press the button without a backup oxygen source.

>purloin mask
[Purloined.]

* * *

>wear it
You put on the emergency mask.

>push button
P.
You feel the air rush out of the room.

>g
You feel the airlock pressurize.

>g
P.
You feel the air rush out of the room.

* * *

>gonear red button
Airlock
There are port and starboard doors and a red button.

>push button
You from your safety training not to press the button without a backup oxygen source.

>purloin mask
[Purloined.]

* * *

>wear mask
You put on the emergency mask.

>push button
You feel the air rush out of the airlock.

>in
(first opening the port airlock door)
You crawl through a narrow accessway.

Antenna Control
You float weightless at the port end of a cylinder. It is very cold and dark here in the near vacuum. A door leads starboard.

A yellow cable waves from a small panel.

[Your score has just gone up by two points.]

* * *

>gonear red button
Airlock
There are port and starboard doors and a red button.

>x door
Which do you mean, the starboard airlock door or the port airlock door?

>x starboard door
You see nothing special about the starboard airlock door.

>x port door
You see nothing special about the port airlock door.

>open starboard door
You open the starboard airlock door.

>x port door
You see nothing special about the port airlock door.

>x starboard
(the starboard airlock door)
You see nothing special about the starboard airlock door.

>version
Founder's Mercy
A Space Story by Thomas Insel
Release 1 / Serial number 181211 / Inform 7 build 6M62 (I6/v6.33 lib 6/12N) SD
Type "about" for credits or "hint" for assistance.
Identification number: //BCC61E7F-CE8E-4C25-9E9D-5550D1138D8C//
Interpreter version 0.5.2 / VM 3.1.2 / Library serial number 080126
Standard Rules version 3/120430 by Graham Nelson
Unicode Character Names by Graham Nelson
Plugs and Sockets version 4/170924 by Sean Turner
Object Response Tests version 7 by Juhana Leinonen

* * *

>gonear scanner
Home
The room where you've slept your entire life. The crops are outside.

There is a secured hatch in the floor.

The homespun blanket which you use as your bed is arranged on the ground.

>x scanner
The handheld voice-activated scanner you use when working on the station's machines.

[You can ask the scanner for a list of commands by typing "scanner, help" and give it voice commands by typing phrases such as "scanner, scan SOMETHING" where SOMETHING is a visible object.]

>scanner, x me
Syntax error: command not in vocabulary.

* * *

>gonear yellow
Antenna Control
You float weightless at the port end of a cylinder. It is very cold and dark here in the near vacuum. A door leads starboard.

A yellow cable waves from a small panel.

[Your score has just gone up by two points.]

>drop display
You haven't got that.

>x display
Calibrate to Epsilon/Lime.

>drop panel
The antenna calibration panel is already here.

>x panel
This is clearly the antenna calibration panel. It has a display, a keypad, and a yellow RF cable.

The antenna calibration panel has a yellow cable plugged into it.

>purloin comms
[Purloined.]

>plug yellow into comms
You plug the yellow cable into the emergency communications unit.

>x comms
A bulky but portable emergency communications unit from a transit pod. It can work independently if you provide audio and antenna connections.

The emergency communications unit has a yellow cable plugged into it.

>x panel
This is clearly the antenna calibration panel. It has a display, a keypad, and a yellow RF cable.

The antenna calibration panel has a yellow cable plugged into it.

>drop panel
The antenna calibration panel is already here.

* * *

>gonear yellow
Antenna Control
You float weightless at the port end of a cylinder. It is very cold and dark here in the near vacuum. A door leads starboard.

A yellow cable waves from a small panel.

[Your score has just gone up by two points.]

>exits
The only exit is starboard.

>s
(first opening the port airlock door)
It seems to be locked.

>gonear red
(the red circuit breaker)
Platform 3
A mesh platform about two thirds of the way towards the hub. You can continue spinward or antispinward.

You feel much lighter here, and you are very aware of how the station rotates, but everything is okay as long as you don't look down.

There is a red circuit breaker here.

>gonear button
Airlock
There are port and starboard doors and a red button.

>exits
The exits are starboard and port to antenna control.

>s
(first opening the starboard airlock door)

Inside the Hub
You float weightless in the middle of a cylinder. It is colder up here, and the light is all artifical but without an obvious source. A ladder rotates around you, leading up or down or maybe out, and a door leads to the port.

>p
The airlock is colder still, too cold for you in only your jumpsuit.

>p
The airlock is colder still, too cold for you in only your jumpsuit.

>push button
You can't see any such thing.

>look
Inside the Hub
You float weightless in the middle of a cylinder. It is colder up here, and the light is all artifical but without an obvious source. A ladder rotates around you, leading up or down or maybe out, and a door leads to the port.

>p
The airlock is colder still, too cold for you in only your jumpsuit.

* * *

>gonear yellow
Antenna Control
You float weightless at the port end of a cylinder. It is very cold and dark here in the near vacuum. A door leads starboard.

A yellow cable waves from a small panel.

[Your score has just gone up by two points.]

>type 3
Calibrate to Delta/Plum.

>type 8
Calibrate to Gamma/Banana.

>type 5
Calibrate to Beta/Cherry.

>type 2
Calibration successful.

>x display
Antenna calibrated.

>x panel
This is clearly the antenna calibration panel. It has a display, a keypad, and a yellow RF cable.

The panel has a yellow cable plugged into it.

* * *

>gonear yellow
Antenna Control
You float weightless at the port end of a cylinder. It is very cold and dark here in the near vacuum. A door leads starboard.

A yellow cable waves from a small panel.

[Your score has just gone up by two points.]

>x display
Calibrate to Epsilon/Lime.

[Now might be a good time to consult your Official Space Relay League Antenna Calibration Guide.]

>type 3
Calibrate to Delta/Plum.

* * *

>x panel
This is clearly the antenna calibration panel. It has a display, a keypad, and a yellow RF cable.

The panel has a yellow cable plugged into it.

>x cable
A two meter yellow RF cable. It is plugged into a panel.

* * *

>gonear yellow
Antenna Control
You float weightless at the port end of a cylinder. It is very cold and dark here in the near vacuum. A door leads starboard.

A yellow cable waves from a small panel.

[Your score has just gone up by two points.]

>x panel
This is clearly the antenna calibration panel. It has a display, a keypad, and a yellow RF cable.

The panel has a yellow cable plugged into it.

* * *

>listen
You hear only the familiar hum of the station.

>gonear yellow
Antenna Control
You float weightless at the port end of a cylinder. It is very cold and dark here. A door leads starboard.

A yellow cable waves from a small panel.

>listen
You hear nothing.

>hint
Your objective is simply to leave the station and find other people.

You can start by looking around and leaving your initial location.

By the way, it should be impossible to put this story into an unwinnable state, so feel free to explore and experiment.

If you are having trouble getting started, I suggest reading A Beginner's Guide to Interactive Fiction by Stephen Granade and Emily Short, available at:

  https://brasslantern.org/players/howto/beginnersguide.html

[You can type "hint" any time for contextual assistance. If you prefer not to be tempted, you can type "hints off" to disable hints.]

>about
About Founder's Mercy
Founder's Mercy is my second released Inform project, conceived and implemented in November of 2018.

Thanks to Graham Nelson, Andrew Plotkin, Emily Short, and everyone else who contributed to the Inform and Glulx ecosystem. Thanks also Juhana Leinonen for the Object Response Tests extension, and Sean Turner for the Plugs and Sockets extension. Exit listing code is inspired by Eric Eve's Exit Lister. The cover art is adapted from Figure 1.1 from NASA SP-413, Space Settlements: A Design Study, edited by Richard D. Johnson and Charles Holbrow, and available from The Internet Archive at https://archive.org/details/SpaceSettlementsADesignStudy1977 .

Please send your feedback, bug reports, and requests for help to tinsel@tinsel.org. You can always find the current version of this story at http://tinsel.org/IF/ .

This work is Copyright © 2018 Thomas Insel but may be freely shared according to the terms of the Creative Commons Attribution 4.0 International license (https://creativecommons.org/licenses/by/4.0/).

* * *

>scanner, help
Recognized commands are "help" and "scan".

[You can ask the scanner for a list of commands by typing "scanner, help" and give it voice commands by typing phrases such as "scanner, scan SOMETHING" where SOMETHING is a visible object.]

>gonear display
Pod Control
This room serves as an airlock for the pod bay, and holds an old space suit and various machinery such as the atmosphere pump. There is a brass plate on the wall.

There is a secured hatch in the ceiling.

Beside the secured port door, a status display shows an error message.

* * *

>version
Founder's Mercy
A Space Story by Thomas Insel
Release 1 / Serial number 181211 / Inform 7 build 6M62 (I6/v6.33 lib 6/12N) SD
Type "about" for credits or "hint" for assistance.
Identification number: //BCC61E7F-CE8E-4C25-9E9D-5550D1138D8C//
Interpreter version 0.5.2 / VM 3.1.2 / Library serial number 080126
Standard Rules version 3/120430 by Graham Nelson
Plugs and Sockets version 4/170924 by Sean Turner
Object Response Tests version 7 by Juhana Leinonen

* * *

>x panel
You can't see any such thing.

>gonear yellow
Antenna Control
You float weightless at the port end of a cylinder. It is very cold and dark here in the near vacuum. A door leads starboard.

A yellow cable waves from a small panel.

[Your score has just gone up by two points.]

* * *

>x panel
This is clearly the antenna calibration panel. It has a display, a keypad, and a yellow RF cable.

The panel has a yellow cable plugged into it.

>g
This is clearly the antenna calibration panel. It has a display, a keypad, and a yellow RF cable.

The panel has a yellow cable plugged into it.