You awake. You are lonely, so lonely. It was a thousand days ago today. All alone these thousand days. Your parents were the last. No, your father was the last. He held on for nearly a hundred days longer. No, you are the last. Alone. Adrift.

But maybe it isn't hopeless. There must still be other people in other worlds, and you think you know how to get there.

Today is the day.

Founder's Mercy
A Space Story by Thomas Insel
Release 1 / Serial number 181128 / Inform 7 build 6M62 (I6/v6.33 lib 6/12N) SD
Type "about" for credits or "hint" for assistance.

Home
The room where you've slept your entire life. You can go out towards the crops.

There is a secured hatch in the floor.

>* minimal walkthrough
(Noted.)

>d
(first opening the floor hatch)
You scramble down through the hatch and close it behind yourself.

Cellar
A decompression shelter and space for storage.

There is a secured hatch in the ceiling.

There is an emergency mask hanging on the wall.

>get mask
Taken.

>u
(first opening the ceiling hatch)
You pull yourself up through the hatch and close it behind yourself.

Home
The room where you've slept your entire life. You can go out towards the crops.

There is a secured hatch in the floor.

>out
Sector 4: Crops
Your home is here among the crops. You can walk spinward or antispinward.

* * *

>in
School
A broken learning machine remains in a corner, but mostly the older farmers took turns leading the class. There is a desk, and a chalkboard hangs on one wall.

On the desk is a clean eraser.

>get eraser
Taken.

* * *

>erase board
(with the eraser)
You carefully erase the chalkboard.

>scanner, open machine
Opening.

The learning machine swings open, revealing a power module and an instruction module.

[Your score has just gone up by five points.]

>get all from machine
power module: (putting the scanner into your pocket to make room)
Taken.
instruction module: (putting the emergency mask into your pocket to make room)
Taken.

>out
Sector 5: Forest
The school house is nestled among the trees. A pylon stretches up from the same grove to the hub of the station. You can walk spinward or antispinward.

* * *

>sw
You walk a little ways to the next sector.

Sector 6: Hydroponics
Your people preferred to grow things the old fashioned way, but in truth the majority of your fruit and vegetables came from this sector when the machines still worked. You can walk spinward or antispinward.

There is a secured hatch in the ground.

>d
(first opening the floor hatch)
You scramble down through the hatch and close it behind yourself.

Supply Vault
This room is dim, quiet, and stuffy. There is still a crate of machine parts left.

There is a secured hatch in the ceiling.

You can also see some pair of gravity boots here.

>search crate
You find an instruction module.
(putting the dusty eraser into your pocket to make room)

>g
You find a pressure regulation module.
(putting the power module into your pocket to make room)

>get boots
(putting the instruction module into your pocket to make room)
Taken.

>hit eraser
(first taking the dusty eraser)
(putting the instruction module into your pocket to make room)
You fill the vault with a cloud of dust and you can now see a laser beam scanning across the hatch.

>u
(first opening the ceiling hatch)
You maneuver around the laser beam.

You pull yourself up through the hatch and close it behind yourself.

Sector 6: Hydroponics
Your people preferred to grow things the old fashioned way, but in truth the majority of your fruit and vegetables came from this sector when the machines still worked. You can walk spinward or antispinward.

There is a secured hatch in the ground.

[Your score has just gone up by five points.]

>wear boots
You put on the pair of gravity boots.

* * *

>asw
You walk a little ways to the next sector.

Sector 3: Forest
Trees, a house, and a church. A red pylon stretches up from the ground to the hub of the station. You can walk spinward or antispinward.

>up
It isn't easy, but with the boots, you are able to climb towards the hub.

Center Platform
It's a mesh platform a little below the hub. You feel much lighter here, and you are very aware of how the station rotates, but everything is okay as long as you don't look down.

You can just reach a red circuit breaker on the hub.

>turn breaker on
You switch the red circuit breaker on.

[Your score has just gone up by five points.]

>d
You climb down the pylon.

Sector 3: Forest
Trees, a house, and a church. A red pylon stretches up from the ground to the hub of the station. You can walk spinward or antispinward.

>asw
You walk a little ways to the next sector.

Sector 2: Aquaculture
A deep pond is used as part of the water filtration system and for raising fish. You can walk spinward or antispinward.

>enter pond
With the air from the emergency mask, you breathe comfortably as you step into the pond. At the bottom, you find a green circuit breaker and flip it on.

[Your score has just gone up by ten points.]

>asw
You walk a little ways to the next sector.

Sector 1: Crops
You still maintain the crops here. There is a small graveyard and the barn remains from when this was the livestock sector. A pylon stretches up from the ground to the hub of the station. You can walk spinward or antispinward.

There is a secured hatch in the ground.

You have walked the entire ring. Everything is as expected, much is not working. Now, it's time to leave. The pods are below Sector 1.

>d
(first opening the floor hatch)
You scramble down through the hatch and close it behind yourself.

Pod Control
This room serves as an airlock for the pod bay, and holds an old space suit and various machinery such as the atmosphere pump. There is a brass plate on the wall.

There is a secured hatch in the ceiling.

Beside the secured port hatch, a status display shows an error message.

>scanner, open pump
Opening.

The atmosphere pump swings open, revealing a power module and a pressure regulation module.

>get all from pump
power module: Taken.
pressure regulation module: (putting the pressure regulation module into your pocket to make room)
Taken.

>scan regulator
Module is faulty.

* * *

>scan unscanned regulator
Module is functional.

>put functional regulator in pump
(first taking the functional pressure regulation module)
(putting the dusty eraser into your pocket to make room)
You put the functional pressure regulation module into the atmosphere pump.

>scan power module
Module is faulty.

* * *

>scan unscanned power module
Module is functional.

>put functional power module in pump
(first taking the functional power module)
You put the functional power module into the atmosphere pump.

>close pump
You close the atmosphere pump and it begins to hum.

It is time to say goodbye to the station. You are ready to leave in a pod.

[Your score has just gone up by five points.]

>port
(first opening the wall hatch)
You close the hatch behind yourself.

Pod Bay
There are four berths for transit pods. Sadly, all are empty.

A secured hatch leads starboard.

Someone left an emergency communications unit on the floor.

This is troubling. You counted. You were sure there would be one pod left. There are none.

[Your score has just gone up by ten points.]

>get communications unit
Taken.

>starboard
(first opening the wall hatch)
You close the hatch behind yourself.

Pod Control
This room serves as an airlock for the pod bay, and holds an old space suit and various machinery such as the atmosphere pump. There is a brass plate on the wall.

Beside the secured port hatch, a status display glows green.

There is a secured hatch in the ceiling.

>scanner, open pump
Opening.

The atmosphere pump swings open, revealing a functional power module and a functional pressure regulation module.

No pods left ... you consider despair.

>get functional power module
(putting the faulty power module into your pocket to make room)
Taken.

>u
(first opening the ceiling hatch)
You pull yourself up through the hatch and close it behind yourself.

Sector 1: Crops
You still maintain the crops here. There is a small graveyard and the barn remains from when this was the livestock sector. A pylon stretches up from the ground to the hub of the station. You can walk spinward or antispinward.

There is a secured hatch in the ground.

So what if you can't escape in a pod. You will just need to bring a pod here. Time to get the communications module working.

>sw
You walk a little ways to the next sector.

Sector 2: Aquaculture
A deep pond is used as part of the water filtration system and for raising fish. You can walk spinward or antispinward.

>sw
You walk a little ways to the next sector.

Sector 3: Forest
Trees, a house, and a church. A red pylon stretches up from the ground to the hub of the station. You can walk spinward or antispinward.

>go church
Church
Before everyone left or died, you celebrated every sabbath here. The altar stands against one wall, and an organ and an audio unit stand against the other.

On the altar is The Founder's Testament.

A gray cable connects the organ and the audio unit.

>unplug cable from organ
You unplug the gray cable from the organ.

* * *

>plug cable into comms unit
You plug the gray cable into the emergency communications unit.

>scanner, open audio
Opening.

The audio unit swings open, revealing an unscanned power module.

>get power module from audio
(putting the faulty pressure regulation module into your pocket to make room)
Taken.

>put functional power into audio
You put the functional power module into the audio unit.

>close audio
You close the audio unit and it seals without any trace of a seam.

The audio unit beeps and a synthesized voice says "Comms ready."

After a moment, it says "Launching automatic routines."

[Your score has just gone up by ten points.]

>z
Time passes.

You hear a human speaking from the audio unit: "RWSS Founder's Mercy, this is OV-4756, over...

"There's really somebody there? We thought your station had been abandoned for kilodays...

"Standby...

"We can have a pod there in about a thousand minutes."

    *** You are not alone. ***

In that game you scored 50 out of a possible 50, in 55 turns.

Would you like to RESTART, RESTORE a saved game, QUIT, or UNDO the last command?

* * *

>about
About Founder's Mercy
Founder's Mercy is my second released Inform project, conceived and implemented in November of 2018.

Thanks to Graham Nelson, Andrew Plotkin, Emily Short, and everyone else who contributed to the Inform and Glulx ecosystem. Thanks also to Eric Eve for the Exit Lister extension, Juhana Leinonen for the Object Response Tests extension, and Sean Turner for the Plugs and Sockets extension. The cover art is adapted from Figure 1.1 from NASA SP-413, Space Settlements: A Design Study, edited by Richard D. Johnson and Charles Holbrow, and available from The Internet Archive at https://archive.org/details/SpaceSettlementsADesignStudy1977 .

Please send your feedback, bug reports, and requests for help to tinsel@tinsel.org. You can always find the current version of this game at http://tinsel.org/IF/ .

This work is Copyright  2018 Thomas Insel but may be freely shared according to the terms of the Creative Commons Attribution 4.0 International license (https://creativecommons.org/licenses/by/4.0/).

>gonear learning
School
A broken learning machine remains in a corner, but mostly the older farmers took turns leading the class. There is a desk, and a chalkboard hangs on one wall.

On the desk is a clean eraser.

>x learning
This last learning machine broke when you were maybe three thousand days old.

>scanner, open learning
Opening.

The learning machine swings open, revealing a power module and an instruction module.

[Your score has just gone up by five points.]

>x learning
This last learning machine broke when you were maybe three thousand days old.
It is open, revealing a power module and an instruction module.

>x learning
This last learning machine broke when you were maybe three thousand days old.
It is open, revealing a power module and an instruction module.

>close learning
You close the learning machine and it seals without any trace of a seam.

>x learning
This last learning machine broke when you were maybe three thousand days old.

* * *

>action
That's not a verb I recognize.

>actions
Actions listing on.

>scan me with scanner
[scanning yourself with the scanner]
[(1) scanning yourself]
No modular technology detected.

[(1) scanning yourself - succeeded]

[scanning yourself with the scanner - succeeded]

>actions off
Actions listing off.

>scan me with scanner
No modular technology detected.

>scan me
No modular technology detected.

>scan
Syntax error: no target.

[You can ask the scanner for a list of commands by typing "scanner, help" and give it voice commands by typing phrases such as "scanner, scan SOMETHING" or "scanner, open SOMETHING" where SOMETHING is a visible object.]

>scan
Syntax error: no target.

* * *

>activities
That's not a verb I recognize.

>rules
Rules tracing now switched on. Type "rules off" to switch it off again, or "rules all" to include even rules which do not apply.

>z
[Rule "declare everything initially unmentioned rule" applies.]
[Rule "announce items from multiple object lists rule" applies.]
[Rule "set pronouns from items from multiple object lists rule" applies.]
[Rule "before stage rule" applies.]
[Rule "instead stage rule" applies.]
[Rule "investigate player's awareness before action rule" applies.]
[Rule "player aware of his own actions rule" applies.]
[Rule "check stage rule" applies.]
[Rule "carry out stage rule" applies.]
[Rule "after stage rule" applies.]
[Rule "investigate player's awareness after action rule" applies.]
[Rule "report stage rule" applies.]
[Rule "standard report waiting rule" applies.]
Time passes.
[Rule "last specific action-processing rule" applies.]

[Rule "A first turn sequence rule" applies.]
[Rule "every turn stage rule" applies.]
[Rule "Every turn" applies.]
[Rule "A last turn sequence rule" applies.]
[Rule "notify score changes rule" applies.]

* * *

>analyze me
examining yourself:
As virtuous as ever.

looking under yourself:
You find nothing of interest.

searching yourself:
You find nothing of interest.

listening to yourself:
You hear nothing unexpected.

smelling yourself:
You smell nothing unexpected.

attacking yourself:
Imperfect vessel that you are, that is not the answer.

buying yourself:
Nothing is on sale.

climbing yourself:
Little is to be achieved by that.

pulling yourself:
You might not like that.

pushing yourself:
You might not like that.

turning yourself:
You might not like that.

pushing yourself to outside:
You cannot be pushed from place to place.

opening yourself:
You aren't something you can open.

entering yourself:
You're not something you can enter.

getting off yourself:
But you aren't on yourself at the moment.

closing yourself:
You aren't something you can close.

taking yourself:
You are always self-possessed.

switching on yourself:
You aren't something you can switch.

switching off yourself:
You aren't something you can switch.

wearing yourself:
(first taking yourself)
You are always self-possessed.

taking off yourself:
You aren't wearing yourself.

throwing the scanner at yourself:
You lack the nerve when it comes to the crucial moment.

showing the scanner to yourself:
The handheld voice-activated scanner you use when working on the station's machines.

[You can ask the scanner for a list of commands by typing "scanner, help" and give it voice commands by typing phrases such as "scanner, scan SOMETHING" or "scanner, open SOMETHING" where SOMETHING is a visible object.]

giving the scanner to yourself:
You can't give the scanner to yourself.

waking yourself:
That seems unnecessary.

kissing yourself:
You don't get much from that.

touching yourself:
You achieve nothing by this.

rubbing yourself:
You rub yourself.

waving yourself:
But you aren't holding you.

squeezing yourself:
You might not like that.

burning yourself:
There is no open flame on the station.

cutting yourself:
Imperfect vessel that you are, that is not the answer.

tying yourself to the floor hatch:
You would achieve nothing by this.

swinging yourself:
There's nothing sensible to swing here.

tasting yourself:
You taste nothing unexpected.

drinking yourself:
There's nothing suitable to drink here.

eating yourself:
You're plainly inedible.

dropping yourself:
You lack the dexterity.

* * *

>ask scanner about me
Syntax error: command not in vocabulary.

[You can ask the scanner for a list of commands by typing "scanner, help" and give it voice commands by typing phrases such as "scanner, scan SOMETHING" or "scanner, open SOMETHING" where SOMETHING is a visible object.]

>ask scanner about jksdjfkljdlk
Syntax error: command not in vocabulary.

>ask scanner about scanner
Syntax error: command not in vocabulary.

>actions
Actions listing on.

>ask scanner about me
[asking the scanner about "me"]
Syntax error: command not in vocabulary.

[asking the scanner about "me" - failed]

>scan
[bare scanning]
Syntax error: no target.

[You can ask the scanner for a list of commands by typing "scanner, help" and give it voice commands by typing phrases such as "scanner, scan SOMETHING" or "scanner, open SOMETHING" where SOMETHING is a visible object.]

[bare scanning - succeeded]

>scan
[bare scanning]
Syntax error: no target.

[bare scanning - succeeded]

>scan
[bare scanning]
Syntax error: no target.

[bare scanning - succeeded]

>scan
[bare scanning]
Syntax error: no target.

[You can ask the scanner for a list of commands by typing "scanner, help" and give it voice commands by typing phrases such as "scanner, scan SOMETHING" or "scanner, open SOMETHING" where SOMETHING is a visible object.]

[bare scanning - succeeded]

* * *

>cut me
Imperfect vessel that you are, that is not the answer.

>attack hatch
The Founder said that violence is never the answer.

>cut hatch
The Founder said that violence is never the answer.

>purloin eraser
[Purloined.]

>hit eraser
Nothing happens.

* * *

>d
(first opening the floor hatch)
You scramble down through the hatch and close it behind yourself.

Cellar
A decompression shelter and space for storage.

There is a secured hatch in the ceiling.

There is an emergency mask hanging on the wall.

>scanner, scan mask
Machine is functional.

>drop scanner
Dropped.

>scanner, scan mask
You must be carrying the scanner to use it.

>scan mask
You must be carrying the scanner to use it.

>get scanner
Taken.

>can mask
That's not a verb I recognize.

>scan mask
No modular technology detected.

* * *

>drop scanner
Dropped.

>scan hatch with scanner
No modular technology detected.

>scan hatch
You must be carrying the scanner to use it.

* * *

>drop scanner
Dropped.

>scanner, help
You must be carrying the scanner to use it.

You must be carrying the scanner to use it.

>scanner, scan
You must be carrying the scanner to use it.

You must be carrying the scanner to use it.

>san
That's not a verb I recognize.

>scan
You must be carrying the scanner to use it.

>sanner, open hatch
You seem to want to talk to someone, but I can't see whom.

>scanner, open hatch
You must be carrying the scanner to use it.

You must be carrying the scanner to use it.

* * *

>e
You have heard of compass directions like east, but they don't make any sense here. Instead, you can go spinward, antispinward, port, and starboard. When you look spinward, port is left and starboard is right.

[You can use the abbreviations "sw", "asw", "p", and "s". You can also go "up", "down", "in", and "out" where appropriate. Type "exits" if you get confused about geography.]

>e
You have heard of compass directions like east, but they don't make any sense here. Instead, you can go spinward, antispinward, port, and starboard. When you look spinward, port is left and starboard is right.

>w
You have heard of compass directions like west, but they don't make any sense here. Instead, you can go spinward, antispinward, port, and starboard. When you look spinward, port is left and starboard is right.

>se
You have heard of compass directions like southeast, but they don't make any sense here. Instead, you can go spinward, antispinward, port, and starboard. When you look spinward, port is left and starboard is right.

>s
You can't go that way. The obvious exits are down and outside.

>sw
You can't go that way. The obvious exits are down and outside.

>asw
You can't go that way. The obvious exits are down and outside.

>port
You can't go that way. The obvious exits are down and outside.

>out
Sector 4: Crops
Your home is here among the crops. You can walk spinward or antispinward.

>p
You can't go that way. The obvious exits are inside (to home), spinward and antispinward.

* * *

>exits
The obvious exits are down and outside.

[Type "exits off" to disable the status line exit list and "exits on" to turn it back on.]

>scanner, help
Recognized commands are "help", "open", and "scan".

[You can ask the scanner for a list of commands by typing "scanner, help" and give it voice commands by typing phrases such as "scanner, scan SOMETHING" or "scanner, open SOMETHING" where SOMETHING is a visible object.]

* * *

>g
Recognized commands are "help", "open", and "scan".

[You can ask the scanner for a list of commands by typing "scanner, help" and give it voice commands by typing phrases such as "scanner, scan SOMETHING" or "scanner, open SOMETHING" where SOMETHING is a visible object.]

>scanner, look
Syntax error: command not in vocabulary.

>n
You have heard of compass directions like north, but they don't make any sense here. Instead, you can go spinward, antispinward, port, and starboard. When you look spinward, port is left and starboard is right.

[You can use the abbreviations "sw", "asw", "p", and "s". You can also go "up", "down", "in", and "out" where appropriate. Type "exits" if you get confused about geography.]

>b
That's not a verb I recognize.

* * *

>f
That's not a verb I recognize.

>d
(first opening the floor hatch)
You scramble down through the hatch and close it behind yourself.

Cellar
A decompression shelter and space for storage.

There is a secured hatch in the ceiling.

There is an emergency mask hanging on the wall.

>scan mask
Machine is functional.

>scanner, scan mask
Machine is functional.

>gonear audio
Church
Before everyone left or died, you celebrated every sabbath here. The altar stands against one wall, and an organ and an audio unit stand against the other.

On the altar is The Founder's Testament.

A gray cable connects the organ and the audio unit.

>scan audio
Machine failed.

>scanner, scan audio
Machine is failed.

>san
That's not a verb I recognize.

>scan
Syntax error: no target.

[You can ask the scanner for a list of commands by typing "scanner, help" and give it voice commands by typing phrases such as "scanner, scan SOMETHING" or "scanner, open SOMETHING" where SOMETHING is a visible object.]

>scanner, scan
Syntax error: no target.

>g
Syntax error: no target.

* * *

>g
Syntax error: no target.

[You can ask the scanner for a list of commands by typing "scanner, help" and give it voice commands by typing phrases such as "scanner, scan SOMETHING" or "scanner, open SOMETHING" where SOMETHING is a visible object.]

>out
Sector 3: Forest
Trees, a house, and a church. A red pylon stretches up from the ground to the hub of the station. You can walk spinward or antispinward.

>scan hub
No modular (2) technology detected.

>scanner, scan hub
No modular (2) technology detected.

>scan solar
Machine is functional. Operating at 73% efficiency.

>scanner, scan solar
No modular (2) technology detected.

* * *

>get eraser
You can't see any such thing.

>gonear eraser
School
A broken learning machine remains in a corner, but mostly the older farmers took turns leading the class. There is a desk, and a chalkboard hangs on one wall.

On the desk is a clean eraser.

>get it
That's hardly portable.

* * *

>erase board
(with the eraser)
You carefully erase the chalkboard.

>gonear boots
Supply Vault
This room is dim, quiet, and stuffy. There is still a crate of machine parts left.

There is a secured hatch in the ceiling.

You can also see some pair of gravity boots here.

>hit eraser
You fill the vault with a cloud of dust and you can now see a laser beam scanning across the hatch.

>z
Time passes.

>z
Time passes.

The cloud of dust finally dissipates.

>hit eraser
You fill the vault with a cloud of dust and you can now see a laser beam scanning across the hatch.

* * *

>z
Time passes.

>hit eraser
You add to the cloud of dust.

>z
Time passes.

>u
You maneuver around the laser beam.

(first opening the ceiling hatch)
You pull yourself up through the hatch and close it behind yourself.

Sector 6: Hydroponics
Your people preferred to grow things the old fashioned way, but in truth the majority of your fruit and vegetables came from this sector when the machines still worked. You can walk spinward or antispinward.

There is a secured hatch in the ground.

>d
(first opening the floor hatch)
You scramble down through the hatch and close it behind yourself.

Supply Vault
This room is dim, quiet, and stuffy. There is still a crate of machine parts left.

There is a secured hatch in the ceiling.

You can also see some pair of gravity boots here.

* * *

>gonear audio
Church
Before everyone left or died, you celebrated every sabbath here. The altar stands against one wall, and an organ and an audio unit stand against the other.

On the altar is The Founder's Testament.

A gray cable connects the organ and the audio unit.

>gonear audio
Church
Before everyone left or died, you celebrated every sabbath here. The altar stands against one wall, and an organ and an audio unit stand against the other.

On the altar is The Founder's Testament.

A gray cable connects the organ and the audio unit.

>purloin all power
[Purloined.]
[Purloined.]
[Purloined.]

>put power in audio
The audio unit is closed.

>scanner, open audio
Opening.

The audio unit swings open, revealing space for one module.

>put scanner in audio
Only modules fit into the audio unit.

>i
You are carrying:
  three power modules
  a scanner
  a green jumpsuit (being worn)

>close scanner
It isn't something you can close.

>close audio
You close the audio unit and it seals without any trace of a seam.

>put scanner into audio
The audio unit is closed.

>get grey
(putting the scanner into your pocket to make room)
You're carrying too many things already.

>i
You are carrying:
  three power modules
  a green jumpsuit (being worn)

Your jumpsuit pocket contains:
  a scanner

>get grey
(putting the power module into your pocket to make room)
Taken.

>undo
Church
[Previous turn undone.]

>i
You are carrying:
  three power modules
  a green jumpsuit (being worn)

Your jumpsuit pocket contains:
  a scanner

>drop all
power module: Dropped.
power module: Dropped.
power module: Dropped.

>get all
power module: Taken.
power module: Taken.
power module: Taken.
gray cable: (putting the power module into your pocket to make room)
Taken.
Founder's Testament: (putting the power module into your pocket to make room)
Taken.

>i
You are carrying:
  The Founder's Testament
  a gray cable (plugged into the organ and an audio unit)
  a power module
  a green jumpsuit (being worn)

Your jumpsuit pocket contains:
  two power modules
  a scanner

>unplug gray from audio
You unplug the gray cable from the audio unit.

>put gray into audio
You plug the gray cable into the audio unit.

* * *

>gonear audio
Church
Before everyone left or died, you celebrated every sabbath here. The altar stands against one wall, and an organ and an audio unit stand against the other.

On the altar is The Founder's Testament.

A gray cable connects the organ and the audio unit.

>open audio with scanner
Opening.

The audio unit swings open, revealing a power module.

* * *

>gonear audio
Church
Before everyone left or died, you celebrated every sabbath here. The altar stands against one wall, and an organ and an audio unit stand against the other.

On the altar is The Founder's Testament.

A gray cable connects the organ and the audio unit.

>scanaudio
That's not a verb I recognize.

>scan audio
Machine failed.

>scanner, scan audio
Machine failed.

>scan organ
Machine functional. No output available.

>scanner, scan organ
Machine functional. No output available.

>scanner, scan cable
Cable is functional.

* * *

>gonear audio
Church
Before everyone left or died, you celebrated every sabbath here. The altar stands against one wall, and an organ and an audio unit stand against the other.

On the altar is The Founder's Testament.

A gray cable connects the organ and the audio unit.

>scanner, open audio
Opening.

The audio unit swings open, revealing a power module.

>scanner, scan power
Module is faulty.

>close audio
You close the audio unit and it seals without any trace of a seam.

>open audio with scanner
That doesn't seem to be something you can unlock.

* * *

>gonear barn
(the Barn)
Barn
Not fancy: livestock on one side and feed on the other, but nothing remains of either.

>out
Sector 1: Crops
You still maintain the crops here. There is a small graveyard and the barn remains from when this was the livestock sector. A pylon stretches up from the ground to the hub of the station. You can walk spinward or antispinward.

There is a secured hatch in the ground.

>x barn
A single story barn.

>drop barn
The barn is already here.

>gonear crate
Supply Vault
This room is dim, quiet, and stuffy. There is still a crate of machine parts left.

There is a secured hatch in the ceiling.

You can also see some pair of gravity boots here.

>x crate
These remaining parts never seem to fit anywhere useful, but Founder only knows what's in there.

>x crate
These remaining parts never seem to fit anywhere useful, but Founder only knows what's in there.

* * *

>search crate
You find a pressure regulation module.

>g
You find an instruction module.

>g
Many miscellaneous parts, few useful.

>g
Many miscellaneous parts, few useful.

>i
You are carrying:
  an instruction module
  a pressure regulation module
  a scanner
  a green jumpsuit (being worn)

>put scanner in pocket
You put the scanner into the pocket.

>drop crate
The crate of machine parts is already here.

* * *

>gonear berths
Pod Bay
There are four berths for transit pods. Sadly, all are empty.

A secured hatch leads starboard.

Someone left an emergency communications unit on the floor.

This is troubling. You counted. You were sure there would be one pod left. There are none.

[Your score has just gone up by ten points.]

>scanner ,open berths
Opening failed. Safety violation.

>scanner, open berths
Opening failed. Safety violation.

>starboard
(first opening the wall hatch)
It seems to be locked.

No pods left ... you consider despair.

>scenes
Scene 'Entire Game' playing (for 4 mins now)
Scene 'Beginning' playing (for 4 mins now)
Scene 'Repairing Comms' playing (for 4 mins now)
(Scene monitoring now switched on. Type "scenes off" to switch it off again.)

* * *

>gonear boots
Supply Vault
This room is dim, quiet, and stuffy. There is still a crate of machine parts left.

There is a secured hatch in the ceiling.

You can also see some pair of gravity boots here.

>get boots
Taken.

>open hatch
An alarm sounds, and a synthesized voice says "Laser scan detects unauthorized materiel removal."

The hatch seems to be locked.

* * *

>drop boots
Dropped.

>gonear eraser
School
A broken learning machine remains in a corner, but mostly the older farmers took turns leading the class. There is a desk, and a chalkboard hangs on one wall.

On the desk is a clean eraser.

>get eraser
Taken.

* * *

>hit eraser
You fill the vault with a cloud of dust and you can now see a laser beam scanning across the hatch.

>open hatch
You maneuver around the laser beam!

You open the ceiling hatch.

>close it
You close the ceiling hatch.

>get boots
Taken.

>u
You maneuver around the laser beam.

(first opening the ceiling hatch)
You maneuver around the laser beam!

You pull yourself up through the hatch and close it behind yourself.

Sector 6: Hydroponics
Your people preferred to grow things the old fashioned way, but in truth the majority of your fruit and vegetables came from this sector when the machines still worked. You can walk spinward or antispinward.

There is a secured hatch in the ground.

[Your score has just gone up by five points.]

* * *

>get boots
Taken.

>u
An alarm sounds, and a synthesized voice says "Laser scan detects unauthorized materiel removal." The hatch seems to be locked.

>gonear eraser
School
A broken learning machine remains in a corner, but mostly the older farmers took turns leading the class. There is a desk, and a chalkboard hangs on one wall.

On the desk is a clean eraser.

* * *

>erase board
(with the eraser)
You carefully erase the chalkboard.

>gonear boots
School
A broken learning machine remains in a corner, but mostly the older farmers took turns leading the class. There is a desk, and a chalkboard hangs on one wall.

>gonear crate
Supply Vault
This room is dim, quiet, and stuffy. There is still a crate of machine parts left.

There is a secured hatch in the ceiling.

>u
An alarm sounds, and a synthesized voice says "Laser scan detects unauthorized materiel removal." The hatch seems to be locked.

>hit eraser
You fill the vault with a cloud of dust and you can now see a laser beam scanning across the hatch.

>touch beam
An alarm sounds, and a synthesized voice says "Laser scan detects unauthorized materiel removal."

* * *

>gonear boots
School
A broken learning machine remains in a corner, but mostly the older farmers took turns leading the class. There is a desk, and a chalkboard hangs on one wall.

>hit eraser
You fill the area with a cloud of dust, which quickly clears.

>get boots
(putting the scanner into your pocket to make room)
You already have those.

>touch beam
You can't see any such thing.

>touch laser
You can't see any such thing.

>gonear crate
Supply Vault
This room is dim, quiet, and stuffy. There is still a crate of machine parts left.

There is a secured hatch in the ceiling.

* * *

>hit eraser
You fill the vault with a cloud of dust and you can now see a laser beam scanning across the hatch.

>touch beam
The laser beam is intangible.

I beg your pardon?

* * *

>gonear boots
Supply Vault
This room is dim, quiet, and stuffy. There is still a crate of machine parts left.

There is a secured hatch in the ceiling.

You can also see some pair of gravity boots here.

>look at boots
Black work boots with red stripes. They don't really make gravity, but they do stick to some maintenance walkways to help workers get around in low gravity or on the outside of a rotating station.

>search crate
You find a pressure regulation module.

* * *

>gonear boots
Supply Vault
This room is dim, quiet, and stuffy. There is still a crate of machine parts left.

There is a secured hatch in the ceiling.

You can also see some pair of gravity boots here.

>look in crate
You find a pressure regulation module.

>g
You find an instruction module.

>g
Many miscellaneous parts, none useful.

>x regulation
It is a standardized pressure regulation module.

>showme regulation
pressure regulation module - pressure regulation module
location: carried by yourself in Supply Vault
singular-named, improper-named; unlit, inedible, portable, handled
list grouping key: none
printed name: "pressure regulation module"
printed plural name: "pressure regulation modules"
indefinite article: none
description: none
initial appearance: none
status: functional

* * *

>gonear boots
Supply Vault
This room is dim, quiet, and stuffy. There is still a crate of machine parts left.

There is a secured hatch in the ceiling.

You can also see some pair of gravity boots here.

>open hatch
You open the ceiling hatch.

>close hatch
You close the ceiling hatch.

>u
(first opening the ceiling hatch)
You pull yourself up through the hatch and close it behind yourself.

Sector 6: Hydroponics
Your people preferred to grow things the old fashioned way, but in truth the majority of your fruit and vegetables came from this sector when the machines still worked. You can walk spinward or antispinward.

There is a secured hatch in the ground.

>d
(first opening the floor hatch)
You scramble down through the hatch and close it behind yourself.

Supply Vault
This room is dim, quiet, and stuffy. There is still a crate of machine parts left.

There is a secured hatch in the ceiling.

You can also see some pair of gravity boots here.

>get boots
Taken.

* * *

>drop boots
Dropped.

>pen hatch
That's not a verb I recognize.

>open hatch
You open the ceiling hatch.

* * *

>open hatch
That's already open.

>u
An alarm sounds, the hatch slams shut, and a synthesized voice says "Laser scan detects unauthorized materiel removal."

The hatch seems to be locked.

>gonear hydroponics
Sector 6: Hydroponics
Your people preferred to grow things the old fashioned way, but in truth the majority of your fruit and vegetables came from this sector when the machines still worked. You can walk spinward or antispinward.

There is a secured hatch in the ground.

[Your score has just gone up by five points.]

>x hatch
You have been well-trained, because the hatch in the ground is secured shut.

>close hatch
That's already closed.

>open hatch
You open the floor hatch.

>d
You scramble down through the hatch and close it behind yourself.

Supply Vault
This room is dim, quiet, and stuffy. There is still a crate of machine parts left.

There is a secured hatch in the ceiling.

>u
An alarm sounds, and a synthesized voice says "Laser scan detects unauthorized materiel removal."

The hatch seems to be locked.

>gonear barn
(the Barn)
Barn
Not fancy: livestock on one side and feed on the other, but nothing remains of either.

>look
Barn
Not fancy: livestock on one side and feed on the other, but nothing remains of either.

>out
Sector 1: Crops
You still maintain the crops here. There is a small graveyard and the barn remains from when this was the livestock sector. A pylon stretches up from the ground to the hub of the station. You can walk spinward or antispinward.

There is a secured hatch in the ground.

* * *

>x barn
A single story barn.

>drop barn
S1B1 is already here.

* * *

>gonear boots
Supply Vault
This room is dim, quiet, and stuffy. There is still a crate of machine parts left.

There is a secured hatch in the ceiling.

You can also see some pair of gravity boots here.

>purloin boots
[Purloined.]

>u
An alarm sounds, and a synthesized voice says "Laser scan detects unauthorized materiel removal."

The hatch seems to be locked.

* * *

>gonear boots
Supply Vault
This room is dim, quiet, and stuffy. There is still a crate of machine parts left.

There is a secured hatch in the ceiling.

You can also see some pair of gravity boots here.

>purloin eraser
[Purloined.]

* * *

>hit eraser
Nothing happens.

>gonear board
School
A broken learning machine remains in a corner, but mostly the older farmers took turns leading the class. There is a desk, and a chalkboard hangs on one wall.

>erase board
(with the eraser)
You carefully erase the chalkboard.

* * *

>hit eraser
You fill the vault with a cloud of dust and you can now see a laser beam scanning across the hatch.

>g
You fill the vault with a cloud of dust and you can now see a laser beam scanning across the hatch.

>z
Time passes.

* * *

>hit eraser
You fill the vault with a cloud of dust and you can now see a laser beam scanning across the hatch.

>get boots
Taken.

>u
You maneuver around the laser beam.

(first opening the ceiling hatch)
You pull yourself up through the hatch and close it behind yourself.

Sector 6: Hydroponics
Your people preferred to grow things the old fashioned way, but in truth the majority of your fruit and vegetables came from this sector when the machines still worked. You can walk spinward or antispinward.

There is a secured hatch in the ground.

[Your score has just gone up by five points.]

* * *

>gonear boots
Supply Vault
This room is dim, quiet, and stuffy. There is still a crate of machine parts left.

There is a secured hatch in the ceiling.

You can also see some pair of gravity boots here.

>x beam
The cloud of dust scatters the laser beam just enough that you can see it scan across the north passageway at seemingly random angles.

* * *

>gonear boots
Supply Vault
This room is dim, quiet, and stuffy. There is still a crate of machine parts left.

There is a secured hatch in the ceiling.

You can also see some pair of gravity boots here.

>x crate
These remaining parts never seem to fit anywhere useful, but Founder only knows what's in there.

* * *

>g
You find an instruction module.

>g
Miscellaneous parts, none useful.

>i
You are carrying:
  an instruction module
  a pressure regulation module
  a scanner
  a green jumpsuit (being worn)

>put scanner in crate
You put the scanner into the crate of machine parts.

>x crate
These remaining parts never seem to fit anywhere useful, but Founder only knows what's in there.

>search crate
You find a scanner.

>g
Miscellaneous parts, none useful.

>look through crate
Miscellaneous parts, none useful.

* * *

>gonear comms
Pod Bay
There are four berths for transit pods. Sadly, all are empty.

A secured hatch leads starboard.

Someone left an emergency communications unit on the floor.

This is troubling. You counted. You were sure there would be one pod left. There are none.

[Your score has just gone up by ten points.]

>ne
You have heard of compass directions like northeast, but they don't make any sense here. Instead, you can go spinward, antispinward, port, and starboard. When you look spinward, port is left and starboard is right.

[You can use the abbreviations "sw", "asw", "p", and "s". You can also go "up", "down", "in", and "out" where appropriate. Type "exits" if you get confused about geography.]

>sw
You can't go that way. The only obvious exit is starboard.

>sw
You can't go that way. The only obvious exit is starboard.

No pods left ... you consider despair.

>sb
That's not a verb I recognize.

* * *

>gonear comms
Pod Bay
There are four berths for transit pods. Sadly, all are empty.

A secured hatch leads starboard.

Someone left an emergency communications unit on the floor.

This is troubling. You counted. You were sure there would be one pod left. There are none.

[Your score has just gone up by ten points.]

>out
(first opening the wall hatch)
It seems to be locked.

>out
(first opening the wall hatch)
It seems to be locked.

>go out
(first opening the wall hatch)
It seems to be locked.

No pods left ... you consider despair.

>g
(first opening the wall hatch)
It seems to be locked.

>g
(first opening the wall hatch)
It seems to be locked.

So what if you can't escape in a pod. You will just need to bring a pod here. Time to get the communications module working.

>g
(first opening the wall hatch)
It seems to be locked.

>g
(first opening the wall hatch)
It seems to be locked.

* * *

>gonear crate
Supply Vault
This room is dim, quiet, and stuffy. There is still a crate of machine parts left.

There is a secured hatch in the ceiling.

You can also see some pair of gravity boots here.

>get crate
That's just junk.

>look under crate
That's just junk.

* * *

>gonear crate
Supply Vault
This room is dim, quiet, and stuffy. There is still a crate of machine parts left.

There is a secured hatch in the ceiling.

You can also see some pair of gravity boots here.

>i
You are carrying:
  a scanner
  a green jumpsuit (being worn)

>put scanner in crate
You put the scanner into the crate of machine parts.

* * *

>x crate
These remaining parts never seem to fit anywhere useful, but Founder only knows what's in there.

>howme crate
That's not a verb I recognize.

>showme crate
crate of machine parts - thing
location: in Supply Vault
singular-named, improper-named; unlit, inedible, fixed in place, scenery
list grouping key: none
printed name: "crate of machine parts"
printed plural name: none
indefinite article: none
description: "These remaining parts never seem to fit anywhere useful, but Founder only knows what's in there."
initial appearance: none

>search crate
You find a pressure regulation module.

>g
You find a scanner.

>g
You find an instruction module.

* * *

>g
Many miscellaneous parts, none useful.

>i
You are carrying:
  an instruction module
  a scanner
  a pressure regulation module
  a green jumpsuit (being worn)

* * *

>gonear crate
Supply Vault
This room is dim, quiet, and stuffy. There is still a crate of machine parts left.

There is a secured hatch in the ceiling.

You can also see some pair of gravity boots here.

>x crate
These remaining parts never seem to fit anywhere be useful, but Founder only knows what's in there.

>look under crate
The crate rests firmly on the ground.

>search crate
You find a pressure regulation module.

>look in crate
You find an instruction module.

>look in crate
Many miscellaneous parts, none useful.

>version
Founder's Mercy
A Space Story by Thomas Insel
Release 1 / Serial number 181125 / Inform 7 build 6M62 (I6/v6.33 lib 6/12N) SD
Type "about" for credits or "hint" for assistance.
Identification number: //BCC61E7F-CE8E-4C25-9E9D-5550D1138D8C//
Interpreter version 0.5.2 / VM 3.1.2 / Library serial number 080126
Standard Rules version 3/120430 by Graham Nelson
Unicode Character Names by Graham Nelson
Exit Lister version 11 by Eric Eve
Plugs and Sockets version 4 by Sean Turner
Object Response Tests version 7 by Juhana Leinonen

* * *

>x crate
These remaining parts never seem to fit anywhere be useful, but Founder only knows what's in there.

>take crate
That's hardly portable.

>look under crate
You find nothing of interest.

>actions
Actions listing on.

>look under crate
[looking under the crate of machine parts]
You find nothing of interest.

[looking under the crate of machine parts - succeeded]

* * *

>gonear dispaly
There seems to be no such object anywhere in the model world.

>gonear display
Pod Control
This room serves as an airlock for the pod bay, and holds an old space suit and various machinery such as the atmosphere pump. There is a brass plaque on the wall.

There is a secured hatch in the ceiling.

Beside the secured port hatch, a status display shows an error message.

>x display
Pod bay locked down

Telemetry sensor array offline - reset breaker FM36-87/A @ hub platform

Launch system cooling loop offline - reset circuit breaker FM29-63/A @ Sector 2

Pod control atmosphere pump offline - scan and repair

* * *

>gonear display
Pod Control
This room serves as an airlock for the pod bay, and holds an old space suit and various machinery such as the atmosphere pump. There is a brass plaque on the wall.

There is a secured hatch in the ceiling.

Beside the secured port hatch, a status display shows an error message.

>gonear red
(the red circuit breaker)
Center Platform
It's a mesh platform a little below the hub. You feel much lighter here, and you are very aware of how the station rotates, but everything is okay as long as you don't look down.

You can just reach a red circuit breaker on the hub.

>turn red on
You switch the red circuit breaker on.

[Your score has just gone up by five points.]

>gonear pool
Sector 2: Aquaculture
A deep pond is used as part of the water filtration system and for raising fish. You can walk spinward or antispinward.

>purloin mask
[Purloined.]

* * *

>wear mask
You put on the emergency mask.

>go water
With the air from the emergency mask, you breathe comfortably as you step into the pond. At the bottom, you find a green circuit breaker and flip it on.

[Your score has just gone up by ten points.]

>gonear display
Pod Control
This room serves as an airlock for the pod bay, and holds an old space suit and various machinery such as the atmosphere pump. There is a brass plaque on the wall.

There is a secured hatch in the ceiling.

Beside the secured port hatch, a status display shows an error message.

>port
(first opening the wall hatch)
It seems to be locked.

>x display
Pod bay locked down
 1. Pod control atmosphere pump offline - scan and repair

>hint
Your objective is simply to leave the station and find other people.

Now might be a good time to try out the scanner.

By the way, it should be impossible to put this game into an unwinnable state, so feel free to explore and experiment.

If you are having trouble getting started, I suggest reading A Beginner's Guide to Interactive Fiction by Stephen Granade and Emily Short, available at:

  https://brasslantern.org/players/howto/beginnersguide.html

[You can type "hint" any time for contextual assistance. If you prefer not to be tempted, you can type "hints off" to disable hints.]

>hint
Now might be a good time to try out the scanner.

>scan machine
Machine is failed.

>hint
Scanning isn't the only thing that the scanner can do.

>scanner, open machine
Opening.

The atmosphere pump swings open.

>hint
You can also scan modules.

>purloin all modules
[Purloined.]
[Purloined.]
[Purloined.]
[Purloined.]
[Purloined.]
[Purloined.]
[Purloined.]

>scan power
Component is functional.

>i
You are carrying:
  two unscanned pressure regulation modules
  two unscanned instruction modules
  a functional power module
  two unscanned power modules
  an emergency mask (being worn)
  a scanner
  a green jumpsuit (being worn)

>put functional power in machine
You put the functional power module into the atmosphere pump.

>port
(first opening the wall hatch)
It seems to be locked.

>scan pressure
Component is functional.

>put functional pressure in machine
You put the functional pressure regulation module into the atmosphere pump.

>i
You are carrying:
  two unscanned instruction modules
  two unscanned power modules
  an unscanned pressure regulation module
  an emergency mask (being worn)
  a scanner
  a green jumpsuit (being worn)

>port
(first opening the wall hatch)
It seems to be locked.

>close machine
You close the atmosphere pump and it begins to hum.

It is time to say goodbye to the station. You are ready to leave in a pod.

[Your score has just gone up by five points.]

>port
(first opening the wall hatch)
You close the hatch behind yourself.

Pod Bay
There are four berths for transit pods. Sadly, all are empty.

A secured hatch leads starboard.

Someone left an emergency communications unit on the floor.

This is troubling. You counted. You were sure there would be one pod left. There are none.

[Your score has just gone up by ten points.]

* * *

>gonear display
Pod Control
This room serves as an airlock for the pod bay, and holds an old space suit and various machinery such as the atmosphere pump. There is a brass plaque on the wall.

There is a secured hatch in the ceiling.

Beside the secured port hatch, a status display shows an error message.

>hint
Your objective is simply to leave the station and find other people.

You need to repair some things. Check out the status display in Pod Control.

By the way, it should be impossible to put this game into an unwinnable state, so feel free to explore and experiment.

If you are having trouble getting started, I suggest reading A Beginner's Guide to Interactive Fiction by Stephen Granade and Emily Short, available at:

  https://brasslantern.org/players/howto/beginnersguide.html

[You can type "hint" any time for contextual assistance. If you prefer not to be tempted, you can type "hints off" to disable hints.]

>g
You need to repair some things. Check out the status display in Pod Control.

>hint
You need to repair some things. Check out the status display in Pod Control.

>x display
Pod bay locked down
 1. Telemetry sensor array offline - reset breaker FM36-87/A @ hub platform
 2. Launch system cooling loop offline - reset breaker FM29-63/A @ Sector 2
 3. Pod control atmosphere pump offline - scan and repair

>hint
You need to make three repairs, so you get three hints:

   Explore a bit more.
   Reset a circuit breaker somewhere in Sector 2.
   Now might be a good time to try out the scanner.

>gonear boots
Supply Vault
This room is dim, quiet, and stuffy. There is still a crate of machine parts left.

There is a secured hatch in the ceiling.

You can also see some pair of gravity boots here.

>hint
You need to make three repairs, so you get three hints:

   You have seen what you need to reach the circuit breaker.
   Reset a circuit breaker somewhere in Sector 2.
   Now might be a good time to try out the scanner.

>gonear boots
Supply Vault
This room is dim, quiet, and stuffy. There is still a crate of machine parts left.

There is a secured hatch in the ceiling.

You can also see some pair of gravity boots here.

* * *

>u
An alarm sounds, and a synthesized voice says "Laser scan detects unauthorized materiel removal."

The hatch seems to be locked.

>hint
You need to make three repairs, so you get three hints:

   You need to evade the alarm, but first explore a bit more.
   Reset a circuit breaker somewhere in Sector 2.
   Now might be a good time to try out the scanner.

>gonear eraser
School
A broken learning machine remains in a corner, but mostly the older farmers took turns leading the class. There is a desk, and a chalkboard hangs on one wall.

On the desk is a clean eraser.

>hint
You need to make three repairs, so you get three hints:

   You have found what you need to evade the alarm, but it still needs some preparation.
   Reset a circuit breaker somewhere in Sector 2.
   Now might be a good time to try out the scanner.

>get eraser
Taken.

* * *

>erase board
(with the eraser)
You carefully erase the chalkboard.

>hint
You need to make three repairs, so you get three hints:

   You have completed the necessary preparation to avoid the alarm.
   Reset a circuit breaker somewhere in Sector 2.
   Now might be a good time to try out the scanner.

>hit eraser
You fill the area with a cloud of dust, which quickly clears.

>hint
You need to make three repairs, so you get three hints:

   You seem to have figured out the trick to avoiding the alarm.
   Reset a circuit breaker somewhere in Sector 2.
   Now might be a good time to try out the scanner.

* * *

>gonear display
Pod Control
This room serves as an airlock for the pod bay, and holds an old space suit and various machinery such as the atmosphere pump. There is a brass plaque on the wall.

There is a secured hatch in the ceiling.

Beside the secured port hatch, a status display shows an error message.

>read display
Pod bay locked down
Diagnosis: telemetry sensor array offline
Remediation: reset breaker FM36-87/A @ hub platform

>wait 10 minutes
I only understood you as far as wanting to wait.

>z
Time passes.

>help
According the the status display, you need to reset a circuit breaker on the hub platform.

By the way, it should be impossible to put this game into an unwinnable state, so feel free to explore and experiment.

If you are having trouble getting started, I suggest reading A Beginner's Guide to Interactive Fiction by Stephen Granade and Emily Short, available at:

  https://brasslantern.org/players/howto/beginnersguide.html

[If you prefer not to be tempted by further hints, you can type "hints off" to disable them.]

>help
According the the status display, you need to reset a circuit breaker on the hub platform.

>z
Time passes.

* * *

I beg your pardon?

>z
Time passes.

>z.z.z.z.z.z
Time passes.

Time passes.

Time passes.

Time passes.

Time passes.

Time passes.

>scenes
Scene 'Entire Game' playing (for 19 mins now)
Scene 'Beginning' ended
Scene 'Repairing Pod Bay' playing (for 19 mins now)
Scene 'Repairing Red Breaker' playing (for 19 mins now)
Scene 'Repairing Green Breaker' playing (for 19 mins now)
Scene 'Repairing Atmosphere Pump' playing (for 19 mins now)
(Scene monitoring now switched on. Type "scenes off" to switch it off again.)

>help
According the the status display, you need to reset a circuit breaker on the hub platform.

* * *

>z
Time passes.

>help
According the the status display, you need to reset a circuit breaker on the hub platform.

A

>z
Time passes.

>gonear red
(the red circuit breaker)
Center Platform
It's a mesh platform a little below the hub. You feel much lighter here, and you are very aware of how the station rotates, but everything is okay as long as you don't look down.

You can just reach a red circuit breaker on the hub.

>help
According the the status display, you need to reset a circuit breaker on the hub platform.

* * *

>gonear display
Pod Control
This room serves as an airlock for the pod bay, and holds an old space suit and various machinery such as the atmosphere pump. There is a brass plaque on the wall.

There is a secured hatch in the ceiling.

Beside the secured port hatch, a status display shows an error message.

>x displa
You can't see any such thing.

>x display
Pod bay locked down
 1. Telemetry sensor array offline - reset breaker FM36-87/A @ hub platform
 2. Launch system cooling loop offline - reset breaker FM29-63/A @ Sector 2
 3. Pod control atmosphere pump offline - scan and repair

>help
You need to repair three things:

 1. Explore a bit more.

 2. Reset a circuit breaker somewhere in Sector 2.

 3. Now might be a good time to try out the scanner.

By the way, it should be impossible to put this game into an unwinnable state, so feel free to explore and experiment.

If you are having trouble getting started, I suggest reading A Beginner's Guide to Interactive Fiction by Stephen Granade and Emily Short, available at:

  https://brasslantern.org/players/howto/beginnersguide.html

[If you prefer not to be tempted by further hints, you can type "hints off" to disable them.]

>help
You need to repair three things:

 1. Explore a bit more.

 2. Reset a circuit breaker somewhere in Sector 2.

 3. Now might be a good time to try out the scanner.

>scan display
Machine is functional.

>hint
You need to repair three things:

 1. Explore a bit more.

 2. Reset a circuit breaker somewhere in Sector 2.

 3. Two.

* * *

>gonear display
Pod Control
This room serves as an airlock for the pod bay, and holds an old space suit and various machinery such as the atmosphere pump. There is a brass plaque on the wall.

There is a secured hatch in the ceiling.

Beside the secured port hatch, a status display shows an error message.

>x display
Pod bay locked down
 1. Telemetry sensor array offline - reset breaker FM36-87/A @ hub platform
 2. Launch system cooling loop offline - reset breaker FM29-63/A @ Sector 2
 3. Pod control atmosphere pump offline - scan and repair

>gonear green
(the green jumpsuit)
Pod Control
This room serves as an airlock for the pod bay, and holds an old space suit and various machinery such as the atmosphere pump. There is a brass plaque on the wall.

There is a secured hatch in the ceiling.

Beside the secured port hatch, a status display shows an error message.

>gonear pond
Sector 2: Aquaculture
A deep pond is used as part of the water filtration system and for raising fish. You can walk spinward or antispinward.

* * *

>purloin mask
[Purloined.]

>go pond
You can't hold your breath long enough to make that worthwhile.

>wear mask
You put on the emergency mask.

>help
You need to explore a bit more.

By the way, it should be impossible to put this game into an unwinnable state, so feel free to explore and experiment.

If you are having trouble getting started, I suggest reading A Beginner's Guide to Interactive Fiction by Stephen Granade and Emily Short, available at:

  https://brasslantern.org/players/howto/beginnersguide.html

[If you prefer not to be tempted by further hints, you can type "hints off" to disable them.]

>go pond
With the air from the emergency mask, you breathe comfortably as you step into the pond. At the bottom, you find a green circuit breaker and flip it on.

[Your score has just gone up by ten points.]

>gonear display
Pod Control
This room serves as an airlock for the pod bay, and holds an old space suit and various machinery such as the atmosphere pump. There is a brass plaque on the wall.

There is a secured hatch in the ceiling.

Beside the secured port hatch, a status display shows an error message.

>x display
Pod bay locked down
 1. Telemetry sensor array offline - reset breaker FM36-87/A @ hub platform
 2. Pod control atmosphere pump offline - scan and repair

* * *

>x display
Pod bay locked down
 1. Telemetry sensor array offline - reset breaker FM36-87/A @ hub platform
 2. Launch system cooling loop offline - reset breaker FM29-63/A @ Sector 2
 3. Pod control atmosphere pump offline - scan and repair

>help
Your objective is simply to leave the station and find other people.

You need to make three repairs, so you get three hints:

   Explore a bit more.
   Reset a circuit breaker somewhere in Sector 2.
   Now might be a good time to try out the scanner.

By the way, it should be impossible to put this game into an unwinnable state, so feel free to explore and experiment.

If you are having trouble getting started, I suggest reading A Beginner's Guide to Interactive Fiction by Stephen Granade and Emily Short, available at:

  https://brasslantern.org/players/howto/beginnersguide.html

[You can type "hint" any time for contextual assistance. If you prefer not to be tempted, you can type "hints off" to disable hints.]

>help
You need to make three repairs, so you get three hints:

   Explore a bit more.
   Reset a circuit breaker somewhere in Sector 2.
   Now might be a good time to try out the scanner.

>scan machine
Machine is failed.

>help
You need to make three repairs, so you get three hints:

   Explore a bit more.
   Reset a circuit breaker somewhere in Sector 2.
   Scanning isn't the only thing that the scanner can do.

>scanner, open machine
Opening.

The atmosphere pump swings open.

>x machine
The atmosphere pump is a smooth featureless machine.

In the atmosphere pump are a power module and a pressure regulation module.

>hint
You need to make three repairs, so you get three hints:

   Explore a bit more.
   Reset a circuit breaker somewhere in Sector 2.
   You can also scan modules.

>scanner, scan power
Component is faulty.

>hint
You need to make three repairs, so you get three hints:

   Explore a bit more.
   Reset a circuit breaker somewhere in Sector 2.
   You still need to find some modules.

>x machine
The atmosphere pump is a smooth featureless machine.

In the atmosphere pump are a faulty power module and an unscanned pressure regulation module.

* * *

>x display
Pod bay locked down
 1. Telemetry sensor array offline - reset breaker FM36-87/A @ hub platform
 2. Launch system cooling loop offline - reset breaker FM29-63/A @ Sector 2
 3. Pod control atmosphere pump offline - scan and repair

>hint
Your objective is simply to leave the station and find other people.

You need to make three repairs, so you get three hints:

   Explore a bit more.
   Reset a circuit breaker somewhere in Sector 2.
   Now might be a good time to try out the scanner.

By the way, it should be impossible to put this game into an unwinnable state, so feel free to explore and experiment.

If you are having trouble getting started, I suggest reading A Beginner's Guide to Interactive Fiction by Stephen Granade and Emily Short, available at:

  https://brasslantern.org/players/howto/beginnersguide.html

[You can type "hint" any time for contextual assistance. If you prefer not to be tempted, you can type "hints off" to disable hints.]

>hint
You need to make three repairs, so you get three hints:

   Explore a bit more.
   Reset a circuit breaker somewhere in Sector 2.
   Now might be a good time to try out the scanner.

>scanner, scan pump
Machine is failed.

>hint
You need to make three repairs, so you get three hints:

   Explore a bit more.
   Reset a circuit breaker somewhere in Sector 2.
   Scanning isn't the only thing that the scanner can do.

>scanner, open pump
Opening.

The atmosphere pump swings open.

>hint
You need to make three repairs, so you get three hints:

   Explore a bit more.
   Reset a circuit breaker somewhere in Sector 2.
   You an also scan modules.

>x pump
The atmosphere pump is a smooth featureless machine.

In the atmosphere pump are a power module and a pressure regulation module.

>scanner, scan power
Component is faulty.

>scanner, scan pressure
Component is faulty.

>hint
You need to make three repairs, so you get three hints:

   Explore a bit more.
   Reset a circuit breaker somewhere in Sector 2.
   You still need to find some modules.

>purloin all modules
[Purloined.]
[Purloined.]
[Purloined.]
[Purloined.]
[Purloined.]
[Purloined.]
[Purloined.]

>i
You are carrying:
  an unscanned pressure regulation module
  two unscanned instruction modules
  two unscanned power modules
  a faulty pressure regulation module
  a faulty power module
  a scanner
  a green jumpsuit (being worn)

>hint
You need to make three repairs, so you get three hints:

   Explore a bit more.
   Reset a circuit breaker somewhere in Sector 2.
   You still need to identify some modules.

>undo
Pod Control
[Previous turn undone.]

>undo
Pod Control
[Previous turn undone.]

>i
You are carrying:
  a scanner
  a green jumpsuit (being worn)

>hint
You need to make three repairs, so you get three hints:

   Explore a bit more.
   Reset a circuit breaker somewhere in Sector 2.
   You still need to find some modules.

>gonear learning
School
A broken learning machine remains in a corner, but mostly the older farmers took turns leading the class. There is a desk, and a chalkboard hangs on one wall.

On the desk is a clean eraser.

>scanner, open learning
Opening.

The learning machine swings open.

[Your score has just gone up by five points.]

>get all from learning
unscanned power module: Taken.
unscanned instruction module: Taken.

>gonear crate
Supply Vault
This room is dim, quiet, and stuffy. There is still a crate of machine parts left.

There is a secured hatch in the ceiling.

You can also see some pair of gravity boots here.

>hint
You need to make three repairs, so you get three hints:

   You have seen what you need to reset the circuit breaker.
   Reset a circuit breaker somewhere in Sector 2.
   You still need to find some modules.

>search crate
You find an unscanned pressure regulation module.
(putting the scanner into your pocket to make room)

>hint
You need to make three repairs, so you get three hints:

   You have seen what you need to reset the circuit breaker.
   Reset a circuit breaker somewhere in Sector 2.
   You still need to identify some modules.

* * *

>hint
You need to make three repairs, so you get three hints:

   Explore a bit more.
   Reset a circuit breaker somewhere in Sector 2.
   Now might be a good time to try out the scanner.

>z
Time passes.

>z.z.z.z.z.z.z.z
Time passes.

Time passes.

Time passes.

Time passes.

Time passes.

Time passes.

Time passes.

Time passes.

>z.z.z.z.z.z.z.z
Time passes.

Time passes.

Time passes.

Time passes.

Time passes.

Time passes.

Time passes.

Time passes.

>hint
According the the status display, you need to reset a circuit breaker on the hub platform.

You need to look for something that will help.

>gonear boots
Supply Vault
This room is dim, quiet, and stuffy. There is still a crate of machine parts left.

There is a secured hatch in the ceiling.

You can also see some pair of gravity boots here.

>hint
According the the status display, you need to reset a circuit breaker on the hub platform.

You have seen what you need.

>gonear red
(the red circuit breaker)
Center Platform
It's a mesh platform a little below the hub. You feel much lighter here, and you are very aware of how the station rotates, but everything is okay as long as you don't look down.

You can just reach a red circuit breaker on the hub.

>hint
According the the status display, you need to reset a circuit breaker on the hub platform.

>undo
Center Platform
[Previous turn undone.]

>gonear doll
House
Two families lived here, but not recently.

Someone has left a doll on the well swept floor.

>hint
According the the status display, you need to reset a circuit breaker on the hub platform.

>undo
House
[Previous turn undone.]

>undo
Center Platform
[Previous turn undone.]

>undo
Supply Vault
[Previous turn undone.]

>gonear doll
House
Two families lived here, but not recently.

Someone has left a doll on the well swept floor.

>hint
According the the status display, you need to reset a circuit breaker on the hub platform.

You have seen what you need.

>gonear boots
Supply Vault
This room is dim, quiet, and stuffy. There is still a crate of machine parts left.

There is a secured hatch in the ceiling.

You can also see some pair of gravity boots here.

* * *

>u
An alarm sounds, and a synthesized voice says "Laser scan detects unauthorized materiel removal." The hatch seems to be locked.

>hint
According the the status display, you need to reset a circuit breaker on the hub platform.

You have touched what you need, but you need to figure out how to get it.

* * *

>scan pump
Machine is failed.

>hint
You need to make three repairs, so you get three hints:

   Explore a bit more.
   Reset a circuit breaker somewhere in Sector 2.
   Scanning isn't the only thing that the scanner can do.

* * *

>gonear display
Pod Control
This room serves as an airlock for the pod bay, and holds an old space suit and various machinery such as the atmosphere pump. There is a brass plaque on the wall.

There is a secured hatch in the ceiling.

Beside the secured port hatch, a status display shows an error message.

>x message
Pod bay locked down
 1. Telemetry sensor array offline - reset breaker FM36-87/A @ hub platform
 2. Launch system cooling loop offline - reset breaker FM29-63/A @ Sector 2
 3. Pod control atmosphere pump offline - scan and repair

>hint
You need to repair three things:

 1. Explore a bit more.

 2. Reset a circuit breaker somewhere in Sector 2.

 3. Now might be a good time to try out the scanner.

By the way, it should be impossible to put this game into an unwinnable state, so feel free to explore and experiment.

If you are having trouble getting started, I suggest reading A Beginner's Guide to Interactive Fiction by Stephen Granade and Emily Short, available at:

  https://brasslantern.org/players/howto/beginnersguide.html

[If you prefer not to be tempted by further hints, you can type "hints off" to disable them.]

>hint
You need to repair three things:

 1. Explore a bit more.

 2. Reset a circuit breaker somewhere in Sector 2.

 3. Now might be a good time to try out the scanner.

>scan pump
Machine is failed.

>hint
You need to repair three things:

 1. Explore a bit more.

 2. Reset a circuit breaker somewhere in Sector 2.

 3. Scanning isn't the only thing that the scanner can do.

>scanner, open pump
Opening.

The atmosphere pump swings open.

>hint
You need to repair three things:

 1. Explore a bit more.

 2. Reset a circuit breaker somewhere in Sector 2.

 3. You an also scan components.

>i
You are carrying:
  a scanner
  a green jumpsuit (being worn)

>x machine
The atmosphere pump is a smooth featureless machine.

In the atmosphere pump are a power module and a pressure regulation module.

>scan power module
Component is faulty.

>hint
You need to repair three things:

 1. Explore a bit more.

 2. Reset a circuit breaker somewhere in Sector 2.

 3. You still need to identify some components.

>scan pressure
Component is faulty.

>i
You are carrying:
  a scanner
  a green jumpsuit (being worn)

>get all from machine
faulty power module: Taken.
faulty pressure regulation module: Taken.

>drop faulty modules
faulty pressure regulation module: Dropped.
faulty power module: Dropped.

>purloin all pressure regulation modules
(the faulty pressure regulation module)
[Purloined.]

>i
You are carrying:
  a faulty pressure regulation module
  a scanner
  a green jumpsuit (being worn)

>purloin all modules
[Purloined.]
[Purloined.]
[Purloined.]
[Purloined.]
[Purloined.]
[Purloined.]
[Purloined.]

>i
You are carrying:
  an unscanned pressure regulation module
  two unscanned instruction modules
  two unscanned power modules
  a faulty power module
  a faulty pressure regulation module
  a scanner
  a green jumpsuit (being worn)

>hint
You need to repair three things:

 1. Explore a bit more.

 2. Reset a circuit breaker somewhere in Sector 2.

 3. You still need to identify some components.

>i
You are carrying:
  an unscanned pressure regulation module
  two unscanned instruction modules
  two unscanned power modules
  a faulty power module
  a faulty pressure regulation module
  a scanner
  a green jumpsuit (being worn)

>scn unscanned pressure
That's not a verb I recognize.

>scan unscanned pressure
Component is functional.

>i
You are carrying:
  a functional pressure regulation module
  two unscanned instruction modules
  two unscanned power modules
  a faulty power module
  a faulty pressure regulation module
  a scanner
  a green jumpsuit (being worn)

>scan unscanned power
Component is functional.

>put functional power in pump
You put the functional power module into the atmosphere pump.

>put function regulation in pump
You can't see any such thing.

>put function regulation module in pump
You can't see any such thing.

>put functional regulation in pump
You put the functional pressure regulation module into the atmosphere pump.

>i
You are carrying:
  two unscanned instruction modules
  an unscanned power module
  a faulty power module
  a faulty pressure regulation module
  a scanner
  a green jumpsuit (being worn)

>hint
You need to repair three things:

 1. Explore a bit more.

 2. Reset a circuit breaker somewhere in Sector 2.

 3. The status display has some clear directions.

>x display
Pod bay locked down
 1. Telemetry sensor array offline - reset breaker FM36-87/A @ hub platform
 2. Launch system cooling loop offline - reset breaker FM29-63/A @ Sector 2
 3. Pod control atmosphere pump offline - close pump

>close pump
You close the atmosphere pump and it begins to hum.

[Your score has just gone up by five points.]

>hint
You need to repair two things:

 1. Explore a bit more.

 2. Reset a circuit breaker somewhere in Sector 2.

>scanner, open pump
Opening.

The atmosphere pump swings open.

>look
Pod Control
This room serves as an airlock for the pod bay, and holds an old space suit and various machinery such as the atmosphere pump. There is a brass plaque on the wall.

There is a secured hatch in the ceiling.

Beside the secured port hatch, a status display shows an error message.

The atmosphere pump is open and contains a functional pressure regulation module and a functional power module.

>hint
You need to repair two things:

 1. Explore a bit more.

 2. Reset a circuit breaker somewhere in Sector 2.

>hint
You need to repair two things:

 1. Explore a bit more.

 2. Reset a circuit breaker somewhere in Sector 2.

>scenes
Scene 'Entire Game' playing (for 34 mins now)
Scene 'Beginning' ended
Scene 'Repairing Pod Bay' playing (for 34 mins now)
Scene 'Repairing Red Breaker' playing (for 34 mins now)
Scene 'Repairing Green Breaker' playing (for 34 mins now)
Scene 'Repairing Atmosphere Pump' ended
(Scene monitoring now switched on. Type "scenes off" to switch it off again.)

>gonear red
(the red circuit breaker)
Center Platform
It's a mesh platform a little below the hub. You feel much lighter here, and you are very aware of how the station rotates, but everything is okay as long as you don't look down.

You can just reach a red circuit breaker on the hub.

>turn red on
You switch the red circuit breaker on.

[Scene 'Repairing Red Breaker' ends]
[Your score has just gone up by five points.]

>gonear pond
Sector 2: Aquaculture
A deep pond is used as part of the water filtration system and for raising fish. You can walk spinward or antispinward.

>hint
Reset a circuit breaker somewhere in Sector 2.

>purloin mask
[Purloined.]

* * *

>wear mask
You put on the emergency mask.

>go pond
With the air from the emergency mask, you breathe comfortably as you step into the pond. At the bottom, you find a green circuit breaker and flip it on.

[Scene 'Repairing Green Breaker' ends]
[Scene 'Repairing Pod Bay' ends]
[Scene 'Between Repairs' begins]
It is time to say goodbye to the station. You are ready to leave in a pod.

[Your score has just gone up by ten points.]

>scenes
Scene 'Entire Game' playing (for 40 mins now)
Scene 'Beginning' ended
Scene 'Repairing Pod Bay' ended
Scene 'Repairing Red Breaker' ended
Scene 'Repairing Green Breaker' ended
Scene 'Repairing Atmosphere Pump' ended
Scene 'Between Repairs' playing (for 1 mins now)
(Scene monitoring now switched on. Type "scenes off" to switch it off again.)

>hint
The status display has some clear directions.

>e
You have heard of compass directions like east, but they don't make any sense here. Instead, you can go spinward, antispinward, port, and starboard. When you look spinward, port is left and starboard is right.

[You can use the abbreviations "sw", "asw", "p", and "s". You can also go "up", "down", "in", and "out" where appropriate. Type "exits" if you get confused about geography.]

>hint
The status display has some clear directions.

>x status
You can't see any such thing.

>port
You can't go that way.

>i
You are carrying:
  an emergency mask (being worn)
  two unscanned instruction modules
  an unscanned power module
  a faulty power module
  a faulty pressure regulation module
  a scanner
  a green jumpsuit (being worn)

>gonear first
There seems to be no such object anywhere in the model world.

>gonear display
Pod Control
This room serves as an airlock for the pod bay, and holds an old space suit and various machinery such as the atmosphere pump. There is a brass plaque on the wall.

There is a secured hatch in the ceiling.

Beside the secured port hatch, a status display shows an error message.

The atmosphere pump is open and contains a functional pressure regulation module and a functional power module.

>i
You are carrying:
  an emergency mask (being worn)
  two unscanned instruction modules
  an unscanned power module
  a faulty power module
  a faulty pressure regulation module
  a scanner
  a green jumpsuit (being worn)

>look
Pod Control
This room serves as an airlock for the pod bay, and holds an old space suit and various machinery such as the atmosphere pump. There is a brass plaque on the wall.

There is a secured hatch in the ceiling.

Beside the secured port hatch, a status display shows an error message.

The atmosphere pump is open and contains a functional pressure regulation module and a functional power module.

>look
Pod Control
This room serves as an airlock for the pod bay, and holds an old space suit and various machinery such as the atmosphere pump. There is a brass plaque on the wall.

There is a secured hatch in the ceiling.

Beside the secured port hatch, a status display shows an error message.

The atmosphere pump is open and contains a functional pressure regulation module and a functional power module.

>x display
Pod bay locked down
 1. Pod control atmosphere pump offline - close pump

There is nothing left for you here. It's time to take a pod and leave.

>port
(first opening the wall hatch)
It seems to be locked.

>close pump
You close the atmosphere pump and it begins to hum.

>x display
The status display glows green.

>look
Pod Control
This room serves as an airlock for the pod bay, and holds an old space suit and various machinery such as the atmosphere pump. There is a brass plaque on the wall.

There is a secured hatch in the ceiling.

Beside the secured port hatch, a status display glows green.

>x status
The status display glows green.

>look
Pod Control
This room serves as an airlock for the pod bay, and holds an old space suit and various machinery such as the atmosphere pump. There is a brass plaque on the wall.

There is a secured hatch in the ceiling.

Beside the secured port hatch, a status display glows green.

>scenes
Scene 'Entire Game' playing (for 56 mins now)
Scene 'Beginning' ended
Scene 'Repairing Pod Bay' ended
Scene 'Repairing Red Breaker' ended
Scene 'Repairing Green Breaker' ended
Scene 'Repairing Atmosphere Pump' ended
Scene 'Between Repairs' playing (for 17 mins now)
(Scene monitoring now switched on. Type "scenes off" to switch it off again.)

>hint
There's no point in waiting. You just need to enter the pod bay.

>port
(first opening the wall hatch)
You close the hatch behind yourself.

Pod Bay
There are four berths for transit pods. Unexpectedly, all are empty.

A secured hatch leads starboard.

Someone left an emergency communications unit on the floor.

[Scene 'Repairing Comms' begins]
This is troubling. You counted. You were sure there would be one pod left. There are none.

[Scene 'Between Repairs' ends]
[Your score has just gone up by ten points.]

>hint
Find the emergency communications unit.

>get unit
(putting the scanner into your pocket to make room)
You're carrying too many things already.

>i
You are carrying:
  an emergency mask (being worn)
  two unscanned instruction modules
  an unscanned power module
  a faulty power module
  a faulty pressure regulation module
  a green jumpsuit (being worn)

Your jumpsuit pocket contains:
  a scanner

No pods left ... you consider despair.

>drop all
unscanned instruction module: Dropped.
unscanned instruction module: Dropped.
unscanned power module: Dropped.
faulty power module: Dropped.
faulty pressure regulation module: Dropped.

>gt all
That's not a verb I recognize.

>get all
faulty pressure regulation module: Taken.
faulty power module: Taken.
unscanned power module: Taken.
unscanned instruction module: (putting the faulty pressure regulation module into your pocket to make room)
Taken.
unscanned instruction module: (putting the faulty power module into your pocket to make room)
Taken.
emergency communications unit: (putting the unscanned power module into your pocket to make room)
Taken.

So what if you can't escape in a pod. You will just need to bring a pod here. Time to get the communications module working.

>i
You are carrying:
  the emergency communications unit
  two unscanned instruction modules
  an emergency mask (being worn)
  a green jumpsuit (being worn)

Your jumpsuit pocket contains:
  an unscanned power module
  a faulty power module
  a faulty pressure regulation module
  a scanner

>get comms
(putting the unscanned instruction module into your pocket to make room)
You already have that.

>i
You are carrying:
  the emergency communications unit
  an unscanned instruction module
  an emergency mask (being worn)
  a green jumpsuit (being worn)

Your jumpsuit pocket contains:
  an unscanned instruction module
  an unscanned power module
  a faulty power module
  a faulty pressure regulation module
  a scanner

>look
Pod Bay
There are four berths for transit pods. Unexpectedly, all are empty.

A secured hatch leads starboard.

>hint
You will need to connect the communications unit to an audio unit.

>x communications
A portable emergency communications unit with a single socket to connect it to a transit pod or other audio source.

The emergency communications unit has nothing plugged into it.

* * *

>gonear doll
House
Two families lived here, but not recently.

Someone has left a doll on the well swept floor.

* * *

>gonear eraser
School
A broken learning machine remains in a corner, but mostly the older farmers took turns leading the class. There is a desk, and a chalkboard hangs on one wall.

On the desk is a clean eraser.

>erase board
You smudge the writing around with your hand.

>out
Sector 5: Forest
The school house is nestled among the trees. A pylon stretches up from the same grove to the hub of the station. You can walk spinward or antispinward.

* * *

>d
(first opening the floor hatch)
You scramble down through the hatch and close it behind yourself.

Supply Vault
This room is dim, quiet, and stuffy. There is still a crate of machine parts left.

There is a secured hatch in the ceiling.

You can also see some pair of gravity boots here.

>x laser
You can't see any such thing.

>hit eraser
You can't see any such thing.

>gonear board
School
A broken learning machine remains in a corner, but mostly the older farmers took turns leading the class. There is a desk, and a chalkboard hangs on one wall.

On the desk is a clean eraser.

>get eraser
Taken.

* * *

>hit eraser
You fill the vault with a cloud of dust and you can now see a laser beam scanning across the hatch.

>x laser
The cloud of dust scatters the laser beam just enough that you can see it scan across the north passageway at seemingly random angles.

>g
The cloud of dust scatters the laser beam just enough that you can see it scan across the north passageway at seemingly random angles.

>g
The cloud of dust scatters the laser beam just enough that you can see it scan across the north passageway at seemingly random angles.

The cloud of dust finally dissipates.

>g
You can't see any such thing.

>hit eraser
You fill the vault with a cloud of dust and you can now see a laser beam scanning across the hatch.

>u
You maneuver around the laser beam.

(first opening the ceiling hatch)
You pull yourself up through the hatch and close it behind yourself.

Sector 6: Hydroponics
Your people preferred to grow things the old fashioned way, but in truth the majority of your fruit and vegetables came from this sector when the machines still worked. You can walk spinward or antispinward.

There is a secured hatch in the ground.

>d
(first opening the floor hatch)
You scramble down through the hatch and close it behind yourself.

Supply Vault
This room is dim, quiet, and stuffy. There is still a crate of machine parts left.

You see a laser beam scan across the exit.

There is a secured hatch in the ceiling.

You can also see some pair of gravity boots here.

>get boots
Taken.

The cloud of dust finally dissipates.

>u
An alarm sounds, and a synthesized voice says "Laser scan detects unauthorized materiel removal." The hatch seems to be locked.

* * *

>hit eraser
You fill the vault with a cloud of dust and you can now see a laser beam scanning across the hatch.

>u
You maneuver around the laser beam.

(first opening the ceiling hatch)
You pull yourself up through the hatch and close it behind yourself.

Sector 6: Hydroponics
Your people preferred to grow things the old fashioned way, but in truth the majority of your fruit and vegetables came from this sector when the machines still worked. You can walk spinward or antispinward.

There is a secured hatch in the ground.

[Your score has just gone up by five points.]

* * *

>open hatch
An alarm sounds, and a synthesized voice says "Laser scan detects unauthorized materiel removal."

The hatch seems to be locked.

>hit eraser
You fill the vault with a cloud of dust and you can now see a laser beam scanning across the hatch.

>open hatch
You maneuver around the laser beam.

You open the ceiling hatch.

>close it
You close the ceiling hatch.

>z
Time passes.

* * *

>open hatch
You maneuver around the laser beam.

You open the ceiling hatch.

>undo
Supply Vault
[Previous turn undone.]

>u
(first opening the ceiling hatch)
You maneuver around the laser beam.

You pull yourself up through the hatch and close it behind yourself.

Sector 6: Hydroponics
Your people preferred to grow things the old fashioned way, but in truth the majority of your fruit and vegetables came from this sector when the machines still worked. You can walk spinward or antispinward.

There is a secured hatch in the ground.

[Your score has just gone up by five points.]

* * *

>gonear boots
Supply Vault
This room is dim, quiet, and stuffy. There is still a crate of machine parts left.

There is a secured hatch in the ceiling.

You can also see some pair of gravity boots here.

>u
(first opening the ceiling hatch)
You pull yourself up through the hatch and close it behind yourself.

Sector 6: Hydroponics
Your people preferred to grow things the old fashioned way, but in truth the majority of your fruit and vegetables came from this sector when the machines still worked. You can walk spinward or antispinward.

There is a secured hatch in the ground.

* * *

>hit eraser
You fill the vault with a cloud of dust and you can now see a laser beam scanning across the hatch.

>l
Supply Vault
This room is dim, quiet, and stuffy. There is still a crate of machine parts left.

You see a laser beam scan across the exit.

There is a secured hatch in the ceiling.

>u
You maneuver around the laser beam.

(first opening the ceiling hatch)
You pull yourself up through the hatch and close it behind yourself.

Sector 6: Hydroponics
Your people preferred to grow things the old fashioned way, but in truth the majority of your fruit and vegetables came from this sector when the machines still worked. You can walk spinward or antispinward.

There is a secured hatch in the ground.

[Your score has just gone up by five points.]

>d
(first opening the floor hatch)
You scramble down through the hatch and close it behind yourself.

Supply Vault
This room is dim, quiet, and stuffy. There is still a crate of machine parts left.

You see a laser beam scan across the exit.

There is a secured hatch in the ceiling.

>z
Time passes.

The cloud of dust finally dissipates.

>u
An alarm sounds, and a synthesized voice says "Laser scan detects unauthorized materiel removal." The hatch seems to be locked.

* * *

>z
Time passes.

>hit eraser
You fill the vault with a cloud of dust and you can now see a laser beam scanning across the hatch.

* * *

>get eraser
Taken.

>erase boart
You can't see any such thing.

>erase board
(with the eraser)
You carefully erase the chalkboard.

* * *

>u
An alarm sounds, and a synthesized voice says "Laser scan detects unauthorized materiel removal."

The hatch seems to be locked.

>hit eraser
You fill the vault with a cloud of dust and you can now see a laser beam scanning across the hatch.

* * *

>touch beam
An alarm sounds, and a synthesized voice says "Laser scan detects unauthorized materiel removal."

>open hatch
You maneuver around the laser beam.

You open the ceiling hatch.

>touch beam
An alarm sounds, the hatch slams shut, and a synthesized voice says "Laser scan detects unauthorized materiel removal."

>gonear comms
Pod Bay
There are four berths for transit pods. Sadly, all are empty.

A secured hatch leads starboard.

Someone left an emergency communications unit on the floor.

This is troubling. You counted. You were sure there would be one pod left. There are none.

[Your score has just gone up by ten points.]

>p
You can't go that way. The only obvious exit is starboard.

>s
(first opening the wall hatch)
It seems to be locked.

>open hatch
It seems to be locked.

No pods left ... you consider despair.

>gonear boots
Pod Bay
There are four berths for transit pods. Unexpectedly, all are empty.

A secured hatch leads starboard.

Someone left an emergency communications unit on the floor.

>gonear crate
Supply Vault
This room is dim, quiet, and stuffy. There is still a crate of machine parts left.

There is a secured hatch in the ceiling.

So what if you can't escape in a pod. You will just need to bring a pod here. Time to get the communications module working.

>open hatch
An alarm sounds, and a synthesized voice says "Laser scan detects unauthorized materiel removal."

>i
You are carrying:
  some pair of gravity boots
  a dusty eraser
  a scanner
  a green jumpsuit (being worn)

>gonear crate
Supply Vault
This room is dim, quiet, and stuffy. There is still a crate of machine parts left.

There is a secured hatch in the ceiling.

>open hatch
An alarm sounds, and a synthesized voice says "Laser scan detects unauthorized materiel removal."

>u
An alarm sounds, and a synthesized voice says "Laser scan detects unauthorized materiel removal."

The hatch seems to be locked.

* * *

>close hatch
That's already closed.

>open hatch
An alarm sounds, and a synthesized voice says "Laser scan detects unauthorized materiel removal."

>g
An alarm sounds, and a synthesized voice says "Laser scan detects unauthorized materiel removal."

* * *

>get boots
Taken.

>hit eraser
You fill the vault with a cloud of dust and you can now see a laser beam scanning across the hatch.

* * *

>touch beam
An alarm sounds, and a synthesized voice says "Laser scan detects unauthorized materiel removal."

>drop boots
Dropped.

>touch beam
The laser beam is intangible.

The cloud of dust finally dissipates.

>g
You can't see any such thing.

* * *

>gonear gray
Church
Before everyone left or died, you celebrated every sabbath here. The altar stands against one wall, and an organ and an audio unit stand against the other.

On the altar is The Founder's Testament.

A gray cable connects the organ and the audio unit.

>get gray
Taken.

>out
The gray cable pulls out from the organ.
The gray cable pulls out from the audio unit.

Sector 3: Forest
Trees, a house, and a church. A red pylon stretches up from the ground to the hub of the station. You can walk spinward or antispinward.

>undo
Church
[Previous turn undone.]

>put gray in pocket
You put the gray cable into the pocket.

>out
The gray cable pulls out from the organ.
The gray cable pulls out from the audio unit.

Sector 3: Forest
Trees, a house, and a church. A red pylon stretches up from the ground to the hub of the station. You can walk spinward or antispinward.

>gonear display
Pod Control
This room serves as an airlock for the pod bay, and holds an old space suit and various machinery such as the atmosphere pump. There is a brass plaque on the wall.

There is a secured hatch in the ceiling.

Beside the secured port hatch, a status display shows an error message.

>x display
Pod bay locked down
Diagnosis: telemetry sensor array offline
Remediation: reset breaker FM36-87/A @ hub platform

>hint
According to the status display, you need to reset a circuit breaker on the hub platform.

By the way, it should be impossible to put this game into an unwinnable state, so feel free to explore and experiment.

If you are having trouble getting started, I suggest reading A Beginner's Guide to Interactive Fiction by Stephen Granade and Emily Short, available at:

  https://brasslantern.org/players/howto/beginnersguide.html

[If you prefer not to be tempted by further hints, you can type "hints off" to disable them.]

>hint
According to the status display, you need to reset a circuit breaker on the hub platform.

>z.z.z.z.z.z.z.z.z.z
Time passes.

Time passes.

Time passes.

Time passes.

Time passes.

Time passes.

Time passes.

Time passes.

Time passes.

Time passes.

>z.z.z.z.z.z.z.z.z.z
Time passes.

Time passes.

Time passes.

Time passes.

Time passes.

Time passes.

Time passes.

Time passes.

Time passes.

Time passes.

>hint
According to the status display, you need to reset a circuit breaker on the hub platform.

You need to look for something that will help.

>gonear boots
Supply Vault
This room is dim, quiet, and stuffy. There is still a crate of machine parts left.

There is a secured hatch in the ceiling.

You can also see some pair of gravity boots here.

>hint
According to the status display, you need to reset a circuit breaker on the hub platform.

You have seen what you need.

>look
Supply Vault
This room is dim, quiet, and stuffy. There is still a crate of machine parts left.

There is a secured hatch in the ceiling.

You can also see some pair of gravity boots here.

>hint
According to the status display, you need to reset a circuit breaker on the hub platform.

You have seen what you need.

>u
(first opening the ceiling hatch)
You pull yourself up through the hatch and close it behind yourself.

Sector 6: Hydroponics
Your people preferred to grow things the old fashioned way, but in truth the majority of your fruit and vegetables came from this sector when the machines still worked. You can walk spinward or antispinward.

There is a secured hatch in the ground.

* * *

>u
An alarm sounds, and a synthesized voice says "Laser scan detects unauthorized materiel removal." The hatch seems to be locked.

>hint
According to the status display, you need to reset a circuit breaker on the hub platform.

You need to evade the alarm , but first explore a bit more.
, but first explore a bit more

>gonear desk
School
A broken learning machine remains in a corner, but mostly the older farmers took turns leading the class. There is a desk, and a chalkboard hangs on one wall.

On the desk is a clean eraser.

>hint
According to the status display, you need to reset a circuit breaker on the hub platform.

You need to evade the alarm . You have seen what you need.
. You have seen what you need

>get eraser
Taken.

>i
You are carrying:
  a clean eraser
  some pair of gravity boots
  a scanner
  a green jumpsuit (being worn)

Your jumpsuit pocket contains:
  a gray cable

>hint
According to the status display, you need to reset a circuit breaker on the hub platform.

You need to evade the alarm . You have found what you need.
. You have found what you need

>erase board
(with the eraser)
You carefully erase the chalkboard.

>hint
According to the status display, you need to reset a circuit breaker on the hub platform.

You need to evade the alarm : prepare something you've already found.
: prepare something you've already found

>hit eraser
You fill the area with a cloud of dust, which quickly clears.

>hint
According to the status display, you need to reset a circuit breaker on the hub platform.

You need to evade the alarm , but you seem to have figured out that trick.
, but you seem to have figured out that trick

* * *

>gonear help
There seems to be no such object anywhere in the model world.

>gonear display
Pod Control
This room serves as an airlock for the pod bay, and holds an old space suit and various machinery such as the atmosphere pump. There is a brass plaque on the wall.

There is a secured hatch in the ceiling.

Beside the secured port hatch, a status display shows an error message.

>help
You need to repair some things. Check out the status display in Pod Control.

By the way, it should be impossible to put this game into an unwinnable state, so feel free to explore and experiment.

If you are having trouble getting started, I suggest reading A Beginner's Guide to Interactive Fiction by Stephen Granade and Emily Short, available at:

  https://brasslantern.org/players/howto/beginnersguide.html

[If you prefer not to be tempted by further hints, you can type "hints off" to disable them.]

>x display
Pod bay locked down
 1. Telemetry sensor array offline - reset breaker FM36-87/A @ hub platform
 2. Launch system cooling loop offline - reset breaker FM29-63/A @ Sector 2
 3. Pod control atmosphere pump offline - scan and repair

>help
You need to repair three things:

 1. Explore a bit more.

 2. Reset a circuit breaker somewhere in Sector 2.

 3. Now might be a good time to try out the scanner.

>gonear red
(the red circuit breaker)
Center Platform
It's a mesh platform a little below the hub. You feel much lighter here, and you are very aware of how the station rotates, but everything is okay as long as you don't look down.

You can just reach a red circuit breaker on the hub.

>help
You need to repair three things:

 1. Just turn the red breaker on.

 2. Reset a circuit breaker somewhere in Sector 2.

 3. Now might be a good time to try out the scanner.

>turn on breaker
You switch the red circuit breaker on.

[Your score has just gone up by five points.]

>hint
You need to repair two things:

 1. Reset a circuit breaker somewhere in Sector 2.

 2. Now might be a good time to try out the scanner.

>gonear display
Pod Control
This room serves as an airlock for the pod bay, and holds an old space suit and various machinery such as the atmosphere pump. There is a brass plaque on the wall.

There is a secured hatch in the ceiling.

Beside the secured port hatch, a status display shows an error message.

>x display
Pod bay locked down
 1. Launch system cooling loop offline - reset breaker FM29-63/A @ Sector 2
 2. Pod control atmosphere pump offline - scan and repair

>gonear sector
Which do you mean, Sector 1: Crops, Sector 2: Aquaculture, Sector 3: Forest, Sector 4: Crops, Sector 5: Forest, or Sector 6: Hydroponics?

>gonear sector 2
Sector 2: Aquaculture
A deep pond is used as part of the water filtration system and for raising fish. You can walk spinward or antispinward.

>purloin mask
[Purloined.]

* * *

>wear mask
You put on the emergency mask.

>go pool
With the air from the emergency mask, you breathe comfortably as you step into the pond. At the bottom, you find a green circuit breaker and flip it on.

[Your score has just gone up by ten points.]

>hint
Now might be a good time to try out the scanner.

>x display
You can't see any such thing.

>gonear display
Pod Control
This room serves as an airlock for the pod bay, and holds an old space suit and various machinery such as the atmosphere pump. There is a brass plaque on the wall.

There is a secured hatch in the ceiling.

Beside the secured port hatch, a status display shows an error message.

>x display
Pod bay locked down
 1. Pod control atmosphere pump offline - scan and repair

>i
You are carrying:
  an emergency mask (being worn)
  a scanner
  a green jumpsuit (being worn)

>hint
Now might be a good time to try out the scanner.

>x scanner
The handheld voice-activated scanner you use when working on the station's machines.

[You can ask the scanner for a list of commands by typing "scanner, help" and give it voice commands by typing phrases such as "scanner, scan SOMETHING" or "scanner, open SOMETHING" where SOMETHING is a visible object.]

>hint
Now might be a good time to try out the scanner.

* * *

>gonear laser
*** Run-time problem P61: Attempt to move the player off-stage.

>gonear boots
Supply Vault
This room is dim, quiet, and stuffy. There is still a crate of machine parts left.

You see a laser beam scan across the exit.

There is a secured hatch in the ceiling.

You can also see some pair of gravity boots here.

* * *

>gonear learning
School
A broken learning machine remains in a corner, but mostly the older farmers took turns leading the class. There is a desk, and a chalkboard hangs on one wall.

On the desk is a clean eraser.

>canner, open
You seem to want to talk to someone, but I can't see whom.

>scanner, open learning
Opening.

The learning machine swings open.

[Your score has just gone up by five points.]

>l
School
A broken learning machine remains in a corner, but mostly the older farmers took turns leading the class. There is a desk, and a chalkboard hangs on one wall.

The learning machine is open and contains a power module and an instruction module.

On the desk is a clean eraser.

[Your score has just gone up by five points.]

>drop scanner
Dropped.

[Your score has just gone up by five points.]

>scan learning
You must be carrying the scanner to use it.

[Your score has just gone up by five points.]

* * *

>open learning
You will need to use the scanner to do that.

>scanner, open learning
Opening.

The learning machine swings open.

[Your score has just gone up by five points.]

>z
Time passes.

>close learning
You close the learning machine and it seals without any trace of a seam.

>z
Time passes.

>scanner, open learning
Opening.

The learning machine swings open.

>z
Time passes.

>gonear graves
Sector 1: Crops
You still maintain the crops here. There is a small graveyard and the barn remains from when this was the livestock sector. A pylon stretches up from the ground to the hub of the station. You can walk spinward or antispinward.

There is a secured hatch in the ground.

>ig
That's not a verb I recognize.

>dig
That's not a verb I recognize.

>open graves
It isn't something you can open.

>analyze graves
examining the graveyard:
Fenced off but unmarked graves. You buried your parents here.

looking under the graveyard:
You find nothing of interest.

searching the graveyard:
You find nothing of interest.

listening to the graveyard:
You hear nothing unexpected.

smelling the graveyard:
You smell nothing unexpected.

attacking the graveyard:
The Founder said that violence is never the answer.

buying the graveyard:
Nothing is on sale.

climbing the graveyard:
Little is to be achieved by that.

pulling the graveyard:
It is fixed in place.

pushing the graveyard:
It is fixed in place.

turning the graveyard:
It is fixed in place.

pushing the graveyard to inside:
The graveyard cannot be pushed from place to place.

opening the graveyard:
It isn't something you can open.

entering the graveyard:
That's not something you can enter.

getting off the graveyard:
But you aren't on the graveyard at the moment.

closing the graveyard:
It isn't something you can close.

taking the graveyard:
That's hardly portable.

switching on the graveyard:
It isn't something you can switch.

switching off the graveyard:
It isn't something you can switch.

wearing the graveyard:
(first taking the graveyard)
That's hardly portable.

taking off the graveyard:
You aren't wearing the graveyard.

touching the graveyard:
You feel nothing unexpected.

rubbing the graveyard:
You rub the graveyard.

waving the graveyard:
But you aren't holding that.

squeezing the graveyard:
You achieve nothing by this.

burning the graveyard:
There is no open flame on the station.

cutting the graveyard:
The Founder said that violence is never the answer.

tying the graveyard to the crops:
You would achieve nothing by this.

swinging the graveyard:
There's nothing sensible to swing here.

tasting the graveyard:
You taste nothing unexpected.

drinking the graveyard:
There's nothing suitable to drink here.

eating the graveyard:
That's plainly inedible.

dropping the graveyard:
The graveyard is already here.

* * *

>gonear learning
School
A broken learning machine remains in a corner, but mostly the older farmers took turns leading the class. There is a desk, and a chalkboard hangs on one wall.

On the desk is a clean eraser.

>scanner, open learning
Opening.

The learning machine swings open, revealing a power module and an instruction module.

[Your score has just gone up by five points.]

>get all from learning
power module: Taken.
instruction module: Taken.

>i
You are carrying:
  an instruction module
  a power module
  a scanner
  a green jumpsuit (being worn)

>x power
It is a standardized power module.

>x instruction
It is a standardized instruction module.

>scanner, scan power
Component is functional.

>x power
The scanner reported that this power module is functional.

>x machine
This last learning machine broke when you were maybe three thousand days old.

There is space for two more modules.

>hint
Your goal is simply to leave the station and find other people. You can start by looking around and leaving your initial location.

By the way, it should be impossible to put this game into an unwinnable state, so feel free to explore and experiment.

If you are having trouble getting started, I suggest reading A Beginner's Guide to Interactive Fiction by Stephen Granade and Emily Short, available at:

  https://brasslantern.org/players/howto/beginnersguide.html

[If you prefer not to be tempted by further hints, you can type "hints off" to disable them.]

>hint
Your goal is simply to leave the station and find other people. You can start by looking around and leaving your initial location.

* * *

>scanner, open learning
Opening.

The learning machine swings open, revealing a power module and an instruction module.

[Your score has just gone up by five points.]

>x machine
This last learning machine broke when you were maybe three thousand days old.

It is open, revealing a power module and an instruction module.

>open machine
You will need to use the scanner to do that.

>look
School
A broken learning machine remains in a corner, but mostly the older farmers took turns leading the class. There is a desk, and a chalkboard hangs on one wall.

The learning machine is open and contains a power module and an instruction module.

On the desk is a clean eraser.

>scanner, help
Recognized commands are "help", "open", and "scan".

[You can ask the scanner for a list of commands by typing "scanner, help" and give it voice commands by typing phrases such as "scanner, scan SOMETHING" or "scanner, open SOMETHING" where SOMETHING is a visible object.]

>x scanner
The handheld voice-activated scanner you use when working on the station's machines.

>scanner, jkjk
Syntax error: command not in vocabulary.

>scanner, help
Recognized commands are "help", "open", and "scan".

[You can ask the scanner for a list of commands by typing "scanner, help" and give it voice commands by typing phrases such as "scanner, scan SOMETHING" or "scanner, open SOMETHING" where SOMETHING is a visible object.]

* * *

>scanner, open learning
Opening.

The learning machine swings open, revealing a power module and an instruction module.

[Your score has just gone up by five points.]

>z
Time passes.

[Your score has just gone up by five points.]

>z
Time passes.

[Your score has just gone up by five points.]

>close machine
You close the learning machine and it seals without any trace of a seam.

>scanner, open machine
Opening.

The learning machine swings open.

>z
Time passes.

* * *

>z
Time passes.

[Your score has just gone up by five points.]

>close
What do you want to close?

>learning
You close the learning machine and it seals without any trace of a seam.

[Your score has just gone up by five points.]

>z
Time passes.

* * *

>gonear me
Home
The room where you've slept your entire life. You can go out towards the crops.

There is a secured hatch in the floor.

>out
Sector 4: Crops
Your home is here among the crops. You can walk spinward or antispinward.

* * *

>asw
You walk a little ways to the next sector.

Sector 1: Crops
You still maintain the crops here. There is a small graveyard and the barn remains from when this was the livestock sector. A pylon stretches up from the ground to the hub of the station. You can walk spinward or antispinward.

There is a secured hatch in the ground.

>d
(first opening the floor hatch)
You scramble down through the hatch and close it behind yourself.

Pod Control
This room serves as an airlock for the pod bay, and holds an old space suit and various machinery such as the atmosphere pump. There is a brass plaque on the wall.

There is a secured hatch in the ceiling.

Beside the secured port hatch, a status display shows an error message.

>hint
You need to fix something. Check out the status display in Pod Control.

By the way, it should be impossible to put this game into an unwinnable state, so feel free to explore and experiment.

If you are having trouble getting started, I suggest reading A Beginner's Guide to Interactive Fiction by Stephen Granade and Emily Short, available at:

  https://brasslantern.org/players/howto/beginnersguide.html

[If you prefer not to be tempted by further hints, you can type "hints off" to disable them.]

>look
Pod Control
This room serves as an airlock for the pod bay, and holds an old space suit and various machinery such as the atmosphere pump. There is a brass plaque on the wall.

There is a secured hatch in the ceiling.

Beside the secured port hatch, a status display shows an error message.

>x status
Pod bay locked down
Diagnosis: telemetry sensor array offline
Remediation: reset breaker FM36-87/A @ hub platform

>hint
1.
According to the status display, you need to reset a circuit breaker on the hub platform.

>hint
2.
According to the status display, you need to reset a circuit breaker on the hub platform.

>hint
3.
According to the status display, you need to reset a circuit breaker on the hub platform.

* * *

>gonear organ
Church
Before everyone left or died, you celebrated every sabbath here. The altar stands against one wall, and an organ and an audio unit stand against the other.

On the altar is The Founder's Testament.

A gray cable connects the organ and the audio unit.

>play organ
Nothing happens.

>scanner, open audio
Opening.

The audio unit swings open, revealing a power module.

>scan power unit
I only understood you as far as wanting to scan the power module.

>scan power module
Component is faulty.

>get power
Taken.

>purloin unscanned power
[Purloined.]

>i
You are carrying:
  an unscanned power module
  a faulty power module
  a scanner
  a green jumpsuit (being worn)

>scan unscanned power
Component is faulty.

>purloin unscanned power
[Purloined.]

>i
You are carrying:
  an unscanned power module
  two faulty power modules
  a scanner
  a green jumpsuit (being worn)

>put unscanned power in audio
You put the unscanned power module into the audio unit.

>close audio
You close the audio unit and it seals without any trace of a seam.

The audio unit beeps and a synthesized voice says "Organ ready."

>play organ
You never really learned how to play, but you pick out a few notes on the keyboard and the sound reverberates from the audio unit.

>unplug gray from organ
You unplug the gray cable from the organ.

The audio unit beeps and a synthesized voice says "No input."

>play organ
Nothing happens.

* * *

>gonear organ
Church
Before everyone left or died, you celebrated every sabbath here. The altar stands against one wall, and an organ and an audio unit stand against the other.

On the altar is The Founder's Testament.

A gray cable connects the organ and the audio unit.

>play prgan
You can't see any such thing.

>play organ
Nothing happens.

>purloin power
[Purloined.]

>x power
It is a standardized power module.

>scan power
Component is faulty.

>purloin all unscanned power
[Purloined.]
[Purloined.]

>scan power
Which do you mean, an unscanned power module or the faulty power module?

>unscanned
Component is functional.

>scanner, open power
Which do you mean, the functional power module, the unscanned power module, or the faulty power module?

>scanner, open audio
Opening.

The audio unit swings open, revealing space for one modules.

>x audio
The audio unit incorporates a speaker, a microphone, and a socket you would use to connect it to another device. It is open, revealing space for one module.

The audio unit has a gray cable plugged into it.

>put functional power into audio
You put the functional power module into the audio unit.

>close audio
You close the audio unit and it seals without any trace of a seam.

The audio unit beeps and a synthesized voice says "Organ ready."

* * *

>play organ
You never really learned how to play, but you pick out a few notes on the keyboard and the sound reverberates from the audio unit.

>g
You play a few notes.

>g
You play a few notes.

* * *

>gonear organ
Church
Before everyone left or died, you celebrated every sabbath here. The altar stands against one wall, and an organ and an audio unit stand against the other.

On the altar is The Founder's Testament.

A gray cable connects the organ and the audio unit.

>scanner, open audio
Opening.

The audio unit swings open, revealing a power module.

>purloin all power modules
[Purloined.]

>scan power module
Component is faulty.

>purloin all unscanned power modules
[Purloined.]
[Purloined.]

>scan unscanned power
Component is functional.

>put functional power in autio
You can't see any such thing.

>put functional power in audio
You put the functional power module into the audio unit.

>close audio
You close the audio unit and it seals without any trace of a seam.

The audio unit beeps and a synthesized voice says "Organ ready."

* * *

>scanner, open audio
Opening.

The audio unit swings open, revealing a power module.

>x auio
You can't see any such thing.

>purloin all power modules
[Purloined.]

>purloin all power modules
[Purloined.]

>purloin all modules
(the power module)
[Purloined.]

>purloin all unscanned modules
(the power module)
[Purloined.]

>scan module
Component is faulty.

>purloin all unscanned modules
[Purloined.]
[Purloined.]
[Purloined.]
[Purloined.]
[Purloined.]
[Purloined.]

>x modules
You can't use multiple objects with that verb.

>scan unscanned power
Component is functional.

>put functional power in audio
You put the functional power module into the audio unit.

* * *

>close audio
You close the audio unit and it seals without any trace of a seam.

The audio unit beeps and a synthesized voice says "Organ ready."

>open audio
You will need to use the scanner to do that.

>scanner, open audio
Opening.

The audio unit swings open.

>close organ
It isn't something you can close.

>close audio
You close the audio unit and it seals without any trace of a seam.

The audio unit beeps and a synthesized voice says "Organ ready."

>unplug cable from organ
You unplug the gray cable from the organ.

The audio unit beeps and a synthesized voice says "No input."

>z
Time passes.

>plug cable into organ
You plug the gray cable into the organ.

The audio unit beeps and a synthesized voice says "Organ ready."

>scanner, open unit
Opening.

The audio unit swings open.

>close unit
You close the audio unit and it seals without any trace of a seam.

The audio unit beeps and a synthesized voice says "Organ ready."

* * *

>gonear organ
Church
Before everyone left or died, you celebrated every sabbath here. The altar stands against one wall, and an organ and an audio unit stand against the other.

On the altar is The Founder's Testament.

A gray cable connects the organ and the audio unit.

>x organ
It's really just a keyboard in a fancy box with a socket to connect it to an audio unit.

The organ has a gray cable plugged into it.

>pull cable from organ
I only understood you as far as wanting to pull the gray cable.

>remove cable from organ
You unplug the gray cable from the organ.

>x organ
It's really just a keyboard in a fancy box with a socket to connect it to an audio unit.

The organ has nothing plugged into it.

>plug cable into organ
You plug the gray cable into the organ.

>x audio
The audio unit incorporates a speaker, a microphone, and a socket you would use to connect it to another device.

The audio unit has a gray cable plugged into it.

>scanner, open audio
Opening.

The audio unit swings open, revealing a power module.

>x audio
The audio unit incorporates a speaker, a microphone, and a socket you would use to connect it to another device. It is open, revealing a power module.

The audio unit has a gray cable plugged into it.

>x cable
A one meter USB 7.2 cable with a Type-F plug at each end.

It is plugged into the organ and an audio unit.

>x audio
The audio unit incorporates a speaker, a microphone, and a socket you would use to connect it to another device. It is open, revealing a power module.

The audio unit has a gray cable plugged into it.

>purloin comms
[Purloined.]

>x comms
A portable emergency communications unit with a single socket to connect it to a transit pod or other audio source.

The emergency communications unit has nothing plugged into it.

* * *

>gonear plaque
Pod Control
This room serves as an airlock for the pod bay, and holds an old space suit and various machinery such as the atmosphere pump. There is a brass plaque on the wall.

There is a secured hatch in the ceiling.

Beside the secured port hatch, a status display shows an error message.

>get plaque
That's hardly portable.

>out
But you aren't in anything at the moment.

>u
(first opening the ceiling hatch)
You pull yourself up through the hatch and close it behind yourself.

Sector 1: Crops
You still maintain the crops here. There is a small graveyard and the barn remains from when this was the livestock sector. A pylon stretches up from the ground to the hub of the station. You can walk spinward or antispinward.

There is a secured hatch in the ground.

>asw
You walk a little ways to the next sector.

Sector 6: Hydroponics
Your people preferred to grow things the old fashioned way, but in truth the majority of your fruit and vegetables came from this sector when the machines still worked. You can walk spinward or antispinward.

There is a secured hatch in the ground.

>sw
You walk a little ways to the next sector.

Sector 1: Crops
You still maintain the crops here. There is a small graveyard and the barn remains from when this was the livestock sector. A pylon stretches up from the ground to the hub of the station. You can walk spinward or antispinward.

There is a secured hatch in the ground.

* * *

>sw
You walk a little ways to the next sector.

Sector 2: Aquaculture
A deep pond is used as part of the water filtration system and for raising fish. You can walk spinward or antispinward.

>sw
You walk a little ways to the next sector.

Sector 3: Forest
Trees, a house, and a church. A red pylon stretches up from the ground to the hub of the station. You can walk spinward or antispinward.

Someone has left a doll on the well swept floor.

>u
The red pylon is designated for climbing, but you can't get a grip.

>actions
Actions listing on.

>in
[going inside]
You can enter the church or the house.
[going inside - failed]

>out
[exiting]
But you aren't in anything at the moment.
[exiting - failed the can't exit when not inside anything rule]

>restart
[restarting the game]
Are you sure you want to restart?

>yes
You awake. You are lonely, so lonely. It was a thousand days ago today. All alone these thousand days. Your parents were the last. No, your father was the last. He held on for nearly a hundred days longer. No, you are the last. Alone. Adrift.

But maybe it isn't hopeless. There must still be other people in other worlds, and you think you know how to get there.

Today is the day.

Founder's Mercy
A Space Story by Thomas Insel
Release 1 / Serial number 181126 / Inform 7 build 6M62 (I6/v6.33 lib 6/12N) SD
Type "about" for credits or "hint" for assistance.

Home
The room where you've slept your entire life. You can go out towards the crops.

There is a secured hatch in the floor.

>out
Sector 4: Crops
Your home is here among the crops. You can walk spinward or antispinward.

* * *

>x home
You were told it was built to look like a log cabin on Old Earth.

>look under home
You find nothing of interest.

>take home
That's hardly portable.

>i
You are carrying:
  a scanner
  a green jumpsuit (being worn)

>drop home
The home is already here.

* * *

>gonear plow
Barn
Not fancy: livestock on one side and feed on the other, but nothing remains of either. There is a plow near the entrance.

>look
Barn
Not fancy: livestock on one side and feed on the other, but nothing remains of either.

>x plow
You see nothing special about the plow.

>push plow
This particular plow is too heavy to use alone, and you have no companions or livestock.

It is fixed in place.

>taste plow
This particular plow is too heavy to use alone, and you have no companions or livestock.

You taste nothing unexpected.

* * *

>gonear plow
Barn
Not fancy: livestock on one side and feed on the other, but nothing remains of either. There is a plow near the entrance.

>push plow
This particular plow is too heavy to use alone, and you have no companions or livestock.

>push plow north
The plow cannot be pushed from place to place.

>push blow
You can't see any such thing.

>push plow
This particular plow is too heavy to use alone, and you have no companions or livestock.

* * *

>gonear plow
Barn
Not fancy: livestock on one side and feed on the other, but nothing remains of either. There is a plow near the entrance.

>push plow north
You have heard of compass directions like north, but they don't make any sense here. Instead, you can go spinward, antispinward, port, and starboard. When you look spinward, port is left and starboard is right.

[You can use the abbreviations "sw", "asw", "p", and "s". You can also go "up", "down", "in", and "out" where appropriate. Type "exits" if you get confused about geography.]

>actions
Actions listing on.

>push plow north
[pushing the plow to north]
The plow cannot be pushed from place to place.
[pushing the plow to north - failed]

* * *

>push plow north
You have heard of compass directions like north, but they don't make any sense here. Instead, you can go spinward, antispinward, port, and starboard. When you look spinward, port is left and starboard is right.

[You can use the abbreviations "sw", "asw", "p", and "s". You can also go "up", "down", "in", and "out" where appropriate. Type "exits" if you get confused about geography.]

>push plow out
This particular plow is too heavy to use alone, and you have no companions or livestock.

>actions
Actions listing on.

* * *

>gonear plow
Barn
Not fancy: livestock on one side and feed on the other, but nothing remains of either. There is a plow near the entrance.

>touch plow
You feel nothing unexpected.

>analyze plow
examining the plow:
You see nothing special about the plow.

looking under the plow:
You find nothing of interest.

searching the plow:
You find nothing of interest.

listening to the plow:
You hear nothing unexpected.

smelling the plow:
You smell nothing unexpected.

attacking the plow:
The Founder said that violence is never the answer.

buying the plow:
Nothing is on sale.

climbing the plow:
Little is to be achieved by that.

pulling the plow:
It is fixed in place.

pushing the plow:
It is fixed in place.

turning the plow:
It is fixed in place.

pushing the plow to outside:
The plow cannot be pushed from place to place.

opening the plow:
It isn't something you can open.

entering the plow:
That's not something you can enter.

getting off the plow:
But you aren't on the plow at the moment.

closing the plow:
It isn't something you can close.

taking the plow:
That's hardly portable.

switching on the plow:
It isn't something you can switch.

switching off the plow:
It isn't something you can switch.

wearing the plow:
(first taking the plow)
That's hardly portable.

taking off the plow:
You aren't wearing the plow.

touching the plow:
You feel nothing unexpected.

rubbing the plow:
You rub the plow.

waving the plow:
But you aren't holding that.

squeezing the plow:
You achieve nothing by this.

burning the plow:
There is no open flame on the station.

cutting the plow:
The Founder said that violence is never the answer.

tying the plow to yourself:
You would achieve nothing by this.

swinging the plow:
There's nothing sensible to swing here.

tasting the plow:
You taste nothing unexpected.

drinking the plow:
There's nothing suitable to drink here.

eating the plow:
That's plainly inedible.

dropping the plow:
The plow is already here.

>.  push plow north
That's not a verb I recognize.

>actions
Actions listing on.

>push plow
[pushing the plow]
It is fixed in place.
[pushing the plow - failed]

>push plow north
[pushing the plow to north]
The plow cannot be pushed from place to place.
[pushing the plow to north - failed]

* * *

>gonear plow
Barn
Not fancy: livestock on one side and feed on the other, but nothing remains of either. There is a plow near the entrance.

>ush plow
That's not a verb I recognize.

>push plow
This particular plow is too heavy to use alone, and you have no companions or livestock.

* * *

>gonear pod bay
(Pod Bay)
Pod Bay
There are four berths for transit pods. Sadly, all are empty.

A secured hatch leads starboard.

Someone left an emergency communications unit on the floor.

This is troubling. You counted. You were sure there would be one pod left. There are none.

[Your score has just gone up by ten points.]

>out
But you aren't in anything at the moment.

>go outside
BOOOOO.

>out
But you aren't in anything at the moment.

No pods left ... you consider despair.

>actions
Actions listing on.

>out
[exiting]
But you aren't in anything at the moment.
[exiting - failed the can't exit when not inside anything rule]

* * *

>gonear pump
Pod Control
This room serves as an airlock for the pod bay, and holds an old space suit and various machinery such as the atmosphere pump. There is a brass plaque on the wall.

There is a secured hatch in the ceiling.

Beside the secured port hatch, a status display shows an error message.

>look
Pod Control
This room serves as an airlock for the pod bay, and holds an old space suit and various machinery such as the atmosphere pump. There is a brass plaque on the wall.

There is a secured hatch in the ceiling.

Beside the secured port hatch, a status display shows an error message.

>scanner, open pump
Opening.

The atmosphere pump swings open.

>x pump
The atmosphere pump is a smooth featureless machine.

In the atmosphere pump are a power module and a pressure regulation module.

>look
Pod Control
This room serves as an airlock for the pod bay, and holds an old space suit and various machinery such as the atmosphere pump. There is a brass plaque on the wall.

There is a secured hatch in the ceiling.

Beside the secured port hatch, a status display shows an error message.

The atmosphere pump is open and contains a power module and a pressure regulation module.

* * *

>gonear pump
Pod Control
This room serves as an airlock for the pod bay, and holds an old space suit and various machinery such as the atmosphere pump. There is a brass plaque on the wall.

There is a secured hatch in the ceiling.

Beside the secured port hatch, a status display shows an error message.

>scan pump
Machine is failed.

* * *

>gonear pump
Pod Control
This room serves as an airlock for the pod bay, and holds an old space suit and various machinery such as the atmosphere pump. There is a brass plaque on the wall.

There is a secured hatch in the ceiling.

Beside the secured port hatch, a status display shows an error message.

>scan pump with scanner
Machine is failed.

>scan pump with scannersdf
You can't see any such thing.

>scanner, scan pump with scanner
Syntax error: command not in vocabulary.

>scanner, scan pump
Machine is failed.

>hint
You need to repair some things. Check out the status display in Pod Control.

By the way, it should be impossible to put this game into an unwinnable state, so feel free to explore and experiment.

If you are having trouble getting started, I suggest reading A Beginner's Guide to Interactive Fiction by Stephen Granade and Emily Short, available at:

  https://brasslantern.org/players/howto/beginnersguide.html

[If you prefer not to be tempted by further hints, you can type "hints off" to disable them.]

>x display
Pod bay locked down
 1. Telemetry sensor array offline - reset breaker FM36-87/A @ hub platform
 2. Launch system cooling loop offline - reset breaker FM29-63/A @ Sector 2
 3. Pod control atmosphere pump offline - scan and repair

>hint
You need to repair three things:

 1. Explore a bit more.

 2. Reset a circuit breaker somewhere in Sector 2.

 3. Scanning isn't the only thing that the scanner can do.

* * *

>hint
You need to repair three things:

 1. Explore a bit more.

 2. Reset a circuit breaker somewhere in Sector 2.

 3. You an also scan components.

>x pump
The atmosphere pump is a smooth featureless machine.

In the atmosphere pump are a power module and a pressure regulation module.

>xcanner, scan power
You seem to want to talk to someone, but I can't see whom.

* * *

>gonear pump
Pod Control
This room serves as an airlock for the pod bay, and holds an old space suit and various machinery such as the atmosphere pump. There is a brass plaque on the wall.

There is a secured hatch in the ceiling.

Beside the secured port hatch, a status display shows an error message.

>scanner, open pump
Opening.

The atmosphere pump swings open, revealing a power module and a pressure regulation module.

>get pressure
Taken.

>scanner, open pump
Machine is already open.

>x pump
The atmosphere pump is a smooth featureless machine.The atmosphere pump is open, revealing a power module and space for one more module.

>close pump
You close the atmosphere pump and it seals without any trace of a seam.

>scanner, open pump
Opening.

The atmosphere pump swing open, revealing a power module and space for one more module.

>get power
Taken.

>close pump
You close the atmosphere pump and it seals without any trace of a seam.

>scanner, open pump
Opening.

The atmosphere pump swing open, revealing space for two modules.

>x pump
The atmosphere pump is a smooth featureless machine.The atmosphere pump is open, revealing space for two modules.

I beg your pardon?

* * *

>scanner, open pump
Opening.

The atmosphere pump swings open, revealing a power module and a pressure regulation module.

>x pump
The atmosphere pump is a smooth featureless machine. It is open, revealing a power module and a pressure regulation module.

>get power
Taken.

>x pump
The atmosphere pump is a smooth featureless machine. It is open, revealing a pressure regulation module and space for one more module.

>get module from pump
Taken.

>x pump
The atmosphere pump is a smooth featureless machine. It is open, revealing space for two modules.

>gonear audio
Church
Before everyone left or died, you celebrated every sabbath here. The altar stands against one wall, and an organ and an audio unit stand against the other.

On the altar is The Founder's Testament.

A gray cable connects the organ and the audio unit.

>scanner open audio
That's not a verb I recognize.

>scanner, open audio
Opening.

The audio unit swings open, revealing a power module.

>x audio
The audio unit incorporates a speaker, a microphone, and a socket you would use to connect it to another device. It is open, revealing a power module.

>x organ
It's really just a keyboard in a fancy box with a socket to connect it to an audio unit.

>x organ
It's really just a keyboard in a fancy box with a socket to connect it to an audio unit.

>close audio
You close the audio unit and it seals without any trace of a seam.

>x audio
The audio unit incorporates a speaker, a microphone, and a socket you would use to connect it to another device.

* * *

>gonear pump
Pod Control
This room serves as an airlock for the pod bay, and holds an old space suit and various machinery such as the atmosphere pump. There is a brass plaque on the wall.

There is a secured hatch in the ceiling.

Beside the secured port hatch, a status display shows an error message.

>x display
Pod bay locked down
 1. Telemetry sensor array offline - reset breaker FM36-87/A @ hub platform
 2. Launch system cooling loop offline - reset breaker FM29-63/A @ Sector 2
 3. Pod control atmosphere pump offline - scan and repair

>x pump
The atmosphere pump is a smooth featureless machine.

>scan pump with scanner
I only understood you as far as wanting to scan the atmosphere pump.

* * *

>gonear scanner
Home
The room where you've slept your entire life. You can go out towards the crops.

There is a secured hatch in the floor.

>gonear audio
Church
Before everyone left or died, you celebrated every sabbath here. The altar stands against one wall, and an organ and an audio unit stand against the other.

On the altar is The Founder's Testament.

A gray cable connects the organ and the audio unit.

* * *

>scanner, open audio
Opening.

The audio unit swings open, revealing a power module.

>x audio
The audio unit incorporates a speaker, a microphone, and a socket you would use to connect it to another device.

It is open, revealing a power module.

The audio unit has a gray cable plugged into it.

>scan power
Module is faulty.

>scanner, scan power
Module is faulty.

* * *

>gonear space suit
Pod Control
This room serves as an airlock for the pod bay, and holds an old space suit and various machinery such as the atmosphere pump. There is a brass plaque on the wall.

There is a secured hatch in the ceiling.

Beside the secured port hatch, a status display shows an error message.

>x space suit
For EVA or extra protection in a pod. Unfortunately, it failed its last periodic inspection: the seals are leaking and there are no spares left.

>take space suit
All of the seals are shot, so the suit won't be useful.

>smell space suit
All of the seals are shot, so the suit won't be useful.

>hit me with space suit
I only understood you as far as wanting to hit yourself.

>throw spsace suit at display
You can't see any such thing.

>throw space suit at display
All of the seals are shot, so the suit won't be useful.

* * *

>gonear space suit
Pod Control
This room serves as an airlock for the pod bay, and holds an old space suit and various machinery such as the atmosphere pump. There is a brass plaque on the wall.

There is a secured hatch in the ceiling.

Beside the secured port hatch, a status display shows an error message.

>x suit
(the green jumpsuit)
You have worn modest jumpsuits like this since you were small. Originally, the colors had meanings: green for farmers, blue for technicians, and so on, but that distinction died even before the population.

It features a single large pocket, currently empty.

>get it
You already have that.

>x space suit
For EVA or extra protection in a pod. Unfortunately, it failed its last periodic inspection: the seals are leaking and there are no spares left.

>get it
All of the seals are shot, so the suit won't be useful.

* * *

>gonear status
Pod Control
This room serves as an airlock for the pod bay, and holds an old space suit and various machinery such as the atmosphere pump. There is a brass plaque on the wall.

There is a secured hatch in the ceiling.

Beside the secured port hatch, a status display shows an error message.

>x status
Pod bay locked down
Diagnosis: telemetry sensor array offline
Remediation: reset breaker FM36-87/A @ hub platform

>hint
According to the status display, you need to reset a circuit breaker on the hub platform.

There is more help available about this topic. Try again if you are sure you need it.

By the way, it should be impossible to put this game into an unwinnable state, so feel free to explore and experiment.

If you are having trouble getting started, I suggest reading A Beginner's Guide to Interactive Fiction by Stephen Granade and Emily Short, available at:

  https://brasslantern.org/players/howto/beginnersguide.html

[If you prefer not to be tempted by further hints, you can type "hints off" to disable them.]

>hint
According to the status display, you need to reset a circuit breaker on the hub platform.

Two.

There is more help available about this topic. Try again if you are sure you need it.

>hint
According to the status display, you need to reset a circuit breaker on the hub platform.

Two.

Three.

>hint
According to the status display, you need to reset a circuit breaker on the hub platform.

Two.

Three.

>about
About Founder's Mercy
Founder's Mercy is my second released Inform project, conceived and implemented in November of 2018.

Thanks to Graham Nelson, Andrew Plotkin, Emily Short, and everyone else who contributed to the Inform and Glulx ecosystem. Thanks also to Eric Eve for the Exit Lister extension, Juhana Leinonen for the Object Response Tests extension, and Sean Turner for the Plugs and Sockets extension. The cover art is adapted from Figure 1.1 from NASA SP-413, Space Settlements: A Design Study, edited by Richard D. Johnson and Charles Holbrow, and available from The Internet Archive at https://archive.org/details/SpaceSettlementsADesignStudy1977 .

Please send your feedback, bug reports, and requests for help to tinsel@tinsel.org. You can always find the current version of this game at http://tinsel.org/IF/ .

This work is Copyright  2018 Thomas Insel but may be freely shared according to the terms of the Creative Commons Attribution 4.0 International license (https://creativecommons.org/licenses/by/4.0/).

>help
According to the status display, you need to reset a circuit breaker on the hub platform.

Two.

Three.

* * *

>gonear status display
Pod Control
This room serves as an airlock for the pod bay, and holds an old space suit and various machinery such as the atmosphere pump. There is a brass plaque on the wall.

There is a secured hatch in the ceiling.

Beside the secured port hatch, a status display shows an error message.

>x it
The atmosphere pump is a smooth featureless machine.

>x display
Pod bay locked down
 1. Telemetry sensor array offline - reset breaker FM36-87/A @ hub platform
 2. Launch system cooling loop offline - reset breaker FM29-63/A @ Sector 2
 3. Pod control atmosphere pump offline - scan and repair

* * *

>help
Your goal is simply to leave the station and find other people.

You can start by looking around and leaving your initial location.

By the way, it should be impossible to put this game into an unwinnable state, so feel free to explore and experiment.

If you are having trouble getting started, I suggest reading A Beginner's Guide to Interactive Fiction by Stephen Granade and Emily Short, available at:

  https://brasslantern.org/players/howto/beginnersguide.html

[If you prefer not to be tempted by further hints, you can type "hints off" to disable them.]

>disbale help
That's not a verb I recognize.

>restart
Are you sure you want to restart?

>yes
You awake. You are lonely, so lonely. It was a thousand days ago today. All alone these thousand days. Your parents were the last. No, your father was the last. He held on for nearly a hundred days longer. No, you are the last. Alone. Adrift.

But maybe it isn't hopeless. There must still be other people in other worlds, and you think you know how to get there.

Today is the day.

Founder's Mercy
A Space Story by Thomas Insel
Release 1 / Serial number 181125 / Inform 7 build 6M62 (I6/v6.33 lib 6/12N) SD
Type "about" for credits or "help" for assistance.

Home
The room where you've slept your entire life. You can go out towards the crops.

There is a secured hatch in the floor.

>disable help
That's not a verb I recognize.

>help off
Disabling hints is irreversible.

Are you sure?

>yes
Ok. Hints are now disabled.

>help
Your goal is simply to leave the station and find other people.

You have disabled hints, but don't despair. It is still impossible to put this game into an unwinnable state, so feel free to explore and experiment.

* * *

>help
Your goal is simply to leave the station and find other people.

You can start by looking around and leaving your initial location.

By the way, it should be impossible to put this game into an unwinnable state, so feel free to explore and experiment.

If you are having trouble getting started, I suggest reading A Beginner's Guide to Interactive Fiction by Stephen Granade and Emily Short, available at:

  https://brasslantern.org/players/howto/beginnersguide.html

[If you prefer not to be tempted by further hints, you can type "hints off" to disable them.]

>help
You can start by looking around and leaving your initial location.

>help
boo.
Your goal is simply to leave the station and find other people. You can start by looking around and leaving your initial location.

* * *

>help
You can start by looking around and leaving your initial location.

>restart
Are you sure you want to restart?

* * *

>help
Your goal is simply to leave the station and find other people.

You can start by looking around and leaving your initial location.

By the way, it should be impossible to put this game into an unwinnable state, so feel free to explore and experiment.

If you are having trouble getting started, I suggest reading A Beginner's Guide to Interactive Fiction by Stephen Granade and Emily Short, available at:

  https://brasslantern.org/players/howto/beginnersguide.html

[If you prefer not to be tempted by further hints, you can type "hints off" to disable them.]

>hint
Your goal is simply to leave the station and find other people. You can start by looking around and leaving your initial location.

>help
Your goal is simply to leave the station and find other people. You can start by looking around and leaving your initial location.

>score
You have so far scored 0 out of a possible 50, in 4 turns.

>about
About Founder's Mercy
Founder's Mercy is my second released Inform project, conceived and implemented in November of 2018.

Thanks to Graham Nelson, Andrew Plotkin, Emily Short, and everyone else who contributed to the Inform and Glulx ecosystem. Thanks also to Eric Eve for the Exit Lister extension, Juhana Leinonen for the Object Response Tests extension, and Sean Turner for the Plugs and Sockets extension. The cover art is adapted from Figure 1.1 from NASA SP-413, Space Settlements: A Design Study, edited by Richard D. Johnson and Charles Holbrow, and available from The Internet Archive at https://archive.org/details/SpaceSettlementsADesignStudy1977 .

Please send your feedback, bug reports, and requests for help to tinsel@tinsel.org. You can always find the current version of this game at http://tinsel.org/IF/ .

This work is Copyright  2018 Thomas Insel but may be freely shared according to the terms of the Creative Commons Attribution 4.0 International license (https://creativecommons.org/licenses/by/4.0/).

>hints off
Disabling hints is irreversible.

Are you sure?

>yes
Ok. Hints are now disabled.

>scenes
Scene 'Entire Game' playing (for 3 mins now)
Scene 'Beginning' playing (for 3 mins now)
(Scene monitoring now switched on. Type "scenes off" to switch it off again.)

>look
Home
The room where you've slept your entire life. You can go out towards the crops.

There is a secured hatch in the floor.

>look
Home
The room where you've slept your entire life. You can go out towards the crops.

There is a secured hatch in the floor.

>show girl
You can't see any such thing.

* * *

>help disable
I only understood you as far as wanting to help.

>disable help
Disabling hints is irreversible.

Are you sure?

>no
Ok. Hints remain available.

>disable help
Disabling hints is irreversible.

Are you sure?

>yes
Ok. Hints are now disabled.

>help
You have disabled hints, but don't despair. It is still impossible to put this game into an unwinnable state, so feel free to explore and experiment.

>restart
Are you sure you want to restart?

* * *

>help
Your objective is simply to leave the station and find other people.

You can start by looking around and leaving your initial location.

By the way, it should be impossible to put this game into an unwinnable state, so feel free to explore and experiment.

If you are having trouble getting started, I suggest reading A Beginner's Guide to Interactive Fiction by Stephen Granade and Emily Short, available at:

  https://brasslantern.org/players/howto/beginnersguide.html

[If you prefer not to be tempted by further hints, you can type "hints off" to disable them.]

>help
You can start by looking around and leaving your initial location.

>gonear hatch
(the floor hatch)
Home
The room where you've slept your entire life. You can go out towards the crops.

There is a secured hatch in the floor.

>gonear display
Pod Control
This room serves as an airlock for the pod bay, and holds an old space suit and various machinery such as the atmosphere pump. There is a brass plaque on the wall.

There is a secured hatch in the ceiling.

Beside the secured port hatch, a status display shows an error message.

>help
You need to repair some things. Check out the status display in Pod Control.

>x display
Pod bay locked down
 1. Telemetry sensor array offline - reset breaker FM36-87/A @ hub platform
 2. Launch system cooling loop offline - reset breaker FM29-63/A @ Sector 2
 3. Pod control atmosphere pump offline - scan and repair

>help
You need to repair three things, so you get three hints:

   Explore a bit more.
   Reset a circuit breaker somewhere in Sector 2.
   Now might be a good time to try out the scanner.

>restart
Are you sure you want to restart?

* * *

>hint
Your objective is simply to leave the station and find other people.

You can start by looking around and leaving your initial location.

By the way, it should be impossible to put this game into an unwinnable state, so feel free to explore and experiment.

If you are having trouble getting started, I suggest reading A Beginner's Guide to Interactive Fiction by Stephen Granade and Emily Short, available at:

  https://brasslantern.org/players/howto/beginnersguide.html

[You can type "hint" any time if you need assistance. If you prefer not to be tempted, you can type "hints off" to disable hints.]

>gonear display
Pod Control
This room serves as an airlock for the pod bay, and holds an old space suit and various machinery such as the atmosphere pump. There is a brass plaque on the wall.

There is a secured hatch in the ceiling.

Beside the secured port hatch, a status display shows an error message.

>hint
You need to fix some things. Check out the status display in Pod Control.

>x display
Pod bay locked down
 1. Telemetry sensor array offline - reset breaker FM36-87/A @ hub platform
 2. Launch system cooling loop offline - reset breaker FM29-63/A @ Sector 2
 3. Pod control atmosphere pump offline - scan and repair

>hint
You need to fix some things....
You need to explore a bit more.
According to the status display, you need to rest a circuit breaker somewhere in Sector 2.
According to the status display, you need to fix the atmosphere pump. Now might be a good time to try out the scanner.

* * *

>gonear scanner
Home
The room where you've slept your entire life. You can go out towards the crops.

There is a secured hatch in the floor.

>gonear display
Pod Control
This room serves as an airlock for the pod bay, and holds an old space suit and various machinery such as the atmosphere pump. There is a brass plaque on the wall.

There is a secured hatch in the ceiling.

Beside the secured port hatch, a status display shows an error message.

* * *

>x display
Pod bay locked down
 1. Telemetry sensor array offline - reset breaker FM36-87/A @ hub platform
 2. Launch system cooling loop offline - reset breaker FM29-63/A @ Sector 2
 3. Pod control atmosphere pump offline - scan and repair

>hint
You need to repair three things:

 1. Explore a bit more.

 2. Reset a circuit breaker somewhere in Sector 2.

 3. Now might be a good time to try out the scanner.

>i
You are carrying:
  a scanner
  a green jumpsuit (being worn)

>scanner, scan pump
Machine is failed.

>hint
You need to repair three things:

 1. Explore a bit more.

 2. Reset a circuit breaker somewhere in Sector 2.

 3. Now might be a good time to try out the scanner.

* * *

>hints off
Disabling hints is irreversible.

Are you sure?

>no
Ok. Hints remain available.

* * *

>hit me
Imperfect vessel that you are, that is not the answer.

>hit eraser
You can't see any such thing.

>hit hatch
The Founder said that violence is never the answer.

>puloin eraser
That's not a verb I recognize.

>purloin eraser
[Purloined.]

* * *

>hit eraser
Nothing happens.

>hit hatch
The Founder said that violence is never the answer.

* * *

>i
You are carrying:
  a scanner
  a green jumpsuit (being worn)

>gonear hatch
(the floor hatch)
Home
The room where you've slept your entire life. You can go out towards the crops.

There is a secured hatch in the floor.

>x hatch
You have been well-trained, because the hatch in the floor is secured shut.

>loo
That's not a verb I recognize.

>look
Home
The room where you've slept your entire life. You can go out towards the crops.

There is a secured hatch in the floor.

>out
Sector 4: Crops
Your home is here among the crops. You can walk spinward or antispinward.

* * *

>x crops
Greens, carrots, and potatoes.

>x carrots
Greens, carrots, and potatoes.

>get carrots
They're hardly portable.

>restart
Are you sure you want to restart?

>yes
You awake. You are lonely, so lonely. It was a thousand days ago today. All alone these thousand days. Your parents were the last. No, your father was the last. He held on for nearly a hundred days longer. No, you are the last. Alone. Adrift.

But maybe it isn't hopeless. There must still be other people in other worlds, and you think you know how to get there.

Today is the day.

Founder's Mercy
A Space Story by Thomas Insel
Release 1 / Serial number 181125 / Inform 7 build 6M62 (I6/v6.33 lib 6/12N) SD
Type "about" for credits or "hint" for assistance.

Home
The room where you've slept your entire life. You can go out towards the crops.

There is a secured hatch in the floor.

>out
Sector 4: Crops
Your home is here among the crops. You can walk spinward or antispinward.

* * *

>i
You are carrying:
  a scanner
  a green jumpsuit (being worn)

>gonear scanner
Home
The room where you've slept your entire life. You can go out towards the crops.

There is a secured hatch in the floor.

>hint
Your goal is simply to leave the station and find other people. You can start by looking around and leaving your initial location.

By the way, it should be impossible to put this game into an unwinnable state, so feel free to explore and experiment.

If you are having trouble getting started, I suggest reading A Beginner's Guide to Interactive Fiction by Stephen Granade and Emily Short, available at:

  https://brasslantern.org/players/howto/beginnersguide.html

[If you prefer not to be tempted by further hints, you can type "hints off" to disable them.]

* * *

>hint
Your goal is simply to leave the station and find other people. You can start by looking around and leaving your initial location.

>gonear display
Pod Control
This room serves as an airlock for the pod bay, and holds an old space suit and various machinery such as the atmosphere pump. There is a brass plaque on the wall.

There is a secured hatch in the ceiling.

Beside the secured port hatch, a status display shows an error message.

* * *

>hint
You need to fix some things. Check out the status display in Pod Control.

>x display
Pod bay locked down
Diagnosis: telemetry sensor array offline
Remediation: reset breaker FM36-87/A @ hub platform

>z.z.z.z.z.z.z.z.z.z.
Time passes.

Time passes.

Time passes.

Time passes.

Time passes.

Time passes.

Time passes.

Time passes.

Time passes.

Time passes.

>z.z.z.z.z.z.z.z.z.z.
Time passes.

Time passes.

Time passes.

Time passes.

Time passes.

Time passes.

Time passes.

Time passes.

Time passes.

Time passes.

>hint
You need to explore a bit more.

>gonear boots
Supply Vault
This room is dim, quiet, and stuffy. There is still a crate of machine parts left.

There is a secured hatch in the ceiling.

You can also see some pair of gravity boots here.

>hint
You have seen what you need to reset the circuit breaker.

>get boots
Taken.

* * *

>u
An alarm sounds, and a synthesized voice says "Laser scan detects unauthorized materiel removal." The hatch seems to be locked.

>hint
You need to evade the alarm, but first explore a bit more.

>out
But you aren't in anything at the moment.

>drop boots
Dropped.

>gonear learning
School
A broken learning machine remains in a corner, but mostly the older farmers took turns leading the class. There is a desk, and a chalkboard hangs on one wall.

On the desk is a clean eraser.

>i
You are carrying:
  a scanner
  a green jumpsuit (being worn)

>hint
You need to evade the alarm. You have seen what you need, but it needs some preparation.

>get eraser
Taken.

* * *

>erase board
(with the eraser)
You carefully erase the chalkboard.

>hint
You have completed the necessary preparation to avoid the alarm.

>hint
You have completed the necessary preparation to avoid the alarm.

>hit eraser
You fill the area with a cloud of dust, which quickly clears.

>hint
You seem to have figured out the trick to avoiding the alarm.

>gonear boots
Supply Vault
This room is dim, quiet, and stuffy. There is still a crate of machine parts left.

There is a secured hatch in the ceiling.

You can also see some pair of gravity boots here.

* * *

>z
Time passes.

The cloud of dust finally dissipates.

>z
Time passes.

>look
Supply Vault
This room is dim, quiet, and stuffy. There is still a crate of machine parts left.

There is a secured hatch in the ceiling.

>x hatch
You have been well-trained, because the hatch in the ceiling is secured shut.

>u
An alarm sounds, and a synthesized voice says "Laser scan detects unauthorized materiel removal." The hatch seems to be locked.

>get boots
(putting the scanner into your pocket to make room)
You already have those.

>hit eraser
You fill the vault with a cloud of dust and you can now see a laser beam scanning across the hatch.

* * *

>u
You maneuver around the laser beam.

(first opening the ceiling hatch)
You pull yourself up through the hatch and close it behind yourself.

Sector 6: Hydroponics
Your people preferred to grow things the old fashioned way, but in truth the majority of your fruit and vegetables came from this sector when the machines still worked. You can walk spinward or antispinward.

There is a secured hatch in the ground.

[Your score has just gone up by five points.]

>hint
You have what you need to reset the circuit breaker, but you need to figure out where to use it.

* * *

>x jumpsuit
You have worn modest jumpsuits like this since you were small. Originally, the colors had meanings: green for farmers, blue for technicians, and so on, but that distinction died even before the population.

It features a single large pocket, currently empty.

>put scanner in pocket
You put the scanner into the pocket.

>x pocket
In the pocket is a scanner.

>i
You are carrying:
  a green jumpsuit (being worn)

Your jumpsuit pocket contains:
  a scanner

>get all from pocket
Taken.

>i
You are carrying:
  a scanner
  a green jumpsuit (being worn)

>x pocket
The pocket is empty.

* * *

>listobj
Founder's Testament
Hydroponics machines (F) (S)
Laser beam (F) (S)
almond socket (P)
altar (F) (S)
atmosphere pump (F)
audio unit (F) (S)
barn (F) (S)
beige socket (P)
berths (F) (S)
brass plaque (F) (S)
chalkboard (F) (S)
church (F) (S)
clean eraser
crate of machine parts (F) (S)
crops (F) (S)
desk (F) (S)
doll
emergency communications unit
emergency mask
fish (F) (S)
graveyard (F) (S)
gray cable
green circuit breaker (F)
green jumpsuit
home (F) (S)
hub (F) (S)
instruction module
instruction module
junk repository
learning machine (F)
light-meter (F) (S)
maintenance platform (F) (S)
mirrors (F) (S)
organ (F) (S)
pair of gravity boots
plow (F) (S)
pocket (P)
pond (F) (S)
power module
power module
power module
pressure regulation module
pressure regulation module
red circuit breaker (F)
scanner
school building (F) (S)
solar panels (F) (S)
some trees (F) (S)
some trees (F) (S)
space suit (F) (S)
status display (F) (S)
tan socket (P)
the floor hatch (F)
the floor hatch (F)
the floor hatch (F)
the house (F) (S)
the pylon (F) (S)
the pylon (F) (S)
the pylon (F) (S)
usb plug (P)
usb plug (P)
vegetables (F) (S)
wall hatch (F)
yourself

* * *

>modules
That's not a verb I recognize.

>version
Founder's Mercy
A Space Story by Thomas Insel
Release 1 / Serial number 181127 / Inform 7 build 6M62 (I6/v6.33 lib 6/12N) SD
Type "about" for credits or "hint" for assistance.
Identification number: //BCC61E7F-CE8E-4C25-9E9D-5550D1138D8C//
Interpreter version 0.5.2 / VM 3.1.2 / Library serial number 080126
Standard Rules version 3/120430 by Graham Nelson
Unicode Character Names by Graham Nelson
Exit Lister version 11 by Eric Eve
Plugs and Sockets version 4 by Sean Turner
Object Response Tests version 7 by Juhana Leinonen

* * *

>n
You have heard of compass directions like north, but they don't make any sense here. Instead, you can go spinward, antispinward, port, and starboard. When you look spinward, port is left and starboard is right.

[You can use the abbreviations "sw", "asw", "p", and "s". You can also go "up", "down", "in", and "out" where appropriate. Type "exits" if you get confused about geography.]

>n
You have heard of compass directions like north, but they don't make any sense here. Instead, you can go spinward, antispinward, port, and starboard. When you look spinward, port is left and starboard is right.

>n
You have heard of compass directions like north, but they don't make any sense here. Instead, you can go spinward, antispinward, port, and starboard. When you look spinward, port is left and starboard is right.

* * *

>north
You have heard of compass directions like north, but they don't make any sense here. Instead, you can go spinward, antispinward, port, and starboard. When you look spinward, port is left and starboard is right.

[You can use the abbreviations "sw", "asw", "p", and "s". You can also go "up", "down", "in", and "out" where appropriate. Type "exits" if you get confused about geography.]

>g
You have heard of compass directions like north, but they don't make any sense here. Instead, you can go spinward, antispinward, port, and starboard. When you look spinward, port is left and starboard is right.

>g
You have heard of compass directions like north, but they don't make any sense here. Instead, you can go spinward, antispinward, port, and starboard. When you look spinward, port is left and starboard is right.

>hint
Your objective is simply to leave the station and find other people.

You can start by looking around and leaving your initial location.

By the way, it should be impossible to put this game into an unwinnable state, so feel free to explore and experiment.

If you are having trouble getting started, I suggest reading A Beginner's Guide to Interactive Fiction by Stephen Granade and Emily Short, available at:

  https://brasslantern.org/players/howto/beginnersguide.html

[You can type "hint" any time for contextual assistance. If you prefer not to be tempted, you can type "hints off" to disable hints.]

>hint
You can start by looking around and leaving your initial location.

>about
About Founder's Mercy
Founder's Mercy is my second released Inform project, conceived and implemented in November of 2018.

Thanks to Graham Nelson, Andrew Plotkin, Emily Short, and everyone else who contributed to the Inform and Glulx ecosystem. Thanks also to Eric Eve for the Exit Lister extension, Juhana Leinonen for the Object Response Tests extension, and Sean Turner for the Plugs and Sockets extension. The cover art is adapted from Figure 1.1 from NASA SP-413, Space Settlements: A Design Study, edited by Richard D. Johnson and Charles Holbrow, and available from The Internet Archive at https://archive.org/details/SpaceSettlementsADesignStudy1977 .

Please send your feedback, bug reports, and requests for help to tinsel@tinsel.org. You can always find the current version of this game at http://tinsel.org/IF/ .

This work is Copyright  2018 Thomas Insel but may be freely shared according to the terms of the Creative Commons Attribution 4.0 International license (https://creativecommons.org/licenses/by/4.0/).

>version
Founder's Mercy
A Space Story by Thomas Insel
Release 1 / Serial number 181126 / Inform 7 build 6M62 (I6/v6.33 lib 6/12N) SD
Type "about" for credits or "hint" for assistance.
Identification number: //BCC61E7F-CE8E-4C25-9E9D-5550D1138D8C//
Interpreter version 0.5.2 / VM 3.1.2 / Library serial number 080126
Standard Rules version 3/120430 by Graham Nelson
Unicode Character Names by Graham Nelson
Exit Lister version 11 by Eric Eve
Plugs and Sockets version 4 by Sean Turner
Object Response Tests version 7 by Juhana Leinonen

>about
About Founder's Mercy
Founder's Mercy is my second released Inform project, conceived and implemented in November of 2018.

Thanks to Graham Nelson, Andrew Plotkin, Emily Short, and everyone else who contributed to the Inform and Glulx ecosystem. Thanks also to Eric Eve for the Exit Lister extension, Juhana Leinonen for the Object Response Tests extension, and Sean Turner for the Plugs and Sockets extension. The cover art is adapted from Figure 1.1 from NASA SP-413, Space Settlements: A Design Study, edited by Richard D. Johnson and Charles Holbrow, and available from The Internet Archive at https://archive.org/details/SpaceSettlementsADesignStudy1977 .

Please send your feedback, bug reports, and requests for help to tinsel@tinsel.org. You can always find the current version of this game at http://tinsel.org/IF/ .

This work is Copyright  2018 Thomas Insel but may be freely shared according to the terms of the Creative Commons Attribution 4.0 International license (https://creativecommons.org/licenses/by/4.0/).

* * *

>nroth
That's not a verb I recognize.

>north
You have heard of compass directions like north, but they don't make any sense here. Instead, you can go spinward, antispinward, port, and starboard. When you look spinward, port is left and starboard is right.

X.

>north
You have heard of compass directions like north, but they don't make any sense here. Instead, you can go spinward, antispinward, port, and starboard. When you look spinward, port is left and starboard is right.

X.

* * *

>objects
That's not a verb I recognize.

>rtree
Barn
    the plow
Cellar
    the emergency mask
Center Platform
    the red circuit breaker
Church
    the altar + Founder's Testament 
    the organ & tan socket
    the audio unit + faulty power module & beige socket
    the gray cable & usb plug and usb plug
Home
    yourself + green jumpsuit, pocket, and scanner 
House
    the doll
Pod Bay
    the berths
    the emergency communications unit & almond socket
Pod Control
    the space suit
    the brass plaque
    the status display
    the atmosphere pump + faulty power module and faulty pressure regulation module 
School
    the learning machine + faulty instruction module and functional power module 
    the desk + clean eraser 
    the chalkboard
Sector 1: Crops
    the pylon
    the crops
    the graveyard
Sector 2: Aquaculture
    the pond
    the fish
Sector 3: Forest
    the pylon
    the trees
Sector 4: Crops
    the vegetables
Sector 5: Forest
    the pylon
    the trees
Sector 6: Hydroponics
    the hydroponics machines
Supply Vault
    the crate of machine parts
    the pair of gravity boots

* * *

>out
Sector 4: Crops
Your home is here among the crops. You can walk spinward or antispinward.

* * *

>asw
You walk a little ways to the next sector.

Sector 1: Crops
You still maintain the crops here. There is a small graveyard and the barn remains from when this was the livestock sector. A pylon stretches up from the ground to the hub of the station. You can walk spinward or antispinward.

There is a secured hatch in the ground.

>asw
You walk a little ways to the next sector.

Sector 6: Hydroponics
Your people preferred to grow things the old fashioned way, but in truth the majority of your fruit and vegetables came from this sector when the machines still worked. You can walk spinward or antispinward.

There is a secured hatch in the ground.

>asw
You walk a little ways to the next sector.

Sector 5: Forest
The school house is nestled among the trees. A pylon stretches up from the same grove to the hub of the station. You can walk spinward or antispinward.

You have walked the entire ring. Everything is as expected, much is not working. Now, it's time to leave. The pods are below Sector 1.

>scenes
Scene 'Entire Game' playing (for 6 mins now)
Scene 'Beginning' ended
Scene 'Repairing Pod Bay' playing (for 1 mins now)
Scene 'Repairing Red Breaker' playing (for 1 mins now)
Scene 'Repairing Green Breaker' playing (for 1 mins now)
Scene 'Repairing Atmosphere Pump' playing (for 1 mins now)
(Scene monitoring now switched on. Type "scenes off" to switch it off again.)

>sw
You walk a little ways to the next sector.

Sector 6: Hydroponics
Your people preferred to grow things the old fashioned way, but in truth the majority of your fruit and vegetables came from this sector when the machines still worked. You can walk spinward or antispinward.

There is a secured hatch in the ground.

* * *

>sw
You walk a little ways to the next sector.

Sector 1: Crops
You still maintain the crops here. There is a small graveyard and the barn remains from when this was the livestock sector. A pylon stretches up from the ground to the hub of the station. You can walk spinward or antispinward.

There is a secured hatch in the ground.

>d
(first opening the floor hatch)
You scramble down through the hatch and close it behind yourself.

Pod Control
This room serves as an airlock for the pod bay, and holds an old space suit and various machinery such as the atmosphere pump. There is a brass plaque on the wall.

There is a secured hatch in the ceiling.

Beside the secured port hatch, a status display shows an error message.

>gonear red
(the red circuit breaker)
Center Platform
It's a mesh platform a little below the hub. You feel much lighter here, and you are very aware of how the station rotates, but everything is okay as long as you don't look down.

You can just reach a red circuit breaker on the hub.

* * *

>turn red on
You switch the red circuit breaker on.

[Scene 'Repairing Red Breaker' ends]
[Your score has just gone up by five points.]

>scenes
Scene 'Entire Game' playing (for 11 mins now)
Scene 'Beginning' ended
Scene 'Repairing Pod Bay' playing (for 6 mins now)
Scene 'Repairing Red Breaker' ended
Scene 'Repairing Green Breaker' playing (for 6 mins now)
Scene 'Repairing Atmosphere Pump' playing (for 6 mins now)
(Scene monitoring now switched on. Type "scenes off" to switch it off again.)

>gonear pond
Sector 2: Aquaculture
A deep pond is used as part of the water filtration system and for raising fish. You can walk spinward or antispinward.

>purloin boots
[Purloined.]

* * *

>wear boots
You put on the pair of gravity boots.

>enter pond
You can't hold your breath long enough to make that worthwhile.

>purloin mask
[Purloined.]

* * *

>wear mask
You put on the emergency mask.

>enter pond
WIth the air from the emergency mask, you breathe comfortably as you step into the pond. At the bottom, you find a green circuit breaker and flip it on.

[Scene 'Repairing Green Breaker' ends]
[Your score has just gone up by ten points.]

>scenes
Scene 'Entire Game' playing (for 16 mins now)
Scene 'Beginning' ended
Scene 'Repairing Pod Bay' playing (for 11 mins now)
Scene 'Repairing Red Breaker' ended
Scene 'Repairing Green Breaker' ended
Scene 'Repairing Atmosphere Pump' playing (for 11 mins now)
(Scene monitoring now switched on. Type "scenes off" to switch it off again.)

* * *

>x pylon
Made of smooth metal, it connects the ground to the hub of the station many meters above.

>sw
You walk a little ways to the next sector.

Sector 2: Aquaculture
A deep pond is used as part of the water filtration system and for raising fish. You can walk spinward or antispinward.

* * *

>sw
You walk a little ways to the next sector.

Sector 3: Forest
Trees, a house, and a church. A red pylon stretches up from the ground to the hub of the station. You can walk spinward or antispinward.

>drop pylon
The pylon is already here.

>drop tree
The trees are already here.

>rtree
Barn
    the plow
Cellar
    the emergency mask
Center Platform
    the red circuit breaker
Church
    the altar + Founder's Testament
    the organ
    the audio unit + power module
    the gray cable
Home
House
    the doll
Pod Bay
    the berths
    the emergency communications unit
Pod Control
    the space suit
    the brass plaque
    the status display
    the atmosphere pump + power module and pressure regulation module
School
    the learning machine + instruction module and power module
    the desk + clean eraser
    the chalkboard
Sector 1: Crops
    the pylon
    the crops
    the graveyard
Sector 2: Aquaculture
    the pond
    the fish
Sector 3: Forest
    the maintenance platform
    the mirrors
    the solar panels
    the hub
    yourself + green jumpsuit, pocket, and scanner
    the pylon
    the trees
Sector 4: Crops
    the vegetables
Sector 5: Forest
    the pylon
    the trees
Sector 6: Hydroponics
    the hydroponics machines
Supply Vault
    the crate of machine parts
    the pair of gravity boots

* * *

>sw
You walk a little ways to the next sector.

Sector 3: Forest
Trees, a house, and a church. A red pylon stretches up from the ground to the hub of the station. You can walk spinward or antispinward.

>d
You can't go that way.

>asw
You walk a little ways to the next sector.

Sector 2: Aquaculture
A deep pond is used as part of the water filtration system and for raising fish. You can walk spinward or antispinward.

* * *

>d
(first opening the floor hatch)
You scramble down through the hatch and close it behind yourself.

Pod Control
This room serves as an airlock for the pod bay, and holds an old space suit and various machinery such as the atmosphere pump. There is a brass plaque on the wall.

There is a secured hatch in the ceiling.

Beside the secured port hatch, a status display shows an error message.

>hint
You need to fix some things. Check out the status display in Pod Control.

By the way, it should be impossible to put this game into an unwinnable state, so feel free to explore and experiment.

If you are having trouble getting started, I suggest reading A Beginner's Guide to Interactive Fiction by Stephen Granade and Emily Short, available at:

  https://brasslantern.org/players/howto/beginnersguide.html

[If you prefer not to be tempted by further hints, you can type "hints off" to disable them.]

>x display
Pod bay locked down

Telemetry sensor array offline - reset breaker FM36-87/A @ hub platform

Launch system cooling loop offline - reset circuit breaker FM29-63/A @ Sector 2

Pod control atmosphere pump offline - scan and repair

>hint
You need to explore a bit more.

* * *

>d
You can't go that way.

>sw
You walk a little ways to the next sector.

Sector 4: Crops
Your home is here among the crops. You can walk spinward or antispinward.

* * *

>sw
You walk a little ways to the next sector.

Sector 6: Hydroponics
Your people preferred to grow things the old fashioned way, but in truth the majority of your fruit and vegetables came from this sector when the machines still worked. You can walk spinward or antispinward.

There is a secured hatch in the ground.

>sw
You walk a little ways to the next sector.

Sector 1: Crops
You still maintain the crops here. There is a small graveyard and the barn remains from when this was the livestock sector. A pylon stretches up from the ground to the hub of the station. You can walk spinward or antispinward.

There is a secured hatch in the ground.

You have walked the entire ring. Everything is as expected, much is not working. Now, it's time to leave. The pods are below Sector 1.

>d
(first opening the floor hatch)
You scramble down through the hatch and close it behind yourself.

Pod Control
This room serves as an airlock for the pod bay, and holds an old space suit and various machinery such as the atmosphere pump. There is a brass plaque on the wall.

There is a secured hatch in the ceiling.

Beside the secured port hatch, a status display shows an error message.

>x status
Pod bay locked down
Diagnosis: telemetry sensor array offline
Remediation: reset breaker FM36-87/A @ hub platform

>help
1.
According to the status display, you need to reset a circuit breaker on the hub platform.
There is more help available about this topic. Try again if you are sure you need it.

By the way, it should be impossible to put this game into an unwinnable state, so feel free to explore and experiment.

If you are having trouble getting started, I suggest reading A Beginner's Guide to Interactive Fiction by Stephen Granade and Emily Short, available at:

  https://brasslantern.org/players/howto/beginnersguide.html

[If you prefer not to be tempted by further hints, you can type "hints off" to disable them.]

>help
2.
According to the status display, you need to reset a circuit breaker on the hub platform.
Two.
There is more help available about this topic. Try again if you are sure you need it.

>help
3.
According to the status display, you need to reset a circuit breaker on the hub platform.
Two.
Three.

>help
4.
According to the status display, you need to reset a circuit breaker on the hub platform.
Two.
Three.

* * *

>asw
You walk a little ways to the next sector.

Sector 3: Forest
Trees, a house, and a church. A red pylon stretches up from the ground to the hub of the station. You can walk spinward or antispinward.

>drop pylon
The pylon is already here.

>asw
You walk a little ways to the next sector.

Sector 2: Aquaculture
A deep pond is used as part of the water filtration system and for raising fish. You can walk spinward or antispinward.

* * *

>asw
You walk a little ways to the next sector.

Sector 1: Crops
You still maintain the crops here. There is a small graveyard and the barn remains from when this was the livestock sector. A pylon stretches up from the ground to the hub of the station. You can walk spinward or antispinward.

There is a secured hatch in the ground.

>drop pylon
The pylon is already here.

* * *

>out
Sector 4: Crops
Your home is here among the crops. You can walk spinward or antispinward.

>hint
Your goal is simply to leave the station and find other people. You can start by looking around and leaving your initial location.

By the way, it should be impossible to put this game into an unwinnable state, so feel free to explore and experiment.

If you are having trouble getting started, I suggest reading A Beginner's Guide to Interactive Fiction by Stephen Granade and Emily Short, available at:

  https://brasslantern.org/players/howto/beginnersguide.html

[If you prefer not to be tempted by further hints, you can type "hints off" to disable them.]

>scenes
Scene 'Entire Game' playing (for 2 mins now)
Scene 'Beginning' playing (for 2 mins now)
(Scene monitoring now switched on. Type "scenes off" to switch it off again.)

>gonear display
Pod Control
This room serves as an airlock for the pod bay, and holds an old space suit and various machinery such as the atmosphere pump. There is a brass plaque on the wall.

There is a secured hatch in the ceiling.

Beside the secured port hatch, a status display shows an error message.

[Scene 'Repairing Pod Bay' begins]
[Scene 'Beginning' ends]
[Scene 'Repairing Red Breaker' begins]
[Scene 'Repairing Green Breaker' begins]
[Scene 'Repairing Atmosphere Pump' begins]

>x display
Pod bay locked down
Diagnosis: telemetry sensor array offline
Remediation: reset breaker FM36-87/A @ hub platform

>z
Time passes.

>hint
According the the status display, you need to reset a circuit breaker on the hub platform.

>z.z.z.z.z.z.z.z.z.z.
Time passes.

Time passes.

Time passes.

Time passes.

Time passes.

Time passes.

Time passes.

Time passes.

Time passes.

Time passes.

>hint
According the the status display, you need to reset a circuit breaker on the hub platform.

You need to find something that will help.

>gonear eraser
School
A broken learning machine remains in a corner, but mostly the older farmers took turns leading the class. There is a desk, and a chalkboard hangs on one wall.

On the desk is a clean eraser.

* * *

>erase board
You smudge the writing around with your hand.

>get eraser
Taken.

* * *

>erase board
(with the eraser)
You carefully erase the chalkboard.

>hint
According the the status display, you need to reset a circuit breaker on the hub platform.

You need to find something that will help.

>gonear boots
Supply Vault
This room is dim, quiet, and stuffy. There is still a crate of machine parts left.

There is a secured hatch in the ceiling.

You can also see some pair of gravity boots here.

* * *

>hint
According the the status display, you need to reset a circuit breaker on the hub platform.

You have seen what you need.

>get boots
Taken.

>hint
According the the status display, you need to reset a circuit breaker on the hub platform.

You have seen what you need.

>u
An alarm sounds, and a synthesized voice says "Laser scan detects unauthorized materiel removal." The hatch seems to be locked.

>hint
According the the status display, you need to reset a circuit breaker on the hub platform.

You have seen what you need.

* * *

>out
Sector 4: Crops
Your home is here among the crops. You can walk spinward or antispinward.

>i
You are carrying:
  a scanner
  a green jumpsuit (being worn)

* * *

>out
Sector 4: Crops
Your home is here among the crops. You can walk spinward or antispinward.

>out
But you aren't in anything at the moment.

* * *

>asw
You walk a little ways to the next sector.

Sector 5: Forest
The school house is nestled among the trees. A pylon stretches up from the same grove to the hub of the station. You can walk spinward or antispinward.

You have walked the entire ring. Everything is as expected, much is not working. Now, it's time to leave. The pods are below Sector 1.

>asw
You walk a little ways to the next sector.

Sector 4: Crops
Your home is here among the crops. You can walk spinward or antispinward.

* * *

>hint
You need to fix something. Check out the status display in Pod Control.

By the way, it should be impossible to put this game into an unwinnable state, so feel free to explore and experiment.

If you are having trouble getting started, I suggest reading A Beginner's Guide to Interactive Fiction by Stephen Granade and Emily Short, available at:

  https://brasslantern.org/players/howto/beginnersguide.html

[If you prefer not to be tempted by further hints, you can type "hints off" to disable them.]

>x display
Pod bay locked down
Diagnosis: telemetry sensor array offline
Remediation: reset breaker FM36-87/A @ hub platform

>hint
0.
According to the status display, you need to reset a circuit breaker on the hub platform.

>hint
0.
According to the status display, you need to reset a circuit breaker on the hub platform.

* * *

>out
Sector 4: Crops
Your home is here among the crops. You can walk spinward or antispinward.

>scan solar
Machine is functional. Operating at 73% efficiency.

>scanner, scan solar
Machine is functional. Operating at 72% efficiency.

>scan me
No modular (2) technology detected.

* * *

>sw
You walk a little ways to the next sector.

Sector 5: Forest
The school house is nestled among the trees. A pylon stretches up from the same grove to the hub of the station. You can walk spinward or antispinward.

>drop house
The the school building is already here.

>out
But you aren't in anything at the moment.

>sw
You walk a little ways to the next sector.

Sector 6: Hydroponics
Your people preferred to grow things the old fashioned way, but in truth the majority of your fruit and vegetables came from this sector when the machines still worked. You can walk spinward or antispinward.

There is a secured hatch in the ground.

>asw
You walk a little ways to the next sector.

Sector 5: Forest
The school house is nestled among the trees. A pylon stretches up from the same grove to the hub of the station. You can walk spinward or antispinward.

* * *

>in
You can enter the church or the house.

>go house
House
Two families lived here, but not recently.

Someone has left a doll on the well swept floor.

* * *

>x doll
Wearing a brown jumpsuit and faceless, because we are all alike in the Founder's eyes.

>look
House
Two families lived here, but not recently.

Someone has left a doll on the well swept floor.

>out
Sector 3: Forest
Trees, a house, and a church. A red pylon stretches up from the ground to the hub of the station. You can walk spinward or antispinward.

>listobj
Founder's Testament
Hydroponics machines (F) (S)
Laser beam (F) (S)
S1B1 (F) (S)
almond socket (P)
altar (F) (S)
atmosphere pump (F)
audio unit (F) (S)
beige socket (P)
berths (F) (S)
brass plaque (F) (S)
chalkboard (F) (S)
church (F) (S)
clean eraser
crate of machine parts (F) (S)
crops (F) (S)
desk (F) (S)
doll
emergency communications unit
emergency mask
fish (F) (S)
graveyard (F) (S)
gray cable
green circuit breaker (F)
green jumpsuit
home (F) (S)
hub (F) (S)
instruction module
instruction module
junk repository
learning machine (F)
light-meter (F) (S)
maintenance platform (F) (S)
mirrors (F) (S)
organ (F) (S)
pair of gravity boots
pocket (P)
pond (F) (S)
power module
power module
power module
pressure regulation module
pressure regulation module
red circuit breaker (F)
scanner
solar panels (F) (S)
some trees (F) (S)
some trees (F) (S)
space suit (F) (S)
status display (F) (S)
tan socket (P)
the floor hatch (F)
the floor hatch (F)
the floor hatch (F)
the house (F) (S)
the pylon (F) (S)
the pylon (F) (S)
the pylon (F) (S)
the school building (F) (S)
usb plug (P)
usb plug (P)
vegetables (F) (S)
wall hatch (F)
yourself

>restart
Are you sure you want to restart?

>yes
You awake. You are lonely, so lonely. It was a thousand days ago today. All alone these thousand days. Your parents were the last. No, your father was the last. He held on for nearly a hundred days longer. No, you are the last. Alone. Adrift.

But maybe it isn't hopeless. There must still be other people in other worlds, and you think you know how to get there.

Today is the day.

Founder's Mercy
A Space Story by Thomas Insel
Release 1 / Serial number 181124 / Inform 7 build 6M62 (I6/v6.33 lib 6/12N) SD
Type "about" for credits or "help" for assistance.

Home
The room where you've slept your entire life. You can go out towards the crops.

There is a secured hatch in the floor.

>out
Sector 4: Crops
Your home is here among the crops. You can walk spinward or antispinward.

* * *

>sw
You walk a little ways to the next sector.

Sector 5: Forest
The school house is nestled among the trees. A pylon stretches up from the same grove to the hub of the station. You can walk spinward or antispinward.

>in
School
One broken learning machine remains in a corner, but mostly the older farmers took turns leading the class. There is a desk and a chalkboard hangs on one wall.

On the desk is a clean eraser.

>out
Sector 5: Forest
The school house is nestled among the trees. A pylon stretches up from the same grove to the hub of the station. You can walk spinward or antispinward.

* * *

>sw
You walk a little ways to the next sector.

Sector 6: Hydroponics
Your people preferred to grow things the old fashioned way, but in truth the majority of your fruit and vegetables came from this sector when the machines still worked. You can walk spinward or antispinward.

There is a secured hatch in the ground.

>in
You can't go that way.

>sw
You walk a little ways to the next sector.

Sector 1: Crops
You still maintain the crops here. There is a small graveyard and the barn remains from when this was the livestock sector. A pylon stretches up from the ground to the hub of the station. You can walk spinward or antispinward.

There is a secured hatch in the ground.

>in
Barn
Not fancy: livestock on one side and feed on the other, but nothing remains of either.

>look
Barn
Not fancy: livestock on one side and feed on the other, but nothing remains of either.

>x barn
You can't see any such thing.

>x livestock
You can't see any such thing.

>out
Sector 1: Crops
You still maintain the crops here. There is a small graveyard and the barn remains from when this was the livestock sector. A pylon stretches up from the ground to the hub of the station. You can walk spinward or antispinward.

There is a secured hatch in the ground.

>l
Sector 1: Crops
You still maintain the crops here. There is a small graveyard and the barn remains from when this was the livestock sector. A pylon stretches up from the ground to the hub of the station. You can walk spinward or antispinward.

There is a secured hatch in the ground.

>sw
You walk a little ways to the next sector.

Sector 2: Aquaculture
A deep pond is used as part of the water filtration system and for raising fish. You can walk spinward or antispinward.

>in
You can't go that way.

>sw
You walk a little ways to the next sector.

Sector 3: Forest
Trees, a house, and a church. A red pylon stretches up from the ground to the hub of the station. You can walk spinward or antispinward.

You have walked the entire ring. Everything is as expected, much is not working. Now, it's time to leave. The pods are below Sector 1.

>sw
You walk a little ways to the next sector.

Sector 4: Crops
Your home is here among the crops. You can walk spinward or antispinward.

>gohome
That's not a verb I recognize.

>go home
Home
The room where you've slept your entire life. You can go out towards the crops.

There is a secured hatch in the floor.

>out
Sector 4: Crops
Your home is here among the crops. You can walk spinward or antispinward.

>in
Home
The room where you've slept your entire life. You can go out towards the crops.

There is a secured hatch in the floor.

>d
(first opening the floor hatch)
You scramble down through the hatch and close it behind yourself.

Cellar
A decompression shelter and space for storage.

There is a secured hatch in the ceiling.

There is an emergency mask hanging on the wall.

>out
But you aren't in anything at the moment.

>up
(first opening the ceiling hatch)
You pull yourself up through the hatch and close it behind yourself.

Home
The room where you've slept your entire life. You can go out towards the crops.

There is a secured hatch in the floor.

>out
Sector 4: Crops
Your home is here among the crops. You can walk spinward or antispinward.

* * *

>in
You can't go that way.

>out
But you aren't in anything at the moment.

>x hydroponics
You were thoroughly trained in hydroponics maintenance, but fixing these machines is beyond you.

>fix machines
That's not a verb I recognize.

>scan machines
Machine failed.

>scanner, open machines
Opening failed.

>x fuit
You can't see any such thing.

>x fruit
You can't see any such thing.

>look
Sector 6: Hydroponics
Your people preferred to grow things the old fashioned way, but in truth the majority of your fruit and vegetables came from this sector when the machines still worked. You can walk spinward or antispinward.

There is a secured hatch in the ground.

>sw
You walk a little ways to the next sector.

Sector 1: Crops
You still maintain the crops here. There is a small graveyard and the barn remains from when this was the livestock sector. A pylon stretches up from the ground to the hub of the station. You can walk spinward or antispinward.

There is a secured hatch in the ground.

* * *

>d
(first opening the floor hatch)
You scramble down through the hatch and close it behind yourself.

Pod Control
This room serves as an airlock for the pod bay, and holds an old space suit and various machinery such as the atmosphere pump. There is a brass plaque on the wall.

There is a secured hatch in the ceiling.

Beside the secured port hatch, a status display shows an error message.

>help
You need to fix something. Check out the status display in Pod Control.

By the way, it should be impossible to put this game into an unwinnable state, so feel free to explore and experiment.

If you are having trouble getting started, I suggest reading A Beginner's Guide to Interactive Fiction by Stephen Granade and Emily Short, available at:

  https://brasslantern.org/players/howto/beginnersguide.html

[If you prefer not to be tempted by further hints, you can type "hints off" to disable them.]

>help
You need to fix something. Check out the status display in Pod Control.

>look
Pod Control
This room serves as an airlock for the pod bay, and holds an old space suit and various machinery such as the atmosphere pump. There is a brass plaque on the wall.

There is a secured hatch in the ceiling.

Beside the secured port hatch, a status display shows an error message.

>x plaque
The plaque reads:

    RWSS Founder's Mercy
    Laid down 2238, Launched 2241.
    "May His mercy shine upon us."

>x suit
(the green jumpsuit)
You have worn modest jumpsuits like this since you were small. Originally, the colors had meanings: green for farmers, blue for technicians, and so on, but that distinction died even before the population.

It features a single large pocket, currently empty.

>scan space suit
Machine is failed.

>scan jumpsuit
No modular technology detected.

>look
Pod Control
This room serves as an airlock for the pod bay, and holds an old space suit and various machinery such as the atmosphere pump. There is a brass plaque on the wall.

There is a secured hatch in the ceiling.

Beside the secured port hatch, a status display shows an error message.

>scan pump
Machine is failed.

>scan machinery
Machine is failed.

>x machinery
The atmosphere pump is a smooth featureless machine.

>look
Pod Control
This room serves as an airlock for the pod bay, and holds an old space suit and various machinery such as the atmosphere pump. There is a brass plaque on the wall.

There is a secured hatch in the ceiling.

Beside the secured port hatch, a status display shows an error message.

>u
(first opening the ceiling hatch)
You pull yourself up through the hatch and close it behind yourself.

Sector 1: Crops
You still maintain the crops here. There is a small graveyard and the barn remains from when this was the livestock sector. A pylon stretches up from the ground to the hub of the station. You can walk spinward or antispinward.

There is a secured hatch in the ground.

>sw
You walk a little ways to the next sector.

Sector 2: Aquaculture
A deep pond is used as part of the water filtration system and for raising fish. You can walk spinward or antispinward.

* * *

>sw
You walk a little ways to the next sector.

Sector 6: Hydroponics
Your people preferred to grow things the old fashioned way, but in truth the majority of your fruit and vegetables came from this sector when the machines still worked. You can walk spinward or antispinward.

There is a secured hatch in the ground.

>n
You have heard of compass directions like north, but they don't make any sense here. Instead, you can go spinward, antispinward, port, and starboard. When you look spinward, port is left and starboard is right.

[You can use the abbreviations "sw", "asw", "p", and "s". You can also go "up", "down", "in", and "out" where appropriate. Type "exits" if you get confused about geography.]

* * *

>sw
You walk a little ways to the next sector.

Sector 2: Aquaculture
A deep pond is used as part of the water filtration system and for raising fish. You can walk spinward or antispinward.

>sw
You walk a little ways to the next sector.

Sector 3: Forest
Trees, a house, and a church. A red pylon stretches up from the ground to the hub of the station. You can walk spinward or antispinward.

You have walked the entire ring. Everything is as expected, much is not working. Now, it's time to leave. The pods are below Sector 1.

* * *

>play hatch
You don't know how to play that.

>i
You are carrying:
  a scanner
  a green jumpsuit (being worn)

>out
Sector 4: Crops
Your home is here among the crops. You can walk spinward or antispinward.

>play crops
You don't know how to play those.

>exits
The obvious exits are inside (to home), spinward and antispinward.

[Type "exits off" to disable the status line exit list and "exits on" to turn it back on.]

>ne
You have heard of compass directions like northeast, but they don't make any sense here. Instead, you can go spinward, antispinward, port, and starboard. When you look spinward, port is left and starboard is right.

[You can use the abbreviations "sw", "asw", "p", and "s". You can also go "up", "down", "in", and "out" where appropriate. Type "exits" if you get confused about geography.]

>ne
You have heard of compass directions like northeast, but they don't make any sense here. Instead, you can go spinward, antispinward, port, and starboard. When you look spinward, port is left and starboard is right.

>nw
You have heard of compass directions like northwest, but they don't make any sense here. Instead, you can go spinward, antispinward, port, and starboard. When you look spinward, port is left and starboard is right.

>in
Home
The room where you've slept your entire life. You can go out towards the crops.

There is a secured hatch in the floor.

>out
Sector 4: Crops
Your home is here among the crops. You can walk spinward or antispinward.

>ou
That's not a verb I recognize.

>out
But you aren't in anything at the moment.

>s
You can't go that way.

>p
You can't go that way.

* * *

>purloin all pressure modules
[Purloined.]
[Purloined.]

>i
You are carrying:
  two pressure regulation modules
  a scanner
  a green jumpsuit (being worn)

>x module
It is a standardized machine module.

>scan module
Component is functional.

>look
Home
The room where you've slept your entire life. You can go out towards the crops.

There is a secured hatch in the floor.

>i
You are carrying:
  a functional pressure regulation module
  an unscanned pressure regulation module
  a scanner
  a green jumpsuit (being worn)

>x functional
The scanner reported that this pressure regulation module is functional.

>x unscanned
It is a standardized machine module.

* * *

>purloin all regulators
[Purloined.]
[Purloined.]

>i
You are carrying:
  two pressure regulation modules
  a scanner
  a green jumpsuit (being worn)

>x pressure module
It is a standardized machine module.

>scan module
Component is functional.

>scan unscanned module
Component is faulty.

>look
Home
The room where you've slept your entire life. You can go out towards the crops.

There is a secured hatch in the floor.

>i
You are carrying:
  a functional pressure regulation module
  a faulty pressure regulation module
  a scanner
  a green jumpsuit (being worn)

>scan faulty module
Component is faulty.

>x faulty module
It is a standardized machine module.

The scanner reported this pressure regulation module as faulty.

* * *

>purloin comms
[Purloined.]

* * *

>x comms
A portable emergency communications unit with a single socket to connect it to a transit pod or other audio source.

The emergency communications unit has nothing plugged into it.

>hint
Your goal is simply to leave the station and find other people. You can start by looking around and leaving your initial location.

By the way, it should be impossible to put this game into an unwinnable state, so feel free to explore and experiment.

If you are having trouble getting started, I suggest reading A Beginner's Guide to Interactive Fiction by Stephen Granade and Emily Short, available at:

  https://brasslantern.org/players/howto/beginnersguide.html

[If you prefer not to be tempted by further hints, you can type "hints off" to disable them.]

* * *

>rlist
That's not a verb I recognize.

>rtree
Barn
    the plow
Cellar
    the emergency mask
Center Platform
    the red circuit breaker
Church
    the altar
        * The Founder's Testament
    the organ
    the audio unit
        - a power module
    the gray cable
Home
    the floor hatch
    yourself
House
    the doll
Pod Bay
    the berths
    the emergency communications unit
Pod Control
    the wall hatch
    the space suit
    the brass plaque
    the status display
    the atmosphere pump
        - a power module and a pressure regulation module
School
    the learning machine
        - a power module and an instruction module
    the desk
        * a clean eraser
    the chalkboard
Sector 1: Crops
    the floor hatch
    the the pylon
    the crops
    the graveyard
    the barn
Sector 2: Aquaculture
    the pond
    the fish
Sector 3: Forest
    the pylon
    the some trees
    the church
    the the house
Sector 4: Crops
    the home
    the vegetables
Sector 5: Forest
    the school building
    the the pylon
    the some trees
Sector 6: Hydroponics
    the floor hatch
    the hydroponics machines
Supply Vault
    the crate of machine parts
    the pair of gravity boots

* * *

>rtree
Barn
    the plow
Cellar
    the emergency mask
Center Platform
    the red circuit breaker
Church
    the altar + Founder's Testament 
    the organ & tan socket
    the audio unit + faulty power module & beige socket
    the gray cable & usb plug and usb plug
Home
    yourself + green jumpsuit, pocket, and scanner 
House
    the doll
Pod Bay
    the berths
    the emergency communications unit & almond socket
Pod Control
    the space suit
    the brass plaque
    the status display
    the atmosphere pump + faulty power module and faulty pressure regulation module 
School
    the learning machine + faulty instruction module and functional power module 
    the desk + clean eraser 
    the chalkboard
Sector 1: Crops
    the pylon
    the crops
    the graveyard
Sector 2: Aquaculture
    the pond
    the fish
Sector 3: Forest
    the pylon
    the trees
Sector 4: Crops
    the vegetables
Sector 5: Forest
    the pylon
    the trees
Sector 6: Hydroponics
    the hydroponics machines
Supply Vault
    the crate of machine parts
    the pair of gravity boots

>* look
(Noted.)

>gonear plow
Barn
Not fancy: livestock on one side and feed on the other, but nothing remains of either. There is a plow near the entrance.

>x plow
You see nothing special about the plow.

>out
Sector 1: Crops
You still maintain the crops here. There is a small graveyard and the barn remains from when this was the livestock sector. A pylon stretches up from the ground to the hub of the station. You can walk spinward or antispinward.

There is a secured hatch in the ground.

>push barn
It is fixed in place.

* * *

>checkobj
light-meter has no description.
red circuit breaker has no description.
green circuit breaker has no description.
pocket has no description.
plow has no description.
status display has no description.
faulty power module has no description.
faulty pressure regulation module has no description.
the floor hatch has no description.
wall hatch has no description.
almond socket has no description.
faulty power module has no description.
tan socket has no description.
beige socket has no description.
usb plug has no description.
usb plug has no description.
the floor hatch has no description.
functional power module has no description.
faulty instruction module has no description.
the floor hatch has no description.
junk repository has no description.
faulty instruction module has no description.
functional pressure regulation module has no description.

*** Run-time problem P47 (at paragraph 1 in the source text): Phrase applied to an incompatible kind of value.

>listobj
Founder's Testament
almond socket (P)
altar (F) (S)
atmosphere pump (F)
audio unit (F) (S)
barn (F) (S)
beige socket (P)
berths (F) (S)
brass plaque (F) (S)
chalkboard (F) (S)
church (F) (S)
clean eraser
crate of machine parts (F) (S)
crops (F) (S)
desk (F) (S)
doll
emergency communications unit
emergency mask
fish (F) (S)
graveyard (F) (S)
gray cable
green circuit breaker (F)
green jumpsuit
home (F) (S)
hub (F) (S)
hydroponics machines (F) (S)
faulty instruction module
faulty instruction module
junk repository
laser beam (F) (S)
learning machine (F)
light-meter (F) (S)
maintenance platform (F) (S)
mirrors (F) (S)
organ (F) (S)
pair of gravity boots
plow (F) (S)
pocket (P)
pond (F) (S)
faulty power module
faulty power module
functional power module
faulty pressure regulation module
functional pressure regulation module
pylon (F) (S)
pylon (F) (S)
pylon (F) (S)
red circuit breaker (F)
scanner
school building (F) (S)
solar panels (F) (S)
space suit (F) (S)
status display (F) (S)
tan socket (P)
the floor hatch (F)
the floor hatch (F)
the floor hatch (F)
the house (F) (S)
trees (F) (S)
trees (F) (S)
usb plug (P)
usb plug (P)
vegetables (F) (S)
wall hatch (F)
yourself

>rtree
Barn
    the plow
Cellar
    the emergency mask
Center Platform
    the red circuit breaker
Church
    the altar + Founder's Testament
    the organ
    the audio unit + faulty power module
    the gray cable
Home
    yourself + green jumpsuit, pocket, and scanner
House
    the doll
Pod Bay
    the berths
    the emergency communications unit
Pod Control
    the space suit
    the brass plaque
    the status display
    the atmosphere pump + faulty power module and faulty pressure regulation module
School
    the learning machine + faulty instruction module and functional power module
    the desk + clean eraser
    the chalkboard
Sector 1: Crops
    the pylon
    the crops
    the graveyard
Sector 2: Aquaculture
    the pond
    the fish
Sector 3: Forest
    the pylon
    the trees
Sector 4: Crops
    the vegetables
Sector 5: Forest
    the pylon
    the trees
Sector 6: Hydroponics
    the hydroponics machines
Supply Vault
    the crate of machine parts
    the pair of gravity boots

* * *

>out
Sector 4: Crops
Your home is here among the crops. You can walk spinward or antispinward.

* * *

>asw
You walk a little ways to the next sector.

Sector 3: Forest
Trees, a house, and a church. A red pylon stretches up from the ground to the hub of the station. You can walk spinward or antispinward.

>drop pylon
the pylon is already here.

>asw
You walk a little ways to the next sector.

Sector 2: Aquaculture
A deep pond is used as part of the water filtration system and for raising fish. You can walk spinward or antispinward.

* * *

>asw
You walk a little ways to the next sector.

Sector 1: Crops
You still maintain the crops here. There is a small graveyard and the barn remains from when this was the livestock sector. A pylon stretches up from the ground to the hub of the station. You can walk spinward or antispinward.

There is a secured hatch in the ground.

>drop pylon
The the pylon is already here.

* * *

>scan
Syntax error: no target.

[You can ask the scanner for a list of commands by typing "scanner, help" and give it voice commands by typing phrases such as "scanner, scan SOMETHING" or "scanner, open SOMETHING" where SOMETHING is a visible object.]

* * *

>scan
Syntax error: no target.

>scan
Syntax error: no target.

* * *

>scan hatch
No modular technology detected.

>scanner, scanhatch
Syntax error: command not in vocabulary.

[You can ask the scanner for a list of commands by typing "scanner, help" and give it voice commands by typing phrases such as "scanner, scan SOMETHING" or "scanner, open SOMETHING" where SOMETHING is a visible object.]

>scanner, scan hatch
No modular (2) technology detected.

>purloin mask
[Purloined.]

>scanner, scan mask
Machine is functional.

The scanner is unable to do that.

>scanner, scan scanner
Machine is functional.

The scanner is unable to do that.

* * *

>scan scanner
Self test completed. Scanner is functional.

>scanner, open machine
Search error: cannot find machine.

[You can ask the scanner for a list of commands by typing "scanner, help" and give it voice commands by typing phrases such as "scanner, scan SOMETHING" or "scanner, open SOMETHING" where SOMETHING is a visible object.]

>d
(first opening the floor hatch)
You scramble down through the hatch and close it behind yourself.

Cellar
A decompression shelter and space for storage.

There is a secured hatch in the ceiling.

There is an emergency mask hanging on the wall.

* * *

>scan mask
Machine is functional.

>scanner, open mask
Machine is unitary.

* * *

>scanner, look
Syntax error: command not in vocabulary.

[You can ask the scanner for a list of commands by typing "scanner, help" and give it voice commands by typing phrases such as "scanner, scan SOMETHING" or "scanner, open SOMETHING" where SOMETHING is a visible object.]

>look
Home
The room where you've slept your entire life. You can go out towards the crops.

There is a secured hatch in the floor.

>scanner, help
Recognized commands are "help", "open", and "scan".

[You can ask the scanner for a list of commands by typing "scanner, help" and give it voice commands by typing phrases such as "scanner, scan SOMETHING" or "scanner, open SOMETHING" where SOMETHING is a visible object.]

>scanner, look
Syntax error: command not in vocabulary.

>g
Syntax error: command not in vocabulary.

>g
Syntax error: command not in vocabulary.

>g
Syntax error: command not in vocabulary.
[You can ask the scanner for a list of commands by typing "scanner, help" and give it voice commands by typing phrases such as "scanner, scan SOMETHING" or "scanner, open SOMETHING" where SOMETHING is a visible object.]

* * *

>scanner, look
Syntax error: command not in vocabulary.

[You can ask the scanner for a list of commands by typing "scanner, help" and give it voice commands by typing phrases such as "scanner, scan SOMETHING" or "scanner, open SOMETHING" where SOMETHING is a visible object.]

>drop scanner
Dropped.

>scanner, look
You must be carrying the scanner to use it.

>scanner, jkjklj
You must be carrying the scanner to use it.

>tell scanner about me
You must be carrying the scanner to use it.

>scan
You must be carrying the scanner to use it.

>actions
Actions listing on.

>scan
[bare scanning]
You must be carrying the scanner to use it.
[bare scanning - failed the Check bare scanning]

* * *

>scanner, open me
No electronic technology detected.

>drop scanner
Dropped.

>scanner, open me
You must be carrying the scanner to use it.

>scanner, open hatch
You must be carrying the scanner to use it.

* * *

>scanner, scan me
No modular (2) technology detected.

>scan m
You can't see any such thing.

>scan me
No modular technology detected.

>gonear pump
Pod Control
This room serves as an airlock for the pod bay, and holds an old space suit and various machinery such as the atmosphere pump. There is a brass plate on the wall.

There is a secured hatch in the ceiling.

Beside the secured port hatch, a status display shows an error message.

>scanner, scan pump
No modular (2) technology detected.

>scan pump
Machine is failed.

>i
You are carrying:
  a green jumpsuit (being worn)
  a scanner

>purloin mask
[Purloined.]

>scan mask
Machine is functional.

>scanner, scan mask
No modular (2) technology detected.

* * *

>scanner, x
(the floor hatch)
Syntax error: command not in vocabulary.
[You can ask the scanner for a list of commands by typing "scanner, help" and give it voice commands by typing phrases such as "scanner, scan SOMETHING" or "scanner, open SOMETHING" where SOMETHING is a visible object.]

The scanner has better things to do.

>scanner, z
Syntax error: command not in vocabulary.

>scanner, z
Syntax error: command not in vocabulary.

>scanner, z
Syntax error: command not in vocabulary.
[You can ask the scanner for a list of commands by typing "scanner, help" and give it voice commands by typing phrases such as "scanner, scan SOMETHING" or "scanner, open SOMETHING" where SOMETHING is a visible object.]

The scanner has better things to do.

>scanner, z
Syntax error: command not in vocabulary.

* * *

>scanner, z
Syntax error: command not in vocabulary.
[You can ask the scanner for a list of commands by typing "scanner, help" and give it voice commands by typing phrases such as "scanner, scan SOMETHING" or "scanner, open SOMETHING" where SOMETHING is a visible object.]

The scanner has better things to do.

>scanner, scan
Syntax error: no target.

* * *

>scanner, scan
Syntax error: no target.

[You can ask the scanner for a list of commands by typing "scanner, help" and give it voice commands by typing phrases such as "scanner, scan SOMETHING" or "scanner, open SOMETHING" where SOMETHING is a visible object.]

>scanner, jkjkjkjk
Syntax error: command not in vocabulary.

>scanner, jkjkjkjk
Syntax error: command not in vocabulary.

[You can ask the scanner for a list of commands by typing "scanner, help" and give it voice commands by typing phrases such as "scanner, scan SOMETHING" or "scanner, open SOMETHING" where SOMETHING is a visible object.]

>scanner, jkjkjkjk
Syntax error: command not in vocabulary.

* * *

>scanner, jkjkjkjk
Syntax error: command not in vocabulary.

[You can ask the scanner for a list of commands by typing "scanner, help" and give it voice commands by typing phrases such as "scanner, scan SOMETHING" or "scanner, open SOMETHING" where SOMETHING is a visible object.]

>scanner, look
Syntax error: command not in vocabulary.

>scanner, look
Syntax error: command not in vocabulary.
[You can ask the scanner for a list of commands by typing "scanner, help" and give it voice commands by typing phrases such as "scanner, scan SOMETHING" or "scanner, open SOMETHING" where SOMETHING is a visible object.]

The scanner has better things to do.

>scanner, look
Syntax error: command not in vocabulary.

* * *

>scenes
Scene 'Entire Game' playing (for 0 mins now)
Scene 'Beginning' playing (for 0 mins now)
(Scene monitoring now switched on. Type "scenes off" to switch it off again.)

>gonear display
Pod Control
This room serves as an airlock for the pod bay, and holds an old space suit and various machinery such as the atmosphere pump. There is a brass plaque on the wall.

There is a secured hatch in the ceiling.

Beside the secured port hatch, a status display shows an error message.

[Scene 'Repairing Pod Bay' begins]
[Scene 'Beginning' ends]
[Scene 'Repairing Red Breaker' begins]
[Scene 'Repairing Green Breaker' begins]
[Scene 'Repairing Atmosphere Pump' begins]

>help
You need to fix something. Check out the status display in Pod Control.

By the way, it should be impossible to put this game into an unwinnable state, so feel free to explore and experiment.

If you are having trouble getting started, I suggest reading A Beginner's Guide to Interactive Fiction by Stephen Granade and Emily Short, available at:

  https://brasslantern.org/players/howto/beginnersguide.html

[If you prefer not to be tempted by further hints, you can type "hints off" to disable them.]

>g
You need to fix something. Check out the status display in Pod Control.

>x display
Pod bay locked down
Diagnosis: telemetry sensor array offline
Remediation: reset breaker FM36-87/A @ hub platform

>g
Pod bay locked down
Diagnosis: telemetry sensor array offline
Remediation: reset breaker FM36-87/A @ hub platform

>help
According the the status display, you need to reset a circuit breaker on the hub platform.

>scenes
Scene 'Entire Game' playing (for 6 mins now)
Scene 'Beginning' ended
Scene 'Repairing Pod Bay' playing (for 6 mins now)
Scene 'Repairing Red Breaker' playing (for 6 mins now)
Scene 'Repairing Green Breaker' playing (for 6 mins now)
Scene 'Repairing Atmosphere Pump' playing (for 6 mins now)
(Scene monitoring now switched on. Type "scenes off" to switch it off again.)

>help
According the the status display, you need to reset a circuit breaker on the hub platform.

* * *

>z
Time passes.

I beg your pardon?

* * *

>z
Time passes.

>help
According the the status display, you need to reset a circuit breaker on the hub platform.

>scenes
Scene 'Entire Game' playing (for 15 mins now)
Scene 'Beginning' ended
Scene 'Repairing Pod Bay' playing (for 15 mins now)
Scene 'Repairing Red Breaker' playing (for 15 mins now)
Scene 'Repairing Green Breaker' playing (for 15 mins now)
Scene 'Repairing Atmosphere Pump' playing (for 15 mins now)
(Scene monitoring now switched on. Type "scenes off" to switch it off again.)

>z
Time passes.

>help
According the the status display, you need to reset a circuit breaker on the hub platform.

Two.

* * *

>scenes
Scene 'Entire Game' playing (for 0 mins now)
Scene 'Beginning' playing (for 0 mins now)
(Scene monitoring now switched on. Type "scenes off" to switch it off again.)

>help
Your goal is simply to leave the station and find other people. You can start by looking around and leaving your initial location.

By the way, it should be impossible to put this game into an unwinnable state, so feel free to explore and experiment.

If you are having trouble getting started, I suggest reading A Beginner's Guide to Interactive Fiction by Stephen Granade and Emily Short, available at:

  https://brasslantern.org/players/howto/beginnersguide.html

[If you prefer not to be tempted by further hints, you can type "hints off" to disable them.]

>help
Your goal is simply to leave the station and find other people. You can start by looking around and leaving your initial location.

>out
Sector 4: Crops
Your home is here among the crops. You can walk spinward or antispinward.

* * *

>asw
You walk a little ways to the next sector.

Sector 2: Aquaculture
A deep pond is used as part of the water filtration system and for raising fish. You can walk spinward or antispinward.

>help
Your goal is simply to leave the station and find other people. You can start by looking around and leaving your initial location.

>asw
You walk a little ways to the next sector.

Sector 1: Crops
You still maintain the crops here. There is a small graveyard and the barn remains from when this was the livestock sector. A pylon stretches up from the ground to the hub of the station. You can walk spinward or antispinward.

There is a secured hatch in the ground.

>help
Your goal is simply to leave the station and find other people. You can start by looking around and leaving your initial location.

>d
(first opening the floor hatch)
You scramble down through the hatch and close it behind yourself.

Pod Control
This room serves as an airlock for the pod bay, and holds an old space suit and various machinery such as the atmosphere pump. There is a brass plaque on the wall.

There is a secured hatch in the ceiling.

Beside the secured port hatch, a status display shows an error message.

[Scene 'Repairing Pod Bay' begins]
[Scene 'Beginning' ends]
[Scene 'Repairing Red Breaker' begins]
[Scene 'Repairing Green Breaker' begins]
[Scene 'Repairing Atmosphere Pump' begins]

>help
You need to fix something. Check out the status display in Pod Control.

>x display
Pod bay locked down
Diagnosis: telemetry sensor array offline
Remediation: reset breaker FM36-87/A @ hub platform

>help
According to the status display, you need to reset a circuit breaker on the hub platform.

>look
Pod Control
This room serves as an airlock for the pod bay, and holds an old space suit and various machinery such as the atmosphere pump. There is a brass plaque on the wall.

There is a secured hatch in the ceiling.

Beside the secured port hatch, a status display shows an error message.

>restart
Are you sure you want to restart?

* * *

>scenes
Scene 'Entire Game' playing (for 0 mins now)
Scene 'Beginning' playing (for 0 mins now)
(Scene monitoring now switched on. Type "scenes off" to switch it off again.)

>out
Sector 4: Crops
Your home is here among the crops. You can walk spinward or antispinward.

* * *

>sw
You walk a little ways to the next sector.

Sector 2: Aquaculture
A deep pond is used as part of the water filtration system and for raising fish. You can walk spinward or antispinward.

>sw
You walk a little ways to the next sector.

Sector 3: Forest
Trees, a house, and a church. A red pylon stretches up from the ground to the hub of the station. You can walk spinward or antispinward.

[Scene 'Ready to Repair' begins]
You have walked the entire ring. Everything is as expected, much is not working. Now, it's time to leave. The pods are below Sector 1.

[Scene 'Beginning' ends]

>sw
You walk a little ways to the next sector.

Sector 4: Crops
Your home is here among the crops. You can walk spinward or antispinward.

>help
It's time to leave the station, but you need to explore a little more.

By the way, it should be impossible to put this game into an unwinnable state, so feel free to explore and experiment.

If you are having trouble getting started, I suggest reading A Beginner's Guide to Interactive Fiction by Stephen Granade and Emily Short, available at:

  https://brasslantern.org/players/howto/beginnersguide.html

[If you prefer not to be tempted by further hints, you can type "hints off" to disable them.]

>help
It's time to leave the station, but you need to explore a little more.

>help
It's time to leave the station, but you need to explore a little more.

>asw
You walk a little ways to the next sector.

Sector 3: Forest
Trees, a house, and a church. A red pylon stretches up from the ground to the hub of the station. You can walk spinward or antispinward.

* * *

>asw
You walk a little ways to the next sector.

Sector 1: Crops
You still maintain the crops here. There is a small graveyard and the barn remains from when this was the livestock sector. A pylon stretches up from the ground to the hub of the station. You can walk spinward or antispinward.

There is a secured hatch in the ground.

>d
(first opening the floor hatch)
You scramble down through the hatch and close it behind yourself.

Pod Control
This room serves as an airlock for the pod bay, and holds an old space suit and various machinery such as the atmosphere pump. There is a brass plaque on the wall.

There is a secured hatch in the ceiling.

Beside the secured port hatch, a status display shows an error message.

[Scene 'Repairing Pod Bay' begins]
[Scene 'Ready to Repair' ends]
[Scene 'Repairing Red Breaker' begins]
[Scene 'Repairing Green Breaker' begins]
[Scene 'Repairing Atmosphere Pump' begins]

>scenes
Scene 'Entire Game' playing (for 14 mins now)
Scene 'Beginning' ended
Scene 'Ready to Repair' ended
Scene 'Repairing Pod Bay' playing (for 1 mins now)
Scene 'Repairing Red Breaker' playing (for 1 mins now)
Scene 'Repairing Green Breaker' playing (for 1 mins now)
Scene 'Repairing Atmosphere Pump' playing (for 1 mins now)
(Scene monitoring now switched on. Type "scenes off" to switch it off again.)

>gonear red
(the red circuit breaker)
Center Platform
It's a mesh platform a little below the hub. You feel much lighter here, and you are very aware of how the station rotates, but everything is okay as long as you don't look down.

You can just reach a red circuit breaker on the hub.

* * *

>turn red on
You switch the red circuit breaker on.

[Scene 'Repairing Red Breaker' ends]
[Your score has just gone up by five points.]

>i
You are carrying:
  a scanner
  a green jumpsuit (being worn)

>scenes
Scene 'Entire Game' playing (for 17 mins now)
Scene 'Beginning' ended
Scene 'Ready to Repair' ended
Scene 'Repairing Pod Bay' playing (for 4 mins now)
Scene 'Repairing Red Breaker' ended
Scene 'Repairing Green Breaker' playing (for 4 mins now)
Scene 'Repairing Atmosphere Pump' playing (for 4 mins now)
(Scene monitoring now switched on. Type "scenes off" to switch it off again.)

>look
Center Platform
It's a mesh platform a little below the hub. You feel much lighter here, and you are very aware of how the station rotates, but everything is okay as long as you don't look down.

You can just reach a red circuit breaker on the hub.

>gonear pond
Sector 2: Aquaculture
A deep pond is used as part of the water filtration system and for raising fish. You can walk spinward or antispinward.

* * *

>scenes
Scene 'Entire Game' playing (for 0 mins now)
Scene 'Beginning' playing (for 0 mins now)
(Scene monitoring now switched on. Type "scenes off" to switch it off again.)

>look
Home
The room where you've slept your entire life. You can go out towards the crops.

There is a secured hatch in the floor.

* * *

>asw
You walk a little ways to the next sector.

Sector 6: Hydroponics
Your people preferred to grow things the old fashioned way, but in truth the majority of your fruit and vegetables came from this sector when the machines still worked. You can walk spinward or antispinward.

There is a secured hatch in the ground.

>asw
You walk a little ways to the next sector.

Sector 5: Forest
The school house is nestled among the trees. A pylon stretches up from the same grove to the hub of the station. You can walk spinward or antispinward.

[Scene 'Ready to Repair' begins]
You have walked the entire ring. Everything is as expected, much is not working. Now, it's time to leave. The pods are below Sector 1.

[Scene 'Beginning' ends]

>asw
You walk a little ways to the next sector.

Sector 4: Crops
Your home is here among the crops. You can walk spinward or antispinward.

* * *

>asw
You walk a little ways to the next sector.

Sector 2: Aquaculture
A deep pond is used as part of the water filtration system and for raising fish. You can walk spinward or antispinward.

>gonear display
Pod Control
This room serves as an airlock for the pod bay, and holds an old space suit and various machinery such as the atmosphere pump. There is a brass plaque on the wall.

There is a secured hatch in the ceiling.

Beside the secured port hatch, a status display shows an error message.

[Scene 'Repairing Pod Bay' begins]
[Scene 'Ready to Repair' ends]
[Scene 'Repairing Red Breaker' begins]
[Scene 'Repairing Green Breaker' begins]
[Scene 'Repairing Atmosphere Pump' begins]

>z
Time passes.

>scenes
Scene 'Entire Game' playing (for 12 mins now)
Scene 'Beginning' ended
Scene 'Ready to Repair' ended
Scene 'Repairing Pod Bay' playing (for 3 mins now)
Scene 'Repairing Red Breaker' playing (for 3 mins now)
Scene 'Repairing Green Breaker' playing (for 3 mins now)
Scene 'Repairing Atmosphere Pump' playing (for 3 mins now)
(Scene monitoring now switched on. Type "scenes off" to switch it off again.)

>u
(first opening the ceiling hatch)
You pull yourself up through the hatch and close it behind yourself.

Sector 1: Crops
You still maintain the crops here. There is a small graveyard and the barn remains from when this was the livestock sector. A pylon stretches up from the ground to the hub of the station. You can walk spinward or antispinward.

There is a secured hatch in the ground.

* * *

>asw
You walk a little ways to the next sector.

Sector 6: Hydroponics
Your people preferred to grow things the old fashioned way, but in truth the majority of your fruit and vegetables came from this sector when the machines still worked. You can walk spinward or antispinward.

There is a secured hatch in the ground.

>asw
You walk a little ways to the next sector.

Sector 5: Forest
The school house is nestled among the trees. A pylon stretches up from the same grove to the hub of the station. You can walk spinward or antispinward.

* * *

>asw
You walk a little ways to the next sector.

Sector 3: Forest
Trees, a house, and a church. A red pylon stretches up from the ground to the hub of the station. You can walk spinward or antispinward.

>scenes
Scene 'Entire Game' playing (for 23 mins now)
Scene 'Beginning' ended
Scene 'Ready to Repair' ended
Scene 'Repairing Pod Bay' playing (for 14 mins now)
Scene 'Repairing Red Breaker' playing (for 14 mins now)
Scene 'Repairing Green Breaker' playing (for 14 mins now)
Scene 'Repairing Atmosphere Pump' playing (for 14 mins now)
(Scene monitoring now switched on. Type "scenes off" to switch it off again.)

* * *

>asw
You walk a little ways to the next sector.

Sector 1: Crops
You still maintain the crops here. There is a small graveyard and the barn remains from when this was the livestock sector. A pylon stretches up from the ground to the hub of the station. You can walk spinward or antispinward.

There is a secured hatch in the ground.

>d
(first opening the floor hatch)
You scramble down through the hatch and close it behind yourself.

Pod Control
This room serves as an airlock for the pod bay, and holds an old space suit and various machinery such as the atmosphere pump. There is a brass plaque on the wall.

There is a secured hatch in the ceiling.

Beside the secured port hatch, a status display shows an error message.

[Scene 'Repairing Pod Bay' begins]
[Scene 'Beginning' ends]
[Scene 'Repairing Red Breaker' begins]
[Scene 'Repairing Green Breaker' begins]
[Scene 'Repairing Atmosphere Pump' begins]

>scenes
Scene 'Entire Game' playing (for 5 mins now)
Scene 'Beginning' ended
Scene 'Repairing Pod Bay' playing (for 1 mins now)
Scene 'Repairing Red Breaker' playing (for 1 mins now)
Scene 'Repairing Green Breaker' playing (for 1 mins now)
Scene 'Repairing Atmosphere Pump' playing (for 1 mins now)
(Scene monitoring now switched on. Type "scenes off" to switch it off again.)

>look
Pod Control
This room serves as an airlock for the pod bay, and holds an old space suit and various machinery such as the atmosphere pump. There is a brass plaque on the wall.

There is a secured hatch in the ceiling.

Beside the secured port hatch, a status display shows an error message.

>help
You need to fix something. Check out the status display in Pod Control.

By the way, it should be impossible to put this game into an unwinnable state, so feel free to explore and experiment.

If you are having trouble getting started, I suggest reading A Beginner's Guide to Interactive Fiction by Stephen Granade and Emily Short, available at:

  https://brasslantern.org/players/howto/beginnersguide.html

[If you prefer not to be tempted by further hints, you can type "hints off" to disable them.]

* * *

>help
You need to fix something. Check out the status display in Pod Control.

>x hatch
Which do you mean, the ceiling hatch or the wall hatch?

>x display
Pod bay locked down
Diagnosis: telemetry sensor array offline
Remediation: reset breaker FM36-87/A @ hub platform

>look
Pod Control
This room serves as an airlock for the pod bay, and holds an old space suit and various machinery such as the atmosphere pump. There is a brass plaque on the wall.

There is a secured hatch in the ceiling.

Beside the secured port hatch, a status display shows an error message.

* * *

>asw
You walk a little ways to the next sector.

Sector 6: Hydroponics
Your people preferred to grow things the old fashioned way, but in truth the majority of your fruit and vegetables came from this sector when the machines still worked. You can walk spinward or antispinward.

There is a secured hatch in the ground.

>look
Sector 6: Hydroponics
Your people preferred to grow things the old fashioned way, but in truth the majority of your fruit and vegetables came from this sector when the machines still worked. You can walk spinward or antispinward.

There is a secured hatch in the ground.

>gonear pond
Sector 2: Aquaculture
A deep pond is used as part of the water filtration system and for raising fish. You can walk spinward or antispinward.

>scenes
Scene 'Entire Game' playing (for 20 mins now)
Scene 'Beginning' ended
Scene 'Repairing Pod Bay' playing (for 16 mins now)
Scene 'Repairing Red Breaker' playing (for 16 mins now)
Scene 'Repairing Green Breaker' playing (for 16 mins now)
Scene 'Repairing Atmosphere Pump' playing (for 16 mins now)
(Scene monitoring now switched on. Type "scenes off" to switch it off again.)

>help
According to the status display, you need to reset a circuit breaker on the hub platform.

>purloin mask
[Purloined.]

* * *

>wear mask
You put on the emergency mask.

>go pond
WIth the air from the emergency mask, you breathe comfortably as you step into the pond. At the bottom, you find a green circuit breaker and flip it on.

[Scene 'Repairing Green Breaker' ends]
[Your score has just gone up by ten points.]

>scenes
Scene 'Entire Game' playing (for 23 mins now)
Scene 'Beginning' ended
Scene 'Repairing Pod Bay' playing (for 19 mins now)
Scene 'Repairing Red Breaker' playing (for 19 mins now)
Scene 'Repairing Green Breaker' ended
Scene 'Repairing Atmosphere Pump' playing (for 19 mins now)
(Scene monitoring now switched on. Type "scenes off" to switch it off again.)

>help
According to the status display, you need to reset a circuit breaker on the hub platform.

>gonear red
(the red circuit breaker)
Center Platform
It's a mesh platform a little below the hub. You feel much lighter here, and you are very aware of how the station rotates, but everything is okay as long as you don't look down.

You can just reach a red circuit breaker on the hub.

>touch red
You feel nothing unexpected.

>look
Center Platform
It's a mesh platform a little below the hub. You feel much lighter here, and you are very aware of how the station rotates, but everything is okay as long as you don't look down.

You can just reach a red circuit breaker on the hub.

>turn breaker on
You switch the red circuit breaker on.

[Scene 'Repairing Red Breaker' ends]
[Your score has just gone up by five points.]

>pull breaker
It is fixed in place.

>push breaker
It is fixed in place.

>scenes
Scene 'Entire Game' playing (for 30 mins now)
Scene 'Beginning' ended
Scene 'Repairing Pod Bay' playing (for 26 mins now)
Scene 'Repairing Red Breaker' ended
Scene 'Repairing Green Breaker' ended
Scene 'Repairing Atmosphere Pump' playing (for 26 mins now)
(Scene monitoring now switched on. Type "scenes off" to switch it off again.)

>gonear pump
Pod Control
This room serves as an airlock for the pod bay, and holds an old space suit and various machinery such as the atmosphere pump. There is a brass plaque on the wall.

There is a secured hatch in the ceiling.

Beside the secured port hatch, a status display shows an error message.

>x status
Pod bay locked down
Diagnosis: pod control atmosphere pump offline
Remediation: scan and repair pump

>x pump
The atmosphere pump is a smooth featureless machine.

>scanner, open pump
Opening.

The atmosphere pump swings open.

* * *

>x pump
The atmosphere pump is a smooth featureless machine.

In the atmosphere pump are a power module and a pressure regulation module.

>get all from pump
power module: Taken.
pressure regulation module: Taken.

>purloin all power modules
[Purloined.]

>purloin all regulation modules
[Purloined.]

>i
You are carrying:
  a pressure regulation module
  a power module
  an emergency mask (being worn)
  a scanner
  a green jumpsuit (being worn)

>scan power module
Component is faulty.

* * *

>purloin all unscanned power modules
[Purloined.]
[Purloined.]

>i
You are carrying:
  two unscanned power modules
  an unscanned pressure regulation module
  a faulty power module
  an emergency mask (being worn)
  a scanner
  a green jumpsuit (being worn)

>scan unscanned power
Component is functional.

>x power
Which do you mean, the functional power module, the unscanned power module, or the faulty power module?

>put functional in pump
You put the functional power module into the atmosphere pump.

>x regulation
It is a standardized pressure regulation module.

>i
You are carrying:
  an unscanned power module
  an unscanned pressure regulation module
  a faulty power module
  an emergency mask (being worn)
  a scanner
  a green jumpsuit (being worn)

>scan unscanned regulation
Component is faulty.

>i
You are carrying:
  an unscanned power module
  a faulty pressure regulation module
  a faulty power module
  an emergency mask (being worn)
  a scanner
  a green jumpsuit (being worn)

>look
Pod Control
This room serves as an airlock for the pod bay, and holds an old space suit and various machinery such as the atmosphere pump. There is a brass plaque on the wall.

There is a secured hatch in the ceiling.

Beside the secured port hatch, a status display shows an error message.

The atmosphere pump is open and contains a functional power module.

>purloin unscanned regulation
[Purloined.]

>put it in machine
You put the unscanned pressure regulation module into the atmosphere pump.

>hint
You're almost there. The status display is fairly clear about what you need to do now.

>x display
Pod bay locked down
Diagnosis: pod control atmosphere pump offline
Remediation: close pump

>close pump
You close the atmosphere pump and it begins to hum.

[Scene 'Repairing Atmosphere Pump' ends]
[Scene 'Repairing Pod Bay' ends]
[Scene 'Between Repairs' begins]
It is time to say goodbye to the station. You are ready to leave in a pod.

[Your score has just gone up by five points.]

>help
There's no point in waiting. You just need to enter the pod bay.

>open ceiling hatch
You open the ceiling hatch.

>port
(first opening the wall hatch)
It seems to be locked.

>help
Pod Control acts as an airlock.

>close ceiling hatch
You close the ceiling hatch.

>port
(first opening the wall hatch)
You close the hatch behind yourself.

Pod Bay
There are four berths for transit pods. Unexpectedly, all are empty.

A secured hatch leads starboard.

Someone left an emergency communications unit on the floor.

[Scene 'Repairing Comms' begins]
This is troubling. You counted. You were sure there would be one pod left. There are none.

[Scene 'Between Repairs' ends]
[Your score has just gone up by ten points.]

>scenes
Scene 'Entire Game' playing (for 56 mins now)
Scene 'Beginning' ended
Scene 'Repairing Pod Bay' ended
Scene 'Repairing Red Breaker' ended
Scene 'Repairing Green Breaker' ended
Scene 'Repairing Atmosphere Pump' ended
Scene 'Between Repairs' ended
Scene 'Repairing Comms' playing (for 1 mins now)
(Scene monitoring now switched on. Type "scenes off" to switch it off again.)

>hint
Take a look at the emergency communications unit.

>look
Pod Bay
There are four berths for transit pods. Unexpectedly, all are empty.

A secured hatch leads starboard.

Someone left an emergency communications unit on the floor.

>get unit
(putting the scanner into your pocket to make room)
You're carrying too many things already.

No pods left ... you consider despair.

>hint
Take a look at the emergency communications unit.

>x unit
A portable emergency communications unit with a single socket to connect it to a transit pod or other audio source.

The emergency communications unit has nothing plugged into it.

So what if you can't escape in a pod. You will just need to bring a pod here. Time to get the communications module working.

>get unit
(putting the faulty power module into your pocket to make room)
Taken.

>i
You are carrying:
  the emergency communications unit
  an unscanned power module
  a faulty pressure regulation module
  an emergency mask (being worn)
  a green jumpsuit (being worn)

Your jumpsuit pocket contains:
  a faulty power module
  a scanner

>hint
You will need to attach the communications unit to an audio unit.

>scenes
Scene 'Entire Game' playing (for 64 mins now)
Scene 'Beginning' ended
Scene 'Repairing Pod Bay' ended
Scene 'Repairing Red Breaker' ended
Scene 'Repairing Green Breaker' ended
Scene 'Repairing Atmosphere Pump' ended
Scene 'Between Repairs' ended
Scene 'Repairing Comms' playing (for 9 mins now)
(Scene monitoring now switched on. Type "scenes off" to switch it off again.)

>look
Pod Bay
There are four berths for transit pods. Sadly, all are empty.

A secured hatch leads starboard.

* * *

>d
(first opening the floor hatch)
You scramble down through the hatch and close it behind yourself.

Pod Control
This room serves as an airlock for the pod bay, and holds an old space suit and various machinery such as the atmosphere pump. There is a brass plaque on the wall.

There is a secured hatch in the ceiling.

Beside the secured port hatch, a status display shows an error message.

[Scene 'Repairing Pod Bay' begins]
[Scene 'Beginning' ends]
[Scene 'Repairing Red Breaker' begins]
[Scene 'Repairing Green Breaker' begins]
[Scene 'Repairing Atmosphere Pump' begins]

>u
(first opening the ceiling hatch)
You pull yourself up through the hatch and close it behind yourself.

Sector 1: Crops
You still maintain the crops here. There is a small graveyard and the barn remains from when this was the livestock sector. A pylon stretches up from the ground to the hub of the station. You can walk spinward or antispinward.

There is a secured hatch in the ground.

* * *

>d
(first opening the floor hatch)
You scramble down through the hatch and close it behind yourself.

Pod Control
This room serves as an airlock for the pod bay, and holds an old space suit and various machinery such as the atmosphere pump. There is a brass plaque on the wall.

There is a secured hatch in the ceiling.

Beside the secured port hatch, a status display shows an error message.

[Scene 'Repairing Pod Bay' begins]
[Scene 'Beginning' ends]
[Scene 'Repairing Red Breaker' begins]
[Scene 'Repairing Green Breaker' begins]
[Scene 'Repairing Atmosphere Pump' begins]

>up
(first opening the ceiling hatch)
You pull yourself up through the hatch and close it behind yourself.

Sector 1: Crops
You still maintain the crops here. There is a small graveyard and the barn remains from when this was the livestock sector. A pylon stretches up from the ground to the hub of the station. You can walk spinward or antispinward.

There is a secured hatch in the ground.

>sw
You walk a little ways to the next sector.

Sector 2: Aquaculture
A deep pond is used as part of the water filtration system and for raising fish. You can walk spinward or antispinward.

>sw
You walk a little ways to the next sector.

Sector 3: Forest
Trees, a house, and a church. A red pylon stretches up from the ground to the hub of the station. You can walk spinward or antispinward.

[Scene 'Repairing Pod Bay' begins]
You have walked the entire ring. Everything is as expected, much is not working. Now, it's time to leave. The pods are below Sector 1.

[Scene 'Beginning' ends]
[Scene 'Repairing Red Breaker' begins]
[Scene 'Repairing Green Breaker' begins]
[Scene 'Repairing Atmosphere Pump' begins]

*** Run-time problem P10: Since the atmosphere pump is not allowed the property "status", it is against the rules to try to use it.

* * *

>showe me
That's not a verb I recognize.

>showme me
yourself - person
    scanner
    green jumpsuit (worn)
        pocket (part of green jumpsuit) - open container
location: in Home
singular-named, proper-named; unlit, inedible, portable; female
list grouping key: none
printed name: "yourself"
printed plural name: "people"
indefinite article: none
description: "As good-looking as ever."
initial appearance: none
carrying capacity: 3

>showme scanner
scanner - thing
location: carried by yourself in Home
singular-named, improper-named; unlit, inedible, portable, handled, machinelike, addressable; list grouping key: none
printed name: "scanner"
printed plural name: none
indefinite article: none
description: "The handheld voice-activated scanner you use when working on the station's machines."
initial appearance: none

* * *

>smell
Only familiar odors.

* * *

>x scanner
The handheld voice-activated scanner you use when working on the station's machines.

[You can ask the scanner for a list of commands by typing "scanner, help" and give it voice commands by typing phrases such as "scanner, scan SOMETHING" or "scanner, open SOMETHING" where SOMETHING is a visible object.]

>version
Founder's Mercy
A Space Story by Thomas Insel
Release 1 / Serial number 181128 / Inform 7 build 6M62 (I6/v6.33 lib 6/12N) SD
Type "about" for credits or "hint" for assistance.
Identification number: //BCC61E7F-CE8E-4C25-9E9D-5550D1138D8C//
Interpreter version 0.5.2 / VM 3.1.2 / Library serial number 080126
Standard Rules version 3/120430 by Graham Nelson
Unicode Character Names by Graham Nelson
Exit Lister version 11 by Eric Eve
Plugs and Sockets version 4 by Sean Turner
Object Response Tests version 7 by Juhana Leinonen

>scanner, open hatch
No electronic technology detected.

>drop scanner
Dropped.

>scanner, open hatch
No electronic technology detected.

>scanner, scan hatch
You must be carrying the scanner to use it.

>scanner, help
Recognized commands are "help", "open", and "scan".

[You can ask the scanner for a list of commands by typing "scanner, help" and give it voice commands by typing phrases such as "scanner, scan SOMETHING" or "scanner, open SOMETHING" where SOMETHING is a visible object.]

* * *

>xyzzy
You say that word out loud. Your mother would never have approved. Even with no one to listen, it feels a little wrong.

>xyzzy
Once was enough.

>xyzzy
Once was enough.