You awake. You are lonely, so lonely. It was a thousand days ago today. All alone these thousand days. Your parents were the last. No, your father was the last. He held on for nearly a hundred days longer. Now you are the last. Alone. Adrift.

But maybe it isn't hopeless. There must still be other people in other worlds, and you think you know how to get there.

Today is the day.

Founder's Mercy
A Space Story by Thomas Insel
Release 1 / Serial number 181222 / Inform 7 build 6M62 (I6/v6.33 lib 6/12N) SD
Type ABOUT for credits or HINT for assistance.

Home (on the blanket)
The room where you've slept your entire life. The crops are outside.

There is a secured hatch in the floor.

>* scratch
(Noted.)

* * *

>* walkthrough
(Noted.)

>d
(first getting off the blanket)
(first opening the floor hatch)

Cellar
Your decompression shelter and storage space for increasingly empty shelves of canned vegetables and one more large bag of split peas.

There is an open hatch in the ceiling.

* * *

>get mask
Taken.

>u
Home
The room where you've slept your entire life. The crops are outside.

There is an open hatch in the floor.

A homespun blanket is arranged neatly on the ground. It is your bed.

>get blanket
Taken.

>out
Sector 4: Crops
Your home is here among the crops. To the port and starboard, the station walls rise up to the hub above. You can walk spinward or antispinward.

>sw
You walk a little ways to the next sector.

Sector 5: Forest
The school house is nestled among the trees. A pylon stretches up from the same grove to the hub of the station. You can walk spinward or antispinward.

* * *

>get eraser
Taken.

>erase board
(with the eraser)
You carefully clean the chalkboard and dirty the eraser.

>get power from machine
Taken.

>out
Sector 5: Forest
The school house is nestled among the trees. A pylon stretches up from the same grove to the hub of the station. You can walk spinward or antispinward.

* * *

>d
(first opening the floor hatch)

Supply Vault
This room is dim, quiet, and stuffy. There is still one crate of machine parts left.

There is an open hatch in the ceiling.

You can also see a pair of gravity boots here.

>search crate
You find an instruction module and a pressure regulation module.
(putting the scanner into your pocket to make room)
(putting the emergency mask into your pocket to make room)

>get boots
(putting the dusty eraser into your pocket to make room)
Taken.

>hit eraser
(first taking the dusty eraser)
(putting the power module into your pocket to make room)
You fill the vault with a cloud of dust which scatters the laser beam that you can now see scanning across the hatch.

>u
You maneuver around the laser beam and pull yourself up through the ceiling hatch.

Sector 6: Hydroponics
Your people preferred to grow things the old fashioned way, but in truth the majority of your fruit and vegetables came from this sector when the machines still worked. You can walk spinward or antispinward.

There is an open hatch in the ground.

[Your score has just gone up by one point.]

* * *

>asw
You walk a little ways to the next sector.

Sector 5: Forest
The school house is nestled among the trees. A pylon stretches up from the same grove to the hub of the station. You can walk spinward or antispinward.

>asw
You walk a little ways to the next sector.

Sector 4: Crops
Your home is here among the crops. To the port and starboard, the station walls rise up to the hub above. You can walk spinward or antispinward.

>asw
You walk a little ways to the next sector.

Sector 3: Forest
Trees, a house, and a church. A red pylon stretches up from the ground to the hub of the station. You can walk spinward or antispinward.

>up
Wearing the boots, you are able to climb up the pylon. As you get closer to the hub, gravity decreases, and the climb becomes easier.

Platform 3
A platform about two thirds of the way towards the hub. You can continue spinward or antispinward.

You feel much lighter here, and you are very aware of how the station rotates, but everything is okay as long as you don't look down.

There is a red circuit breaker here.

>turn breaker on
You reach out and switch the circuit breaker on.

[Your score has just gone up by one point.]

* * *

>asw
You walk a little ways to the next sector.

Sector 2: Aquaculture
A deep pond with some fish. You can walk spinward or antispinward.

>enter pond
You set your belongings aside. With the air from the emergency mask, you breathe comfortably as you step into the pond. At the bottom, you find a valve and open it, then swim to the surface, climb out, and recover everything you were carrying.

[Your score has just gone up by one point.]

>remove mask
You take off the emergency mask.

* * *

>asw
You walk a little ways to the next sector.

Sector 1: Crops
You still maintain the crops here. There is a small graveyard and the barn remains from when this was the livestock sector. A pylon stretches up from the ground to the hub of the station. You can walk spinward or antispinward.

There is a secured hatch in the ground.

You have walked the entire ring. Everything is as expected, much is not working. Now, it's time to leave: the pods are below Sector 1.

>in
Barn
Not fancy: livestock on one side and feed on the other, but nothing remains of either. There is a plow near the entrance.

You can see a hoe here.

>get hoe
Taken.

>out
Sector 1: Crops
You still maintain the crops here. There is a small graveyard and the barn remains from when this was the livestock sector. A pylon stretches up from the ground to the hub of the station. You can walk spinward or antispinward.

There is a secured hatch in the ground.

>d
(first opening the floor hatch)

Pod Control
This room serves as an airlock for the pod bay, and holds an old space suit and various machinery such as the atmosphere pump. There is a brass plate on the wall.

There is an open hatch in the ceiling.

Beside the secured port door, a status display shows an error message.

>get all from pump
power module: (putting the instruction module into your pocket to make room)
Taken.
pressure regulation module: (putting the pressure regulation module into your pocket to make room)
Taken.

>scan regulator
Module is faulty.

* * *

>close ceiling hatch
You close the ceiling hatch.

>port
(first opening the bulkhead door)

Pod Bay
There are four berths for transit pods. Unfortunately, all are empty. There is also a pile of clutter. It looks like equipment removed to free up space in the transit pods.

An open door leads starboard.

You've been here before, of course, when other families were leaving. They always had a seat for you, but you stayed behind to care for your parents. And then there was nobody else left.

But this is troubling: you had counted, and you were sure there would be one pod left for you, but there are none.

[Your score has just gone up by one point.]

>get communications unit
Taken.

>starboard
Pod Control
This room serves as an airlock for the pod bay, and holds an old space suit and various machinery such as the atmosphere pump. There is a brass plate on the wall.

Beside the open port door, a status display glows green.

There is a secured hatch in the ceiling.

No pods left ... you breathe deeply and fight off a wave of despair.

>get functional power module
(putting the emergency mask into your pocket to make room)
Taken.

>close door
You close the bulkhead door.

You breathe deeply again and realize there's another way. You will just need to find a way to communicate outside.

>u
(first opening the ceiling hatch)

Sector 1: Crops
You still maintain the crops here. There is a small graveyard and the barn remains from when this was the livestock sector. A pylon stretches up from the ground to the hub of the station. You can walk spinward or antispinward.

There is an open hatch in the ground.

>sw
You walk a little ways to the next sector.

Sector 2: Aquaculture
A deep pond with some fish. You can walk spinward or antispinward.

* * *

>sw
You walk a little ways to the next sector.

Sector 3: Forest
Trees, a house, and a church. A red pylon stretches up from the ground to the hub of the station. You can walk spinward or antispinward.

>go church
Church
Before everyone left, you celebrated every sabbath here. The altar stands against one wall, and an organ and a portable audio unit stand against the other.

On the altar is The Founder's Testament.

A gray cable connects the organ to the audio unit.

>unplug cable from organ
You unplug the gray cable from the organ.

* * *

>plug cable into comms unit
You plug the gray cable into the emergency communications unit.

>get power module from audio
(putting the faulty power module into your pocket to make room)
Taken.

>put functional power into audio
You put the functional power module into the audio unit.

The audio unit beeps and a synthesized voice says "Comms unit connected."

>get cable and audio
gray cable: Taken.
audio unit: (putting the faulty pressure regulation module into your pocket to make room)
Taken.

>out
Sector 3: Forest
Trees, a house, and a church. A red pylon stretches up from the ground to the hub of the station. You can walk spinward or antispinward.

>u
Wearing the boots, you are able to climb up the pylon. As you get closer to the hub, gravity decreases, and the climb becomes easier.

Platform 3
A platform about two thirds of the way towards the hub. You can continue spinward or antispinward.

There is a red circuit breaker here.

>asw
Platform 1
A platform about two thirds of the way towards the hub. You can continue spinward or antispinward, or go up a ladder into the hub.

>u
Gravity fades as you climb.

Inside the Hub
This is your first time in this part of the station or even out of artificial gravity. You float weightless in the middle of a cylinder. It is cold up here, and the light is all artificial and without an obvious source. A ladder rotates around you, leading up or down or maybe out, and the airlock is to the port.

>wear mask
(first taking the emergency mask)
(putting the unscanned power module into your pocket to make room)
You put on the emergency mask.

>port
(first opening the starboard airlock door)

Airlock
The airlock is also a cylinder, with a closed door to the port, an open door to the starboard, and a red handle in the ceiling. It is very cold here.

>turn red handle
The starboard door slams shut. You turn the handle an entire rotation, and after a moment, you feel the air rush out of the airlock.

>port
(first opening the port airlock door)
You crawl through a narrow accessway.

Antenna Control
You float weightless at the port end of a cylinder. Through a surprisingly large window, you can see the station rotating around you, solar panels, and antennas, all backed by a spectacular field of stars.  A short lever extends from the floor, and a yellow cable waves from a small control panel.

It is very cold and dark here in the near vacuum. An airlock door leads starboard.

[Your score has just gone up by two points.]

>plug yellow into comms
You plug the yellow cable into the emergency communications unit.

>press 3
Calibrate to Delta/Plum.

>press 8
Calibrate to Gamma/Banana.

>press 5
Calibrate to Beta/Cherry.

>press 2
Calibration successful.

The audio unit vibrates, but in the vacuum, you can't hear what it is saying.

[Your score has just gone up by one point.]

>put hoe in lever
You slide the hoe into the hollow lever, forming a longer lever.

The audio unit vibrates, but in the vacuum, you can't hear what it is saying.

[Your score has just gone up by one point.]

>push lever
You push the hoe and the lever moves. After a moment, you feel air rush into the room.

The audio unit beeps and a synthesized voice says "Comms ready."

After a moment, it says "Launching automatic routines."

[Your score has just gone up by one point.]

>z
    *** You are not alone. ***

In that game you scored 10 out of a possible 10, in 72 turns.

Would you like to RESTART, RESTORE a saved game, QUIT, UNDO the last command, or read the CREDITS?

>rtree
Please give one of the answers above.

Would you like to RESTART, RESTORE a saved game, QUIT, UNDO the last command, or read the CREDITS?

* * *

>gonear calibration panel
Antenna Control
You float weightless at the port end of a cylinder. Through a surprisingly large window, you can see the station rotating around you, solar panels, and antennas, all backed by a spectacular field of stars.  A short lever extends from the floor, and a yellow cable waves from a small control panel.

It is very cold and dark here in the near vacuum. An airlock door leads starboard.

[Your score has just gone up by two points.]

>search panel
The calibration panel is empty.

>search door
The port airlock door is secured.

>search cable
You find nothing of interest.

>purloin power module
[Purloined.]

>put module in panel
There is no more room in the calibration panel.

* * *

>gonear gray
Church
Before everyone left, you celebrated every sabbath here. The altar stands against one wall, and an organ and a portable audio unit stand against the other.

On the altar is The Founder's Testament.

A gray cable connects the organ to the audio unit.

>get gray
Taken.

>drop gray
Dropped.

>out
* the gray cable 0 2.

Sector 3: Forest
Trees, a house, and a church. A red pylon stretches up from the ground to the hub of the station. You can walk spinward or antispinward.

>in
You can enter the church or the house.

>church
Church
Before everyone left, you celebrated every sabbath here. The altar stands against one wall, and an organ and a portable audio unit stand against the other.

On the altar is The Founder's Testament.

You can also see a gray cable (plugged into the organ and an audio unit) here.

>unplug gray from orga
You can't see any such thing.

>unplug gray from organ
You unplug the gray cable from the organ.

>take audio
Taken.

>out
* the gray cable 1 0.

The gray cable pulls out of the audio unit.

Sector 3: Forest
Trees, a house, and a church. A red pylon stretches up from the ground to the hub of the station. You can walk spinward or antispinward.

* * *

>gonear gray
Church
Before everyone left, you celebrated every sabbath here. The altar stands against one wall, and an organ and a portable audio unit stand against the other.

On the altar is The Founder's Testament.

A gray cable connects the organ to the audio unit.

>out
* the gray cable.

Sector 3: Forest
Trees, a house, and a church. A red pylon stretches up from the ground to the hub of the station. You can walk spinward or antispinward.

>in
You can enter the church or the house.

>church
Church
Before everyone left, you celebrated every sabbath here. The altar stands against one wall, and an organ and a portable audio unit stand against the other.

On the altar is The Founder's Testament.

A gray cable connects the organ to the audio unit.

>get gray
Taken.

* * *

>out
* the gray cable.

Sector 3: Forest
Trees, a house, and a church. A red pylon stretches up from the ground to the hub of the station. You can walk spinward or antispinward.

>undo
Church
[Previous turn undone.]

>get gray
Taken.

* * *

>gonear gray
Church
Before everyone left, you celebrated every sabbath here. The altar stands against one wall, and an organ and a portable audio unit stand against the other.

On the altar is The Founder's Testament.

A gray cable connects the organ to the audio unit.

>take audio
Taken.

>out
The gray cable pulls out of the audio unit.

Sector 3: Forest
Trees, a house, and a church. A red pylon stretches up from the ground to the hub of the station. You can walk spinward or antispinward.

>undo
Church
[Previous turn undone.]

>unplug audio from organ
But it isn't there now.

>unplug cable from organ
You unplug the gray cable from the organ.

>i
You are carrying:
  an audio unit
  a scanner
  a green jumpsuit (being worn)

>out
(first taking the gray cable)

Sector 3: Forest
Trees, a house, and a church. A red pylon stretches up from the ground to the hub of the station. You can walk spinward or antispinward.

>i
You are carrying:
  a gray cable (plugged into an audio unit)
  an audio unit
  a scanner
  a green jumpsuit (being worn)

* * *

>gonear gray
Church
Before everyone left, you celebrated every sabbath here. The altar stands against one wall, and an organ and a portable audio unit stand against the other.

On the altar is The Founder's Testament.

A gray cable connects the organ to the audio unit.

>take gray
Taken.

>out
* the gray cable.

The gray cable pulls out of the organ.
The gray cable pulls out of the audio unit.

Sector 3: Forest
Trees, a house, and a church. A red pylon stretches up from the ground to the hub of the station. You can walk spinward or antispinward.

>undo
Church
[Previous turn undone.]

* * *

>gonear organ
Church
Before everyone left, you celebrated every sabbath here. The altar stands against one wall, and an organ and a portable audio unit stand against the other.

On the altar is The Founder's Testament.

A gray cable connects the organ to the audio unit.

>up
The only exit is outside to sector 3.

>out
* the gray cable.

Sector 3: Forest
Trees, a house, and a church. A red pylon stretches up from the ground to the hub of the station. You can walk spinward or antispinward.

* * *

>gonear pod bay
(Pod Bay)
Pod Bay
There are four berths for transit pods. Unfortunately, all are empty. There is also a pile of clutter. It looks like equipment removed to free up space in the transit pods.

A secured door leads starboard.

You've been here before, of course, when other families were leaving. They always had a seat for you, but you stayed behind to care for your parents. And then there was nobody else left.

But this is troubling: you had counted, and you were sure there would be one pod left for you, but there are none.

[Your score has just gone up by one point.]

* * *

>gonear red breaker
Platform 3
A platform about two thirds of the way towards the hub. You can continue spinward or antispinward.

You feel much lighter here, and you are very aware of how the station rotates, but everything is okay as long as you don't look down.

There is a red circuit breaker here.

>x breaker
It is labelled "36-87."

The red circuit breaker is currently switched off.

* * *

>gonear window
Antenna Control
You float weightless at the port end of a cylinder. Through a surprisingly large window, you can see the station rotating around you, solar panels, and antennas, all backed by a spectacular field of stars.  A short lever extends from the floor, and a yellow cable waves from a small control panel.

It is very cold and dark here in the near vacuum. An airlock door leads starboard.

[Your score has just gone up by two points.]

* * *

>actions
Actions listing on.

* * *

>look
[looking]
Antenna Control
You float weightless at the port end of a cylinder. Through a surprisingly large window, you can see the station rotating around you, solar panels, and antennas, all backed by a spectacular field of stars.  A short lever extends from the floor, and a yellow cable waves from a small control panel.

It is very cold and dark here in the near vacuum. An airlock door leads starboard.

You can see a scanner floating here.

[looking - succeeded]

* * *

>gonear yello
There seems to be no such object anywhere in the model world.

>gonear yellow cable
Antenna Control
You float weightless at the port end of a cylinder. Through a surprisingly large window, you can see the station rotating around you, solar panels, and antennas, all backed by a spectacular field of stars.  A short lever extends from the floor, and a yellow cable waves from a small control panel.

It is very cold and dark here in the near vacuum. An airlock door leads starboard.

[Your score has just gone up by two points.]

>sb
That's not a verb I recognize.

>s
(first opening the port airlock door)
It seems to be locked.

>take yellow
That's hardly portable.

>take cable
That's hardly portable.

>i
You are carrying:
  a scanner
  a green jumpsuit (being worn)

>x cable
A two meter yellow RF cable. It is plugged into the calibration panel.

* * *

>gonear yellow
Antenna Control
You float weightless at the port end of a cylinder. Through a surprisingly large window, you can see the station rotating around you, solar panels, and antennas, all backed by a spectacular field of stars.  A short lever extends from the floor, and a yellow cable waves from a small control panel.

It is very cold and dark here in the near vacuum. An airlock door leads starboard.

[Your score has just gone up by two points.]

>search panel
You find nothing of interest.

>x panel
This is clearly the antenna calibration panel, made up of a display, a keypad, and a yellow RF cable.

The calibration panel has a yellow cable plugged into it.

* * *

>gonear yellow
Antenna Control
You float weightless at the port end of a cylinder. Through a surprisingly large window, you can see the station rotating around you, solar panels, and antennas, all backed by a spectacular field of stars.  A short lever extends from the floor, and a yellow cable waves from a small control panel.

It is very cold and dark here in the near vacuum. An airlock door leads starboard.

[Your score has just gone up by two points.]

>take yellow
Taken.

>s
The yellow cable is permanently attached to the panel, so you must drop it before leaving.

>drop cable
You release the yellow cable and it floats nearby.

>gonear red handle
Airlock
The airlock is also a cylinder, with a closed door to the port, a closed door to the starboard, and a red handle in the wall. It is very cold here.

>purloin mask
[Purloined.]

>wear it
You put on the emergency mask.

>pull handle
That doesn't work, but you could probably turn the handle.

>turn handle
You turn the handle an entire rotation, and after a moment, you feel the air rush out of the airlock.

>in
(first opening the port airlock door)
You crawl through a narrow accessway.

Antenna Control
You float weightless at the port end of a cylinder. Through a surprisingly large window, you can see the station rotating around you, solar panels, and antennas, all backed by a spectacular field of stars.  A short lever extends from the floor, and a yellow cable waves from a small control panel.

It is very cold and dark here in the near vacuum. An airlock door leads starboard.

You can see a yellow cable (plugged into the calibration panel) floating here.

>take yellow
Taken.

* * *

>s
The yellow cable is permanently attached to the panel, so you must drop it before leaving.

>drop yellow
You release the yellow cable and it floats nearby.

>s
You make your way back along the narrow accessway.

Airlock
The airlock is also a cylinder, with an open door to the port, a closed door to the starboard, and a red handle in the wall. It is very cold here and there is no air.

>gonear gray
Church
Before everyone left, you celebrated every sabbath here. The altar stands against one wall, and an organ and a portable audio unit stand against the other.

On the altar is The Founder's Testament.

A gray cable connects the organ to the audio unit.

>unplug gray from audio
You unplug the gray cable from the audio unit.

>undo
Church
[Previous turn undone.]

>unplug gray from organ
You unplug the gray cable from the organ.

* * *

>take audio
Taken.

>out
TAKE the gray cable.

The gray cable pulls out of the audio unit.

Sector 3: Forest
Trees, a house, and a church. A red pylon stretches up from the ground to the hub of the station. You can walk spinward or antispinward.

* * *

>rtree
Airlock
    red handle
Antenna Control
    window
    station
    lever
    calibration panel & RF socket, display, keypad 
    yellow cable & RF plug, RF plug 
Barn
    plow
    hoe
Cellar
    shelves + canned vegetables, emergency mask*  
    large bag of split peas
Church
    altar + Founder's Testament  
    organ & tan socket 
    audio unit*  + power module  & beige socket 
    gray cable & USB plug, USB plug 
Home
    blanket + green jumpsuit, pocket, scanner, yourself*  
House
    doll
Inside the Hub
Platform 1
Platform 3
    red circuit breaker
Platform 5
    pigeon droppings
    flock of pigeons
Pod Bay
    berths
    pile of clutter + RF socket, almond socket, atmosphere sensor, emergency communications unit, unremarkable junk  
Pod Control
    space suit
    brass plate
    status display
    atmosphere pump + power module, pressure regulation module  
School House
    learning machine + instruction module, power module  
    desk + clean eraser  
    chalkboard
Sector 1: Crops
    crops
    graveyard
    pylon
Sector 2: Aquaculture
    pond
    fish
Sector 3: Forest
    pylon
    trees
Sector 4: Crops
    vegetables
Sector 5: Forest
    pylon
    trees
Sector 6: Hydroponics
    hydroponics machines
Supply Vault
    crate of machine parts
    pair of gravity boots
(Nowhere)
    green valve
    handful of split peas
    hologram
    instruction module
    jar of pickled okra
    junk repository
    laser beam
    pressure regulation module
(Backdrops)
    antennas
    antennas
    ground
    hub
    maintenance platform
    maintenance platform
    mirrors
    pylon
    pylons
    solar panels
    stars
    station walls

* * *

>version
Founder's Mercy
A Space Story by Thomas Insel
Release 1 / Serial number 181221 / Inform 7 build 6M62 (I6/v6.33 lib 6/12N) SD
Type ABOUT for credits or HINT for assistance.
Identification number: //BCC61E7F-CE8E-4C25-9E9D-5550D1138D8C//
Interpreter version 0.5.2 / VM 3.1.2 / Library serial number 080126
Standard Rules version 3/120430 by Graham Nelson
Plugs and Sockets version 4/170924 by Sean Turner
Object Response Tests version 7 by Juhana Leinonen
Real-Time Delays version 1/100607 by Erik Temple

>about
About Founder's Mercy
This is my second released Inform project, conceived and implemented in the last months of 2018.

Thanks to Graham Nelson, Andrew Plotkin, Emily Short, and everyone else who contributed to the Inform and Glulx ecosystem. Thanks also Juhana Leinonen for the Object Response Tests extension, Erik Temple for the Real-Time Delays extension, and Sean Turner for the Plugs and Sockets extension. Exit listing code is inspired by Eric Eve's Exit Lister and keypad code is inspired by Emily Short's Computers.

The cover art is adapted from Figure 1.1 from NASA SP-413, Space Settlements: A Design Study, edited by Richard D. Johnson and Charles Holbrow, and available from The Internet Archive at https://archive.org/details/SpaceSettlementsADesignStudy1977 .

Please send your feedback, bug reports, and requests for help to tinsel@tinsel.org. You can always find the current version of this story at http://tinsel.org/IF/ .

This work is Copyright © 2019 Thomas Insel but may be freely shared according to the terms of the Creative Commons Attribution 4.0 International license (https://creativecommons.org/licenses/by/4.0/).

* * *

>x me
As virtuous as ever.

>gonear pod bay
(Pod Bay)
Pod Bay
There are four berths for transit pods. Unfortunately, all are empty. There is also a pile of clutter. It looks like equipment removed to free up space in the transit pods.

A secured door leads starboard.

You've been here before, of course, when other families were leaving. They always had a seat for you, but you stayed behind to care for your parents. And then there was nobody else left.

But this is troubling: you had counted, and you were sure there would be one pod left for you, but there are none.

[Your score has just gone up by one point.]

>z
Time passes.

>z
Time passes.

No pods left ... you breathe deeply and fight off a wave of despair.

>z
Time passes.

>z
Time passes.

You breathe deeply again and realize there's another way. You will just need to find a way to communicate outside.

* * *

>x me
As virtuous as ever.

>gonear red breaker
Platform 3
A platform about two thirds of the way towards the hub. You can continue spinward or antispinward.

You feel much lighter here, and you are very aware of how the station rotates, but everything is okay as long as you don't look down.

There is a red circuit breaker here.

>x breaker
The red circuit breaker is currently switched off.

* * *

>x pockt
You can't see any such thing.

>search pocket
The pocket is empty.

>x pocket
The pocket is empty.

>i
You are carrying:
  a scanner
  a green jumpsuit (being worn)

>x jumpsuit
You have worn modest jumpsuits like this since you were small. Originally, the colors had meanings: forest green for farmers, navy blue for technicians, and so on, but that distinction died even before the community.

It features a single large pocket, currently empty.

>gonear window
Antenna Control
You float weightless at the port end of a cylinder. Through a surprisingly large window, you can see the station rotating around you, solar panels, and antennas, all backed by a spectacular field of stars.  A short lever extends from the floor, and a yellow cable waves from a small control panel.

It is very cold and dark here in the near vacuum. An airlock door leads starboard.

[Your score has just gone up by two points.]

>unplug window
The window is not plugged into anything.

>unplug window from station
But it isn't there now.

>unplug station from window
The station is all around you, so you should try something more specific instead.

>analyze window
examining the window:
You might be the first person to look out through this window in a generation. While you've seen the stars through transparent walls of the station, the view from here is different and entirely more impressive.

looking under the window:
You find nothing of interest.

searching the window:
You might be the first person to look out through this window in a generation. While you've seen the stars through transparent walls of the station, the view from here is different and entirely more impressive.

listening to the window:
You hear nothing unexpected.

smelling the window:
You smell nothing unexpected.

attacking the window:
The Founder said that violence is rarely the answer.

buying the window:
Nothing is on sale.

climbing the window:
Little is to be achieved by that.

pulling the window:
It is fixed in place.

pushing the window:
It is fixed in place.

turning the window:
It is fixed in place.

pushing the window to starboard:
The window cannot be pushed from place to place.

opening the window:
It isn't something you can open.

entering the window:
That's not something you can enter.

getting off the window:
But you aren't on the window at the moment.

closing the window:
It isn't something you can close.

taking the window:
That's hardly portable.

switching on the window:
It isn't something you can switch.

switching off the window:
It isn't something you can switch.

wearing the window:
(first taking the window)
That's hardly portable.

taking off the window:
You aren't wearing the window.

touching the window:
You feel nothing unexpected.

rubbing the window:
You rub the window.

waving the window:
But you aren't holding that.

squeezing the window:
You achieve nothing by this.

burning the window:
There is no open flame on the station.

cutting the window:
The Founder said that violence is rarely the answer.

tying the window to the solar panels:
You would achieve nothing by this.

swinging the window:
There's nothing sensible to swing here.

tasting the window:
You taste nothing unexpected.

drinking the window:
There's nothing suitable to drink here.

eating the window:
That's plainly inedible.

dropping the window:
The window is already here.

typing 7 on the window: 
There is no keypad on the window.

typing mimolette on the window: 
There is no keypad on the window.

feeding the window:
You can only do that to something animate.

swimming in the window:
You can't swim in the window.

playing the window:
That isn't something you can play.

unplugging the window:
The window is not plugged into anything.

>analyze lever
examining the lever:
A short length of hollow steel pipe pulled out from the wall.

looking under the lever:
You find nothing of interest.

searching the lever:
The lever is empty.

listening to the lever:
You hear nothing unexpected.

smelling the lever:
You smell nothing unexpected.

attacking the lever:
The Founder said that violence is rarely the answer.

buying the lever:
Nothing is on sale.

climbing the lever:
Little is to be achieved by that.

pulling the lever:
The lever is already pulled as far as it goes.

pushing the lever:
You try, but is too hard to push the lever without more mechanical advantage.

turning the lever:
It is fixed in place.

pushing the lever to starboard:
The lever cannot be pushed from place to place.

opening the lever:
It isn't something you can open.

entering the lever:
That's not something you can enter.

getting off the lever:
But you aren't on the lever at the moment.

closing the lever:
It isn't something you can close.

taking the lever:
That's hardly portable.

switching on the lever:
It isn't something you can switch.

switching off the lever:
It isn't something you can switch.

wearing the lever:
(first taking the lever)
That's hardly portable.

taking off the lever:
You aren't wearing the lever.

touching the lever:
You feel nothing unexpected.

rubbing the lever:
You rub the lever.

waving the lever:
But you aren't holding that.

squeezing the lever:
You achieve nothing by this.

burning the lever:
There is no open flame on the station.

cutting the lever:
The Founder said that violence is rarely the answer.

tying the lever to the solar panels:
You would achieve nothing by this.

swinging the lever:
There's nothing sensible to swing here.

tasting the lever:
You taste nothing unexpected.

drinking the lever:
There's nothing suitable to drink here.

eating the lever:
That's plainly inedible.

dropping the lever:
The lever is already here.

typing 7 on the lever: 
There is no keypad on the lever.

typing mimolette on the lever: 
There is no keypad on the lever.

feeding the lever:
You can only do that to something animate.

swimming in the lever:
You can't swim in the lever.

playing the lever:
That isn't something you can play.

unplugging the lever:
The lever is not plugged into anything.