You awake. You are lonely, so lonely. It was a thousand days ago today. All alone these thousand days. Your parents were the last. No, your father was the last. He held on for nearly a hundred days longer. No, you are the last. Alone. Adrift.

But maybe it isn't hopeless. There must still be other people in other worlds, and you think you know how to get there.

Today is the day.

Founder's Mercy
A Space Story by Thomas Insel
Release 1 / Serial number 181124 / Inform 7 build 6M62 (I6/v6.33 lib 6/12N) SD
Type "about" for credits and more information.

Home
The room where you've slept your entire life. You can go out towards the crops.

There is a secured hatch in the floor.

>* minimal walkthrough
(Noted.)

* * *

>put functional power into audio
You put the functional power module into the audio unit.

>close audio
You close the audio unit and it seals without any trace of a seam.

The audio unit beeps and a synthesized voice says "Comms ready."

You call for help. I need to write this bit.

    *** You win. ***

In that game you scored 50 out of a possible 50, in 54 turns.

Would you like to RESTART, RESTORE a saved game, QUIT, or UNDO the last command?

* * *

>* scratch
(Noted.)

>gonear organ
Church
Before everyone left or died, you celebrated every sabbath here. The altar stands against one wall, and an organ and an audio unit stand against the other.

On the altar is The Founder's Testament.

A gray cable connects the organ and the audio unit.

>get cable
Taken.

>out
The gray cable pulls out from the organ.
The gray cable pulls out from the audio unit.

Sector 3: Forest
Trees, a house, and a church. A red pylon stretches up from the ground to the hub of the station. You can walk spinward or antispinward.

>look
Sector 3: Forest
Trees, a house, and a church. A red pylon stretches up from the ground to the hub of the station. You can walk spinward or antispinward.

>i
You are carrying:
  a gray cable
  a scanner
  a green jumpsuit (being worn)

>look
Sector 3: Forest
Trees, a house, and a church. A red pylon stretches up from the ground to the hub of the station. You can walk spinward or antispinward.

>scan cable
Cable is functional.

>scanner, open cable.
Cable is unitary.

>scan cable
Cable is functional.

>scanner, open cable
Cable is unitary.

>in
You can enter the church or the house.

>go church
Church
Before everyone left or died, you celebrated every sabbath here. The altar stands against one wall, and an organ and an audio unit stand against the other.

On the altar is The Founder's Testament.

>connect cable to audio unit
You plug the gray cable into the audio unit.

>connect cable to organ
You plug the gray cable into the organ.

>scan cable
Cable is functional.

>scan organ
Machine functional. No output available.

>purloin comms
[Purloined.]

>purloin all modules
[Purloined.]
[Purloined.]
[Purloined.]
[Purloined.]
[Purloined.]
[Purloined.]
[Purloined.]

>scan power
Component is functional.

>open comms
You will need to use the scanner to do that.

>x comms
A portable communications unit with a single socket to connect it to an audio unit.

The communications unit has nothing plugged into it.

>scanner, open comms
Machine is unitary.

>scanner, open audio
Opening.

The audio unit swings open.

>get all
Founder's Testament: (putting the scanner into your pocket to make room)
You're carrying too many things already.

>i
You are carrying:
  two unscanned pressure regulator modules
  two unscanned instruction modules
  a functional power module
  two unscanned power modules
  the communications unit
  a gray cable (plugged into the organ and an audio unit)
  a green jumpsuit (being worn)

Your jumpsuit pocket contains:
  a scanner

>get all
Founder's Testament: (putting the gray cable into your pocket to make room)
You're carrying too many things already.

>drop all
unscanned pressure regulator module: Dropped.
unscanned instruction module: Dropped.
unscanned instruction module: Dropped.
functional power module: Dropped.
unscanned power module: Dropped.
unscanned pressure regulator module: Dropped.
unscanned power module: Dropped.
communications unit: Dropped.

>get all
communications unit: Taken.
unscanned power module: Taken.
unscanned pressure regulator module: Taken.
unscanned power module: (putting the communications unit into your pocket to make room)
Taken.
functional power module: (putting the unscanned power module into your pocket to make room)
Taken.
unscanned instruction module: (putting the unscanned pressure regulator module into your pocket to make room)
Taken.
unscanned instruction module: (putting the unscanned power module into your pocket to make room)
Taken.
unscanned pressure regulator module: (putting the functional power module into your pocket to make room)
Taken.
Founder's Testament: (putting the unscanned instruction module into your pocket to make room)
Taken.

>look
Church
Before everyone left or died, you celebrated every sabbath here. The altar stands against one wall, and an organ and an audio unit stand against the other.

>i
You are carrying:
  The Founder's Testament
  an unscanned pressure regulator module
  an unscanned instruction module
  a green jumpsuit (being worn)

Your jumpsuit pocket contains:
  an unscanned instruction module
  a functional power module
  two unscanned power modules
  an unscanned pressure regulator module
  the communications unit
  a gray cable (plugged into the organ and an audio unit)
  a scanner

>put functional power in audio
(first taking the functional power module)
(putting the unscanned instruction module into your pocket to make room)
You put the functional power module into the audio unit.

>look
Church
Before everyone left or died, you celebrated every sabbath here. The altar stands against one wall, and an organ and an audio unit stand against the other.

>x audio
The audio unit incorporates a speaker, a microphone, and a socket you would use to connect it to another device.

In the audio unit is a power module.

The audio unit has a gray cable plugged into it.

>scan audio
Machine functional. Input connected.

>x cable
A one meter USB 7.2 cable with a Type-F plug at each end.

It is plugged into the organ and an audio unit.

>close audio
You close the audio unit and it seals without any trace of a seam.

The audio unit beeps and a synthesized voice says "Organ ready."

>scan cable
Cable is functional.

>scan audio
Machine functional. Input connected.

>play organ
You never really learned how to play, but you pick out a few notes on the keyboard and the sound reverberates from the audio unit.

* * *

>* scratch
(Noted.)

>purloin comms
[Purloined.]

>put comms in pocket
That is too big for your pocket.

>i
You are carrying:
  the communications unit
  a scanner
  a green jumpsuit (being worn)

>purloin all modules
[Purloined.]
[Purloined.]
[Purloined.]
[Purloined.]
[Purloined.]
[Purloined.]
[Purloined.]

>drop all
pressure regulator module: Dropped.
instruction module: Dropped.
instruction module: Dropped.
power module: Dropped.
power module: Dropped.
pressure regulator module: Dropped.
power module: Dropped.
communications unit: Dropped.
scanner: Dropped.

>get comms
Taken.

>i
You are carrying:
  the communications unit
  a green jumpsuit (being worn)

>get all
scanner: Taken.
power module: Taken.
pressure regulator module: (putting the communications unit into your pocket to make room)
That is too big for your pocket.

power module: (putting the communications unit into your pocket to make room)
That is too big for your pocket.

power module: (putting the communications unit into your pocket to make room)
That is too big for your pocket.

instruction module: (putting the communications unit into your pocket to make room)
That is too big for your pocket.

instruction module: (putting the communications unit into your pocket to make room)
That is too big for your pocket.

pressure regulator module: (putting the communications unit into your pocket to make room)
That is too big for your pocket.

>look
Home
The room where you've slept your entire life. You can go out towards the crops.

There is a secured hatch in the floor.

You can also see two pressure regulator modules, two power modules, and two instruction modules here.

* * *

>* scratch
(Noted.)

>scenes
Scene 'Entire Game' playing (for 0 mins now)
Scene 'Beginning' playing (for 0 mins now)
(Scene monitoring now switched on. Type "scenes off" to switch it off again.)

* * *

>asw
You walk a little ways to the next sector.

Sector 2: Aquaculture
A deep pond is used as part of the water filtration system and for raising fish. You can walk spinward or antispinward.

>aws
That's not a verb I recognize.

>asw
You walk a little ways to the next sector.

Sector 1: Crops
You still maintain the crops here. There is a small graveyard and the barn remains from when this was the livestock sector. A pylon stretches up from the ground to the hub of the station. You can walk spinward or antispinward.

There is a secured hatch in the ground.

* * *

>asw
You walk a little ways to the next sector.

Sector 5: Forest
The school house is nestled among the trees. A pylon stretches up from the same grove to the hub of the station. You can walk spinward or antispinward.

[Scene 'Ready to Repair' begins]
You have walked the entire ring. Everything is as expected, much is not working. Now, it's time to leave. The pods are below Sector 1.

[Scene 'Beginning' ends]

>help
Now it's time to leave the station, but you need to explore a little more.

* * *

>about
About Founder's Mercy
Founder's Mercy is my second released Inform project, conceived and implemented in November of 2018.

Thanks to Graham Nelson, Andrew Plotkin, Emily Short, and everyone else who contributed to the Inform and Glulx ecosystem. Thanks also to Eric Eve for the Exit Lister extension, Juhana Leinonen for the Object Response Tests extension, and Sean Turner for the Plugs and Sockets extension. The cover art is adapted from Figure 1.1 from NASA SP-413, Space Settlements: A Design Study, edited by Richard D. Johnson and Charles Holbrow, and available from The Internet Archive at https://archive.org/details/SpaceSettlementsADesignStudy1977 .

Please send your feedback, bug reports, and requests for help to tinsel@tinsel.org. You can always find the current version of this game at http://tinsel.org/IF/ .

This work is Copyright  2018 Thomas Insel but may be freely shared according to the terms of the Creative Commons Attribution 4.0 International license (https://creativecommons.org/licenses/by/4.0/).

>hint
Your goal is simply to leave the station and find other people. You can start by looking around and leaving your initial location.

By the way, it should be impossible to put this game into an unwinnable state, so feel free to explore and expirement.

If you are having trouble getting started, I suggest reading A Beginner's Guide to Interactive Fiction by Stephen Granade and Emily Short, available at:

  https://brasslantern.org/players/howto/beginnersguide.html

* * *

>get plugs
You can't see any such thing.

>gonear organ
Church
Before everyone left or died, you celebrated every sabbath here. The altar stands against one wall, and an organ and an audio unit stand against the other.

On the altar is The Founder's Testament.

A gray cable connects the organ and the audio unit.

>get plugs
(the gray cable)
Taken.

>x cable
A one meter USB 7.2 Type-F cable.

It is plugged into the organ and an audio unit.

* * *

>gonear altar
Church
Before everyone left or died, you celebrated every sabbath here. The altar stands against one wall, and an organ and an audio unit stand against the other.

On the altar is The Founder's Testament.

A gray cable connects the organ and the audio unit.

You can also see a bag (empty) here.

>put cable in bag
(first taking the gray cable)
You put the gray cable into the bag.

>i
You are carrying:
  a scanner
  a green jumpsuit (being worn)

>look
Church
Before everyone left or died, you celebrated every sabbath here. The altar stands against one wall, and an organ and an audio unit stand against the other.

On the altar is The Founder's Testament.

You can also see a bag (in which is a gray cable (plugged into the organ and an audio unit)) here.

>close bag
You close the bag.

>look
Church
Before everyone left or died, you celebrated every sabbath here. The altar stands against one wall, and an organ and an audio unit stand against the other.

On the altar is The Founder's Testament.

You can also see a bag (closed) here.

>get bag
Taken.

>w
You have heard of compass directions like west, but they don't make any sense here. Instead, you can go spinward, antispinward, port, and starboard. When you look spinward, port is left and starboard is right.

[You can use the abbreviations "sw", "asw", "p", and "s". You can also go "up", "down", "in", and "out" where appropriate. Type "exits" if you get confused about geography.]

>out
Sector 3: Forest
Trees, a house, and a church. A red pylon stretches up from the ground to the hub of the station. You can walk spinward or antispinward.

>i
You are carrying:
  a bag (closed)
  a scanner
  a green jumpsuit (being worn)

>open bag
You open the bag, revealing a gray cable (plugged into the organ and an audio unit).

>in
You can enter the church or the house.

>get cable
Taken.

>in
You can enter the church or the house.

>go church
The gray cable pulls out from the organ.
The gray cable pulls out from the audio unit.

Church
Before everyone left or died, you celebrated every sabbath here. The altar stands against one wall, and an organ and an audio unit stand against the other.

On the altar is The Founder's Testament.

>restart
Are you sure you want to restart?

>yes
You awake. You are lonely, so lonely. It was a thousand days ago today. All alone these thousand days. Your parents were the last. No, your father was the last. He held on for nearly a hundred days longer. No, you are the last. Alone. Adrift.

But maybe it isn't hopeless. There must still be other people in other worlds, and you think you know how to get there.

Today is the day.

Founder's Mercy
A Space Story by Thomas Insel
Release 1 / Serial number 181124 / Inform 7 build 6M62 (I6/v6.33 lib 6/12N) SD
Type "about" for credits and more information.

Home
The room where you've slept your entire life. You can go out towards the crops.

There is a secured hatch in the floor.

>gonear altar
Church
Before everyone left or died, you celebrated every sabbath here. The altar stands against one wall, and an organ and an audio unit stand against the other.

On the altar is The Founder's Testament.

A gray cable connects the organ and the audio unit.

You can also see a bag (empty) here.

>get cable
Taken.

>put cable in pocket
You put the gray cable into the pocket.

>out
Sector 3: Forest
Trees, a house, and a church. A red pylon stretches up from the ground to the hub of the station. You can walk spinward or antispinward.

* * *

>gonear grey cable
Church
Before everyone left or died, you celebrated every sabbath here. The altar stands against one wall, and an organ and an audio unit stand against the other.

On the altar is The Founder's Testament.

A gray cable connects the organ and the audio unit.

>x gray cable
A one meter USB 7.2 Type-F cable.

It is plugged into the organ and an audio unit.

>x plug
(the gray cable)
A one meter USB 7.2 Type-F cable.

It is plugged into the organ and an audio unit.

>get plugs
usb plug: That seems to be a part of the gray cable.
usb plug: That seems to be a part of the gray cable.

>plug cable
What do you want to plug the gray cable into?

>gray
The gray cable has no socket.

* * *

>gonear learning
School
One broken learning machine remains in a corner, but mostly the older farmers took turns leading the class. There is a desk and a chalkboard hangs on one wall.

On the desk is a clean eraser.

* * *

>x learning
This last learning machine broke when you were maybe three thousand days old.

In the learning machine are a power module and an instruction module.

>x power
It is a standardized machine module.

>scan power
Component is functional.

>x learning
This last learning machine broke when you were maybe three thousand days old.

In the learning machine are a functional power module and an unscanned instruction module.

>x power
It is a standardized machine module.

The scanner reported this power module as functional.

* * *

>scanner, open learning
Opening.

The learning machine swings open.

[Your score has just gone up by five points.]

>x learning
This last learning machine broke when you were maybe three thousand days old.

In the learning machine are a <<<<<<<<<<<<<<<<<<<power module, the learning machine, nothing>power module, the learning machine, nothing>power module, the learning machine, nothing>power module, the learning machine, nothing>power module, the learning machine, nothing>power module, the learning machine, nothing>power module, the learning machine, nothing>power module, the learning machine, nothing>power module, the learning machine, nothing>power module, the learning machine, nothing>power module, the learning machine, nothing>power module, the learning machine, nothing>power module, the learning machine, nothing>power module, the learning machine, nothing>power module, the learning machine, nothing>power module, the learning machine, nothing>power module, the learning machine, nothing>power module, the learning machine, nothing>power module, the learning machine, nothing>power module and a <<<<<<<<<<<<<<<<<<<instruction module, the learning machine, nothing>instruction module, the learning machine, nothing>instruction module, the learning machine, nothing>instruction module, the learning machine, nothing>instruction module, the learning machine, nothing>instruction module, the learning machine, nothing>instruction module, the learning machine, nothing>instruction module, the learning machine, nothing>instruction module, the learning machine, nothing>instruction module, the learning machine, nothing>instruction module, the learning machine, nothing>instruction module, the learning machine, nothing>instruction module, the learning machine, nothing>instruction module, the learning machine, nothing>instruction module, the learning machine, nothing>instruction module, the learning machine, nothing>instruction module, the learning machine, nothing>instruction module, the learning machine, nothing>instruction module, the learning machine, nothing>instruction module.

* * *

>gonear learninig
There seems to be no such object anywhere in the model world.

>gonear learning
School
One broken learning machine remains in a corner, but mostly the older farmers took turns leading the class. There is a desk and a chalkboard hangs on one wall.

On the desk is a clean eraser.

>scanner, open learninig
Search error: cannot find learninig.

[You can ask the scanner for a list of commands by typing "scanner, help" and give it voice commands by typing phrases such as "scanner, scan SOMETHING" or "scanner, open SOMETHING" where SOMETHING is a visible object.]

>scanner, open learning
Opening.

The learning machine swings open.

[Your score has just gone up by five points.]

>x machine
This last learning machine broke when you were maybe three thousand days old.

In the learning machine are a power module and an instruction module.

>scan power module
Component is functional.

>x machine
This last learning machine broke when you were maybe three thousand days old.

In the learning machine are a functional power module and an unscanned instruction module.

>x functional
It is a standardized machine module.

The scanner reported this functional power module as functional.

* * *

>gonear organ
Church
Before everyone left or died, you celebrated every sabbath here. The altar stands against one wall, and an organ and an audio unit stand against the other.

On the altar is The Founder's Testament.

A gray cable connects the organ and the audio unit.

>analyze cable
examining the gray cable:
A one meter USB 7.2 cable with a Type-F plug at each end.

It is plugged into the organ and an audio unit.

looking under the gray cable:
You find nothing of interest.

searching the gray cable:
You find nothing of interest.

listening to the gray cable:
You hear nothing unexpected.

smelling the gray cable:
You smell nothing unexpected.

attacking the gray cable:
The Founder said that violence is never the answer.

buying the gray cable:
Nothing is on sale.

climbing the gray cable:
Little is to be achieved by that.

pulling the gray cable:
Nothing obvious happens.

pushing the gray cable:
Nothing obvious happens.

turning the gray cable:
Nothing obvious happens.

pushing the gray cable to outside:
The gray cable cannot be pushed from place to place.

opening the gray cable:
It isn't something you can open.

entering the gray cable:
That's not something you can enter.

getting off the gray cable:
But you aren't on the gray cable at the moment.

closing the gray cable:
It isn't something you can close.

taking the gray cable:
Taken.

switching on the gray cable:
It isn't something you can switch.

switching off the gray cable:
It isn't something you can switch.

wearing the gray cable:
You can't wear that!

taking off the gray cable:
The gray cable is plugged into more than one thing.

[Try "unplug gray cable from SOMETHING".]

(no other people in the location; can't test throwing at.)

(no other people in the location; can't test showing to.)

(no other people in the location; can't test giving to.)

touching the gray cable:
You feel nothing unexpected.

rubbing the gray cable:
You rub the gray cable.

waving the gray cable:
You wave the gray cable.

squeezing the gray cable:
You achieve nothing by this.

burning the gray cable:
There is no open flame on the station.

cutting the gray cable:
The Founder said that violence is never the answer.

tying the gray cable to the altar:
You would achieve nothing by this.

swinging the gray cable:
There's nothing sensible to swing here.

tasting the gray cable:
You taste nothing unexpected.

drinking the gray cable:
There's nothing suitable to drink here.

eating the gray cable:
That's plainly inedible.

dropping the gray cable:
Dropped.

* * *

>gonear organ
Church
Before everyone left or died, you celebrated every sabbath here. The altar stands against one wall, and an organ and an audio unit stand against the other.

On the altar is The Founder's Testament.

A gray cable connects the organ and the audio unit.

>get audio
It is too heavy to move.

* * *

>get cable
Taken.

>drop cable
Dropped.

>look
Church
Before everyone left or died, you celebrated every sabbath here. The altar stands against one wall, and an organ stands against the other, beside an audio unit.

On the altar is The Founder's Testament.

You can also see a gray cable (plugged into the organ and an audio unit) here.

* * *

>get cable
Taken.

>out
The gray cable disconnects from the organ.
The gray cable disconnects from the audio unit.

Sector 3: Forest
Trees, a house, and a church. A red pylon stretches up from the ground to the hub of the station. You can walk spinward or antispinward.

>undo
Church
[Previous turn undone.]

>i
You are carrying:
  a gray cable (plugged into the organ and an audio unit)
  a scanner
  a green jumpsuit (being worn)

>purloin comms
[Purloined.]

>disconnect cable from organ
You unplug the gray cable from the organ.

>connect cable to comms
You plug the gray cable into the communications unit.

>out
The gray cable disconnects from the audio unit.

Sector 3: Forest
Trees, a house, and a church. A red pylon stretches up from the ground to the hub of the station. You can walk spinward or antispinward.

>i
You are carrying:
  the communications unit
  a gray cable (plugged into the communications unit)
  a scanner
  a green jumpsuit (being worn)

>go church
Church
Before everyone left or died, you celebrated every sabbath here. The altar stands against one wall, and an organ and an audio unit stand against the other.

On the altar is The Founder's Testament.

>out
Sector 3: Forest
Trees, a house, and a church. A red pylon stretches up from the ground to the hub of the station. You can walk spinward or antispinward.

* * *

>undo
Church
[Previous turn undone.]

>pull cable
Nothing obvious happens.

>unplug cable
The gray cable is plugged into more than one thing.

[Try "unplug gray cable from SOMETHING".]

* * *

>undo
Church
[Previous turn undone.]

>put cable in pocket
You put the gray cable into the pocket.

>out
The gray cable disconnects from the organ.
The gray cable disconnects from the audio unit.

Sector 3: Forest
Trees, a house, and a church. A red pylon stretches up from the ground to the hub of the station. You can walk spinward or antispinward.

* * *

>get cable
Taken.

>tie cable to me
Tying the cable would damage it.

>look
Church
Before everyone left or died, you celebrated every sabbath here. The altar stands against one wall, and an organ and an audio unit stand against the other.

On the altar is The Founder's Testament.

>attach cable to altar
Tying the cable would damage it.

* * *

>gonear organ
Church
Before everyone left or died, you celebrated every sabbath here. The altar stands against one wall, and an organ and an audio unit stand against the other.

On the altar is The Founder's Testament.

A gray cable connects the organ and the audio unit.

>get usb
(the gray cable)
Taken.

>x usb
(the gray cable)
A one meter USB 7.2 Type-F cable.

It is plugged into the organ and an audio unit.

>out
It is impractical to leave with the gray cable attached to the organ.

>drop cable
Dropped.

* * *

>look
Church
Before everyone left or died, you celebrated every sabbath here. The altar stands against one wall, and an organ stands against the other, beside an audio unit.

On the altar is The Founder's Testament.

You can also see a gray cable (plugged into the organ and an audio unit) here.

>unplug cable
The gray cable is plugged into more than one thing.

[Try "unplug gray cable from SOMETHING".]

>unplug cable from organ
You unplug the gray cable from the organ.

>unplug cable from audio
You unplug the gray cable from the audio unit.

>i
You are carrying:
  a scanner
  a green jumpsuit (being worn)

>get cable
Taken.

>out
Sector 3: Forest
Trees, a house, and a church. A red pylon stretches up from the ground to the hub of the station. You can walk spinward or antispinward.

>drop cable
Dropped.

>in
You can enter the church or the house.

>go church
Church
Before everyone left or died, you celebrated every sabbath here. The altar stands against one wall, and an organ stands against the other, beside an audio unit.

On the altar is The Founder's Testament.

>x altar
Really just a table.

On the altar is The Founder's Testament.

>x organ
It's really just a keyboard. It has a single socket to connect it to an audio unit.

The organ has nothing plugged into it.

>look
Church
Before everyone left or died, you celebrated every sabbath here. The altar stands against one wall, and an organ stands against the other, beside an audio unit.

On the altar is The Founder's Testament.

>look
Church
Before everyone left or died, you celebrated every sabbath here. The altar stands against one wall, and an organ stands against the other, beside an audio unit.

On the altar is The Founder's Testament.

>x usb
It is a female standard connector of the organ. It has nothing plugged into it.

>x usb
It is a female standard connector of the organ. It has nothing plugged into it.

* * *

>gonear organ
Church
Before everyone left or died, you celebrated every sabbath here. The altar stands against one wall, and an organ and an audio unit stand against the other.

On the altar is The Founder's Testament.

A gray cable connects the organ and the audio unit.

>pull cable
The gray cable is plugged into more than one thing.

[Try "unplug gray cable from SOMETHING".]

>take cable
Taken.

>i
You are carrying:
  a gray cable (plugged into the organ and an audio unit)
  a scanner
  a green jumpsuit (being worn)

* * *

>gonear organ
Church
Before everyone left or died, you celebrated every sabbath here. The altar stands against one wall, and an organ and an audio unit stand against the other.

On the altar is The Founder's Testament.

A gray cable connects the organ and the audio unit.

>put cable in pocket
(first taking the gray cable)
You put the gray cable into the pocket.

>out
Sector 3: Forest
Trees, a house, and a church. A red pylon stretches up from the ground to the hub of the station. You can walk spinward or antispinward.

* * *

>gonear organ
Church
Before everyone left or died, you celebrated every sabbath here. The altar stands against one wall, and an organ and an audio unit stand against the other.

On the altar is The Founder's Testament.

A gray cable connects the organ and the audio unit.

>scanner, open audio
Opening.

The audio unit swings open.

>purloin all power units
There seems to be no such object anywhere in the model world.

>purloin all power modules
[Purloined.]

>i
You are carrying:
  a power module
  a scanner
  a green jumpsuit (being worn)

>purloin power modules
[Purloined.]

>i
You are carrying:
  a power module
  a scanner
  a green jumpsuit (being worn)

>look
Church
Before everyone left or died, you celebrated every sabbath here. The altar stands against one wall, and an organ stands against the other.

On the altar is The Founder's Testament.

You can also see an audio unit (empty) and a gray cable (plugged into the organ and an audio unit) here.

>restart
Are you sure you want to restart?

* * *

>purloin power modules
[Purloined.]
[Purloined.]
[Purloined.]

>i
You are carrying:
  three power modules
  a scanner
  a green jumpsuit (being worn)

>gonear organ
Church
Before everyone left or died, you celebrated every sabbath here. The altar stands against one wall, and an organ stands against the other.

On the altar is The Founder's Testament.

You can also see an audio unit and a gray cable (plugged into the organ and an audio unit) here.

>scan power module
Component is functional.

>scanner, open organ
Machine is unitary.

>scanner, open audio
Opening.

The audio unit swings open.

>x audio
The audio unit incorporates a speaker, a microphone, and a single socket you would use to connect it to another device.

There is space for one more module.

The audio unit has a gray cable plugged into it.

>play organ
Nothing happens.

>put functional power in audio
You put the functional power module into the audio unit.

>play organ
Nothing happens.

>close organ
It isn't something you can close.

>close audio
You close the audio unit and it seals without any trace of a seam.

The audio unit beeps and a synthesized voice says "Organ ready."

>play organ
You never really learned how to play, but you pick out a few notes on the keyboard and the sound reverberates from the audio unit.

>g
You play a few notes.

>open audio
You will need to use the scanner to do that.

>scanner, openaudio
Syntax error: command not in vocabulary.

[You can ask the scanner for a list of commands by typing "scanner, help" and give it voice commands by typing phrases such as "scanner, scan SOMETHING" or "scanner, open SOMETHING" where SOMETHING is a visible object.]

>scanner open audio
That's not a verb I recognize.

>scanner, open audio
Opening.

The audio unit swings open.

The audio unit beeps and a synthesized voice says "No input."

>close audio
You close the audio unit and it seals without any trace of a seam.

The audio unit beeps and a synthesized voice says "Organ ready."

* * *

>gonear organ
Church
Before everyone left or died, you celebrated every sabbath here. The altar stands against one wall, and an organ and an audio unit stand against the other.

On the altar is The Founder's Testament.

A gray cable connects the organ and the audio unit.

>x socket
Which do you mean, the tan socket or the ivory socket?

>tan
It is a female standard connector of the organ. It has the gray cable plugged into it.

>x ivory socket
It is a female standard connector of the audio unit. It has the gray cable plugged into it.

>x usb socket
You can't use multiple objects with that verb.

>x socket
Which do you mean, the tan socket or the ivory socket?

>x usb
You can't use multiple objects with that verb.

* * *

>goner sack
That's not a verb I recognize.

>gonear sack
There seems to be no such object anywhere in the model world.

>gonear bag
There seems to be no such object anywhere in the model world.

>gonear organ
Church
Before everyone left or died, you celebrated every sabbath here. The altar stands against one wall, and an organ and an audio unit stand against the other.

On the altar is The Founder's Testament.

A gray cable connects the organ and the audio unit.

* * *

>put cable in pocket
(first taking the gray cable)
You put the gray cable into the pocket.

>out
The gray cable disconnects from the organ.
The gray cable disconnects from the audio unit.

Sector 3: Forest
Trees, a house, and a church. A red pylon stretches up from the ground to the hub of the station. You can walk spinward or antispinward.

* * *

>help
Your goal is simply to leave the station and find other people. You can start by looking around and leaving your initial location.

If you are having trouble getting started, I suggest reading A Beginner's Guide to Interactive Fiction by Stephen Granade and Emily Short, available at:

  https://brasslantern.org/players/howto/beginnersguide.html

>help
Your goal is simply to leave the station and find other people. You can start by looking around and leaving your initial location. If you are having trouble getting started, I suggest reading A Beginner's Guide to Interactive Fiction by Stephen Granade and Emily Short, available at:

  https://brasslantern.org/players/howto/beginnersguide.html

Finally, if you're really stuck, you can write me at: tinsel@tinsel.org.

>about
About Founder's Mercy
Founder's Mercy is my second released Inform project, conceived and implemented in November of 2018. It should be impossible to put this game into an unwinnable state.

Thanks to Graham Nelson, Andrew Plotkin, Emily Short, and everyone else who contributed to the Inform and Glulx ecosystem. Thanks also to Eric Eve for the Exit Lister extension, Juhana Leinonen for the Object Response Tests extension, and Sean Turner for the Plugs and Sockets extension. The cover art is adapted from Figure 1.1 from NASA SP-413, Space Settlements: A Design Study, edited by Richard D. Johnson and Charles Holbrow, and available from The Internet Archive at https://archive.org/details/SpaceSettlementsADesignStudy1977 .

Please send your feedback, bug reports, and requests for help to tinsel@tinsel.org. You can always find the current version of this game at http://tinsel.org/IF/ .

This work is Copyright  2018 Thomas Insel but may be freely shared according to the terms of the Creative Commons Attribution 4.0 International license (https://creativecommons.org/licenses/by/4.0/).

* * *

>look
Home
The room where you've slept your entire life. You can go out towards the crops.

There is a secured hatch in the floor.

>gonear organ
Church
Before everyone left or died, you celebrated every sabbath here. The altar stands against one wall, and an organ stands against the other, beside an audio unit.

On the altar is The Founder's Testament.

A gray cable connects the organ and the audio unit.

>x grey
It's a USB 7.2 Type-F cable.

It is plugged into the organ and an audio unit.

* * *

>out
Sector 4: Crops
Your home is here among the crops. You can walk spinward or antispinward.

* * *

>sw
You walk a little ways to the next sector.

Sector 2: Aquaculture
A deep pond is used as part of the water filtration system and for raising fish. You can walk spinward or antispinward.

>sw
You walk a little ways to the next sector.

Sector 3: Forest
Trees, a house, and a church. A red pylon stretches up from the ground to the hub of the station. You can walk spinward or antispinward.

You have walked the entire ring. Everything is as expected, much is not working. Now, it's time to leave. The pods are below Sector 1.

* * *

>sw
You walk a little ways to the next sector.

Sector 4: Crops
Your home is here among the crops. You can walk spinward or antispinward.

>asw
You walk a little ways to the next sector.

Sector 3: Forest
Trees, a house, and a church. A red pylon stretches up from the ground to the hub of the station. You can walk spinward or antispinward.

* * *

>d
(first opening the floor hatch)
You scramble down through the hatch and close it behind yourself.

Pod Control
This room serves as an airlock for the pod bay, and holds an old space suit and various machinery such as the atmosphere pump. There is a brass plaque on the wall.

There is a secured hatch in the ceiling.

Beside the secured port hatch, a status display shows an error message.

>open hatch
Which do you mean, the ceiling hatch or the wall hatch?

>read message
Pod bay locked down
Diagnosis: telemetry sensor array offline
Remediation: reset breaker FM36-87/A @ hub platform

* * *

>scanner, close hatch
Command error: closing is a manual process.

The scanner is unable to do that.

* * *

>scanner, close me
Command error: closing is a manual process.

>scanner, close jkjkk
Search error: cannot find jkjkk.

[You can ask the scanner for a list of commands by typing "scanner, help" and give it voice commands by typing phrases such as "scanner, scan SOMETHING" or "scanner, open SOMETHING" where SOMETHING is a visible object.]

>scanner, close jkjkk
Search error: cannot find jkjkk.

>scanner, close gate
Search error: cannot find gate.

>scanner, close hatch
Command error: closing is a manual process.

>look
Home
The room where you've slept your entire life. You can go out towards the crops.

There is a secured hatch in the floor.

* * *

>scanner, help
Recognized commands are "help", "open", and "scan".

[You can ask the scanner for a list of commands by typing "scanner, help" and give it voice commands by typing phrases such as "scanner, scan SOMETHING" or "scanner, open SOMETHING" where SOMETHING is a visible object.]

>scanner, help me
Recognized commands are "help", "open", and "scan".

[You can ask the scanner for a list of commands by typing "scanner, help" and give it voice commands by typing phrases such as "scanner, scan SOMETHING" or "scanner, open SOMETHING" where SOMETHING is a visible object.]

>scanner, help
Recognized commands are "help", "open", and "scan".

[You can ask the scanner for a list of commands by typing "scanner, help" and give it voice commands by typing phrases such as "scanner, scan SOMETHING" or "scanner, open SOMETHING" where SOMETHING is a visible object.]

>scanner, helpdf
Syntax error: command not in vocabulary.

>scanner, help me figure this out
Recognized commands are "help", "open", and "scan".

[You can ask the scanner for a list of commands by typing "scanner, help" and give it voice commands by typing phrases such as "scanner, scan SOMETHING" or "scanner, open SOMETHING" where SOMETHING is a visible object.]

* * *

>scanner, request the credits
Syntax error: command not in vocabulary.

[You can ask the scanner for a list of commands by typing "scanner, help" and give it voice commands by typing phrases such as "scanner, scan SOMETHING" or "scanner, open SOMETHING" where SOMETHING is a visible object.]

>scanner, help
[That command asks to do something outside of play, so it can only make sense from you to me. The scanner cannot be asked to do this.]

* * *

>scanner, scan hatch
No modular technology detected.

>scanner, close hatch
Command error: closing is a manual process.

The scanner is unable to do that.

* * *

>scenes
Scene 'Entire Game' playing (for 0 mins now)
Scene 'Beginning' playing (for 0 mins now)
(Scene monitoring now switched on. Type "scenes off" to switch it off again.)

* * *

>get functional power module
(putting the faulty power module into your pocket to make room)
Taken.

>help
Your goal is simply to leave the station and find other people. You can start by looking around and leaving your initial location. If you are having trouble getting started, I suggest reading A Beginner's Guide to Interactive Fiction by Stephen Granade and Emily Short, available at:

  https://brasslantern.org/players/howto/beginnersguide.html

Finally, if you're really stuck, you can write me at: tinsel@tinsel.org.

So what if you can't escape in a pod. You will just need to bring a pod here. Time to get the communications module working.

>help
Your goal is simply to leave the station and find other people. You can start by looking around and leaving your initial location. If you are having trouble getting started, I suggest reading A Beginner's Guide to Interactive Fiction by Stephen Granade and Emily Short, available at:

  https://brasslantern.org/players/howto/beginnersguide.html

Finally, if you're really stuck, you can write me at: tinsel@tinsel.org.

>help
Your goal is simply to leave the station and find other people. You can start by looking around and leaving your initial location. If you are having trouble getting started, I suggest reading A Beginner's Guide to Interactive Fiction by Stephen Granade and Emily Short, available at:

  https://brasslantern.org/players/howto/beginnersguide.html

Finally, if you're really stuck, you can write me at: tinsel@tinsel.org.

* * *

>scenes
Scene 'Entire Game' playing (for 0 mins now)
Scene 'Beginning' playing (for 0 mins now)
(Scene monitoring now switched on. Type "scenes off" to switch it off again.)

>help
Your goal is simply to leave the station and find other people. You can start by looking around and leaving your initial location.

By the way, it should be impossible to put this game into an unwinnable state, so feel free to explore and experiment.

If you are having trouble getting started, I suggest reading A Beginner's Guide to Interactive Fiction by Stephen Granade and Emily Short, available at:

  https://brasslantern.org/players/howto/beginnersguide.html

>get mask
You can't see any such thing.

>d
(first opening the floor hatch)
You scramble down through the hatch and close it behind yourself.

Cellar
A decompression shelter and space for storage.

There is a secured hatch in the ceiling.

There is an emergency mask hanging on the wall.

* * *

>in
School
One broken learning machine remains in a corner, but mostly the older farmers took turns leading the class. There is a desk and a chalkboard hangs on one wall.

On the desk is a clean eraser.

>hint
Your goal is simply to leave the station and find other people. You can start by looking around and leaving your initial location.

By the way, it should be impossible to put this game into an unwinnable state, so feel free to explore and experiment.

If you are having trouble getting started, I suggest reading A Beginner's Guide to Interactive Fiction by Stephen Granade and Emily Short, available at:

  https://brasslantern.org/players/howto/beginnersguide.html

>get eraser
Taken.

* * *

>sw
You walk a little ways to the next sector.

Sector 3: Forest
Trees, a house, and a church. A red pylon stretches up from the ground to the hub of the station. You can walk spinward or antispinward.

[Scene 'Ready to Repair' begins]
You have walked the entire ring. Everything is as expected, much is not working. Now, it's time to leave. The pods are below Sector 1.

[Scene 'Beginning' ends]

>help
It's time to leave the station, but you need to explore a little more.

>asw
You walk a little ways to the next sector.

Sector 2: Aquaculture
A deep pond is used as part of the water filtration system and for raising fish. You can walk spinward or antispinward.

* * *

>d
(first opening the floor hatch)
You scramble down through the hatch and close it behind yourself.

Pod Control
This room serves as an airlock for the pod bay, and holds an old space suit and various machinery such as the atmosphere pump. There is a brass plaque on the wall.

There is a secured hatch in the ceiling.

Beside the secured port hatch, a status display shows an error message.

>help
You need to fix something. Check out the status display in Pod Control.

* * *

>x display
Pod bay locked down
Diagnosis: telemetry sensor array offline
Remediation: reset breaker FM36-87/A @ hub platform

>help
According to the status display, you need to check out a circuit breaker on the hub platform.

>u
(first opening the ceiling hatch)
You pull yourself up through the hatch and close it behind yourself.

Sector 1: Crops
You still maintain the crops here. There is a small graveyard and the barn remains from when this was the livestock sector. A pylon stretches up from the ground to the hub of the station. You can walk spinward or antispinward.

There is a secured hatch in the ground.

>u
The pylon is slick metal with no obvious handholds.

>sw
You walk a little ways to the next sector.

Sector 2: Aquaculture
A deep pond is used as part of the water filtration system and for raising fish. You can walk spinward or antispinward.

* * *

>x boots
Black work boots with red stripes. They don't really make gravity, but they do stick to some maintenance walkways to help workers get around in low gravity or on the outside of a rotating station.

>get boots
(putting the dusty eraser into your pocket to make room)
Taken.

>search crate
You find a pressure regulator module.
(putting the power module into your pocket to make room)

>g
You find an instruction module.
(putting the instruction module into your pocket to make room)

>hit eraser
(first taking the dusty eraser)
(putting the pair of gravity boots into your pocket to make room)
You fill the vault with a cloud of dust and you can now see a laser beam scanning across the hatch.

>u
You maneuver around the laser beam.

(first opening the ceiling hatch)
You pull yourself up through the hatch and close it behind yourself.

Sector 6: Hydroponics
Your people preferred to grow things the old fashioned way, but in truth the majority of your fruit and vegetables came from this sector when the machines still worked. You can walk spinward or antispinward.

There is a secured hatch in the ground.

[Your score has just gone up by five points.]

>look
Sector 6: Hydroponics
Your people preferred to grow things the old fashioned way, but in truth the majority of your fruit and vegetables came from this sector when the machines still worked. You can walk spinward or antispinward.

There is a secured hatch in the ground.

* * *

>sw
You walk a little ways to the next sector.

Sector 3: Forest
Trees, a house, and a church. A red pylon stretches up from the ground to the hub of the station. You can walk spinward or antispinward.

>wear boots
(first taking the pair of gravity boots)
(putting the pressure regulator module into your pocket to make room)
You put on the pair of gravity boots.

>u
It isn't easy, but with the boots, you are able to climb towards the hub.

Center Platform
It's a mesh platform a little below the hub. You feel much lighter here, and you are very aware of how the station rotates, but everything is okay as long as you don't look down.

You can just reach a red circuit breaker on the hub.

>turn breaker
It is fixed in place.

>turn breaker on
You switch the red circuit breaker on.

[Your score has just gone up by five points.]

* * *

>d
You climb down the pylon.

Sector 3: Forest
Trees, a house, and a church. A red pylon stretches up from the ground to the hub of the station. You can walk spinward or antispinward.

>hint
According to the status display, you need to check out a circuit breaker somewhere in Sector 2.

>sw
You walk a little ways to the next sector.

Sector 4: Crops
Your home is here among the crops. You can walk spinward or antispinward.

>i
You are carrying:
  some pair of gravity boots (being worn)
  a dusty eraser
  an instruction module
  a green jumpsuit (being worn)

Your jumpsuit pocket contains:
  a pressure regulator module
  an instruction module
  a power module
  an emergency mask
  a scanner

>asw
You walk a little ways to the next sector.

Sector 3: Forest
Trees, a house, and a church. A red pylon stretches up from the ground to the hub of the station. You can walk spinward or antispinward.

* * *

>asw
You walk a little ways to the next sector.

Sector 2: Aquaculture
A deep pond is used as part of the water filtration system and for raising fish. You can walk spinward or antispinward.

>wear mask
(first taking the emergency mask)
You put on the emergency mask.

>go water
WIth the air from the emergency mask, you breathe comfortably as you step into the pond. At the bottom, you find a green circuit breaker and flip it on.

[Your score has just gone up by ten points.]

>score
You have so far scored 25 out of a possible 50, in 55 turns.

>hint
According to the status display, you need to fix the atmosphere pump. Now might be a good time to check out the scanner.

>score
You have so far scored 25 out of a possible 50, in 56 turns.

>hint
According to the status display, you need to fix the atmosphere pump. Now might be a good time to check out the scanner.

>i
You are carrying:
  an emergency mask (being worn)
  some pair of gravity boots (being worn)
  a dusty eraser
  an instruction module
  a green jumpsuit (being worn)

Your jumpsuit pocket contains:
  a pressure regulator module
  an instruction module
  a power module
  a scanner

>scan power module
Component is functional.

>look
Sector 2: Aquaculture
A deep pond is used as part of the water filtration system and for raising fish. You can walk spinward or antispinward.

>out
But you aren't in anything at the moment.

>asw
You walk a little ways to the next sector.

Sector 1: Crops
You still maintain the crops here. There is a small graveyard and the barn remains from when this was the livestock sector. A pylon stretches up from the ground to the hub of the station. You can walk spinward or antispinward.

There is a secured hatch in the ground.

* * *

>d
(first opening the floor hatch)
You scramble down through the hatch and close it behind yourself.

Pod Control
This room serves as an airlock for the pod bay, and holds an old space suit and various machinery such as the atmosphere pump. There is a brass plaque on the wall.

There is a secured hatch in the ceiling.

Beside the secured port hatch, a status display shows an error message.

>x plaque
The plaque reads:

    RWSS Founder's Mercy
    Laid down 2533, Launched 2537.
    "May His mercy shine upon us."

>x pump
The atmosphere pump is a smooth featureless machine.

* * *

>scanner, open pump
Opening.

The atmosphere pump swings open.

>get power from pump
Taken.

>put functional power into pump
(first taking the functional power module)
(putting the unscanned instruction module into your pocket to make room)
You put the functional power module into the atmosphere pump.

>help
According to the status display, you need to fix the atmosphere pump. Now might be a good time to check out the scanner.

>close pump
You close the atmosphere pump and it seals without any trace of a seam.

>scan pump
Machine is failed.

>open pump
You will need to use the scanner to do that.

>scanner, open pump
Opening.

The atmosphere pump swings open.

>i
You are carrying:
  an unscanned power module
  an emergency mask (being worn)
  some pair of gravity boots (being worn)
  a dusty eraser
  a green jumpsuit (being worn)

Your jumpsuit pocket contains:
  two unscanned instruction modules
  an unscanned pressure regulator module
  a scanner

>x pump
The atmosphere pump is a smooth featureless machine.

In the atmosphere pump are a power module and a pressure regulator module.

>get pressure from pump
Taken.

>scan pressure
Component is faulty.

>scan unscanned pressure
Component is functional.

>put functional pressure into pump
(first taking the functional pressure regulator module)
(putting the dusty eraser into your pocket to make room)
You put the functional pressure regulator module into the atmosphere pump.

>hint
You're almost there. The status display is fairly clear about what you need to do now.

* * *

>x display
Pod bay locked down
Diagnosis: pod control atmosphere pump offline
Remediation: close pump

>close pump
You close the atmosphere pump and it begins to hum.

[Scene 'Anxious to Leave' begins]
It is time to say goodbye to the station. You are ready to leave in a pod.

[Scene 'Ready to Repair' ends]
[Your score has just gone up by five points.]

>look
Pod Control
This room serves as an airlock for the pod bay, and holds an old space suit and various machinery such as the atmosphere pump. There is a brass plaque on the wall.

There is a secured hatch in the ceiling.

Beside the secured port hatch, a status display glows green.

>scenes
Scene 'Entire Game' playing (for 82 mins now)
Scene 'Beginning' ended
Scene 'Ready to Repair' ended
Scene 'Anxious to Leave' playing (for 2 mins now)
(Scene monitoring now switched on. Type "scenes off" to switch it off again.)

>help
There's no point in waiting. You just need to enter the pod bay now.

>e
You have heard of compass directions like east, but they don't make any sense here. Instead, you can go spinward, antispinward, port, and starboard. When you look spinward, port is left and starboard is right.

[You can use the abbreviations "sw", "asw", "p", and "s". You can also go "up", "down", "in", and "out" where appropriate. Type "exits" if you get confused about geography.]

>port
(first opening the wall hatch)
You close the hatch behind yourself.

Pod Bay
There are four berths for transit pods. Unexpectedly, all are empty.

A secured hatch leads starboard.

Someone left a communications unit on the floor.

[Scene 'Pod Problems' begins]
This is troubling. You counted. You were sure there would be one pod left. There are none.

[Scene 'Anxious to Leave' ends]
[Your score has just gone up by ten points.]

>hint
Take a look at the communications unit.

>undo
Pod Bay
[Previous turn undone.]

>undo
Pod Control
[Previous turn undone.]

>z
Time passes.

>scenes
Scene 'Entire Game' playing (for 85 mins now)
Scene 'Beginning' ended
Scene 'Ready to Repair' ended
Scene 'Anxious to Leave' playing (for 5 mins now)
(Scene monitoring now switched on. Type "scenes off" to switch it off again.)

>z
Time passes.

>z
Time passes.

There is nothing left for you here. It's time to take a pod and leave.

>z
Time passes.

>score
You have so far scored 30 out of a possible 50, in 94 turns.

>hint
There's no point in waiting. You just need to enter the pod bay now.

>in
You can't go that way.

>look
Pod Control
This room serves as an airlock for the pod bay, and holds an old space suit and various machinery such as the atmosphere pump. There is a brass plaque on the wall.

There is a secured hatch in the ceiling.

Beside the secured port hatch, a status display glows green.

>port
(first opening the wall hatch)
You close the hatch behind yourself.

Pod Bay
There are four berths for transit pods. Sadly, all are empty.

A secured hatch leads starboard.

Someone left a communications unit on the floor.

[Scene 'Pod Problems' begins]
This is troubling. You counted. You were sure there would be one pod left. There are none.

[Scene 'Anxious to Leave' ends]
[Your score has just gone up by ten points.]

>showme unit
(the communications unit)
communications unit - machine
    cream socket (part of communications unit) - usb socket
location: in Pod Bay
singular-named, improper-named; unlit, inedible, portable; opaque, closed, unopenable, unlocked; list grouping key: none
printed name: "communications unit"
printed plural name: "machines"
indefinite article: "the"
description: "A portable communications unit with a single socket to connect it to an audio unit."
initial appearance: "Someone left a communications unit on the floor."
carrying capacity: 100

>get units
You can't see any such thing.

>showme unit
(the communications unit)
communications unit - machine
    cream socket (part of communications unit) - usb socket
location: in Pod Bay
singular-named, improper-named; unlit, inedible, portable; opaque, closed, unopenable, unlocked; list grouping key: none
printed name: "communications unit"
printed plural name: "machines"
indefinite article: "the"
description: "A portable communications unit with a single socket to connect it to an audio unit."
initial appearance: "Someone left a communications unit on the floor."
carrying capacity: 100

>get unit
Taken.

>showme unit
(the communications unit)
communications unit - machine
    cream socket (part of communications unit) - usb socket
location: carried by yourself in Pod Bay
singular-named, improper-named; unlit, inedible, portable, handled; opaque, closed, unopenable, unlocked; list grouping key: none
printed name: "communications unit"
printed plural name: "machines"
indefinite article: "the"
description: "A portable communications unit with a single socket to connect it to an audio unit."
initial appearance: "Someone left a communications unit on the floor."
carrying capacity: 100

>hint
You will need to attach the communications unit to an audio unit.

>look
Pod Bay
There are four berths for transit pods. Unexpectedly, all are empty.

A secured hatch leads starboard.

No pods left ... you consider despair.

>s
(first opening the wall hatch)
You close the hatch behind yourself.

Pod Control
This room serves as an airlock for the pod bay, and holds an old space suit and various machinery such as the atmosphere pump. There is a brass plaque on the wall.

Beside the secured port hatch, a status display glows green.

There is a secured hatch in the ceiling.

>hint
You will need to attach the communications unit to an audio unit.

So what if you can't escape in a pod. You will just need to bring a pod here. Time to get the communications module working.

>u
(first opening the ceiling hatch)
You pull yourself up through the hatch and close it behind yourself.

Sector 1: Crops
You still maintain the crops here. There is a small graveyard and the barn remains from when this was the livestock sector. A pylon stretches up from the ground to the hub of the station. You can walk spinward or antispinward.

There is a secured hatch in the ground.

* * *

>asw
You walk a little ways to the next sector.

Sector 3: Forest
Trees, a house, and a church. A red pylon stretches up from the ground to the hub of the station. You can walk spinward or antispinward.

>go church
Church
Before everyone left or died, you celebrated every sabbath here. The altar stands against one wall, and an organ and an audio unit stand against the other.

On the altar is The Founder's Testament.

A gray cable connects the organ and the audio unit.

>hint
You will need to attach the communications unit to an audio unit.

>remove cable from organ
You unplug the gray cable from the organ.

>attach cable to comms
You plug the gray cable into the communications unit.

>hint
Repair the audio unit.

>scanner, open audio
Opening.

The audio unit swings open.

>x audio
The audio unit incorporates a speaker, a microphone, and a socket you would use to connect it to another device.

In the audio unit is a power module.

The audio unit has a gray cable plugged into it.

>look in audio
In the audio unit is an unscanned power module.

>scan power module
Component is faulty.

>x audio
The audio unit incorporates a speaker, a microphone, and a socket you would use to connect it to another device.

In the audio unit is a power module.

The audio unit has a gray cable plugged into it.

* * *

>look in audio
In the audio unit is an unscanned power module.

>get power module from audio
(putting the faulty power module into your pocket to make room)
Taken.

>look at audio
The audio unit incorporates a speaker, a microphone, and a socket you would use to connect it to another device.

There is space for one more module.

The audio unit has a gray cable plugged into it.

>put faulty power in audio
(first taking the faulty power module)
(putting the faulty pressure regulator module into your pocket to make room)
You put the faulty power module into the audio unit.

>x audio
The audio unit incorporates a speaker, a microphone, and a socket you would use to connect it to another device.

In the audio unit is a power module.

The audio unit has a gray cable plugged into it.

>help
Repair the audio unit.

>x power module in audio unit
You can't see any such thing.

>x audio unit
The audio unit incorporates a speaker, a microphone, and a socket you would use to connect it to another device.

In the audio unit is a power module.

The audio unit has a gray cable plugged into it.

>scan audio unit
Machine failed.

>get module from unit
(the audio unit)
Taken.

>put functional power module in unit
You can't see any such thing.

>purloin functional power module
[Purloined.]

>put functional power module in unit
(the communications unit)
The communications unit is closed.

>put functional power module in audio unit
You put the functional power module into the audio unit.

>scanner, x audio unit
Machine functional. Input and output connected.

>hint
Close the audio unit.

>close audio unit
You close the audio unit and it seals without any trace of a seam.

The audio unit beeps and a synthesized voice says "Comms ready."

You call for help. I need to write this bit.

    *** You win. ***

In that game you scored 50 out of a possible 50, in 131 turns.

Would you like to RESTART, RESTORE a saved game, QUIT, or UNDO the last command?

* * *

>show me
What do you want to show yourself?

>gonear organ
Church
Before everyone left or died, you celebrated every sabbath here. The altar stands against one wall, and an organ and an audio unit stand against the other.

On the altar is The Founder's Testament.

A gray cable connects the organ and the audio unit.

>x cable
A one meter USB 7.2 cable with a Type-F plug at each end.

It is plugged into the organ and an audio unit.

>take cable
Taken.

>out
It is impractical to leave with the gray cable attached to the organ.

>put cable in pocket
You put the gray cable into the pocket.

>i
You are carrying:
  a scanner
  a green jumpsuit (being worn)

Your jumpsuit pocket contains:
  a gray cable (plugged into the organ and an audio unit)