You awake. You are lonely, so lonely. It was a thousand days ago today. All alone these thousand days. Your parents were the last. No, your father was the last. He held on for nearly a hundred days longer than your mother. No, you are the last. Alone. Adrift.

But maybe it isn't hopeless. There must still be some people in other worlds, and you think you know how to get there.

Today is the day.

Green
A Space Story by Thomas Insel
Release 1 / Serial number 181122 / Inform 7 build 6M62 (I6/v6.33 lib 6/12N) SD
Type "about" for credits and more information.

Home
The room where you've slept your entire life. You can go out towards the crops.

There is a secured hatch in the floor.

>about
About Green
Green is my second released Inform project, conceived and implemented in November of 2018. It should be impossible to put this game into an unwinnable state.

The cover art is adapted from Figure 1.1 from NASA SP-413, Space Settlements: A Design Study, edited by Richard D. Johnson and Charles Holbrow, and available from The Internet Archive at https://archive.org/details/SpaceSettlementsADesignStudy1977 .

Please send your feedback, bug reports, and requests for help to tinsel@tinsel.org. You can always find the current version of this game at http://tinsel.org/IF/ .

This work is Copyright  2018 Thomas Insel but may be freely shared according to the terms of the Creative Commons Attribution 4.0 International license (https://creativecommons.org/licenses/by/4.0/).

* * *

>asw
You can't go that way.

>out
Sector 4: Crops
Your home is here among the crops.

>sw
You walk a little ways to the next sector.

Sector 5: Forest
A pylon stretches up from among a group of trees to the hub of the station.

The school house is nestled among the trees.

>asw
You walk a little ways to the next sector.

Sector 4: Crops
Your home is here among the crops.

>asw
You walk a little ways to the next sector.

Sector 3: Forest
Trees, a house, and a church. A red pylon stretches up from the ground to the hub of the station.

>u
The red pylon is designated for climbing, but you still can't get a grip.

>asw
You walk a little ways to the next sector.

Sector 2: Aquaculture
A deep pond serves as part of the water filtration system and for raising fish.

>asw
You walk a little ways to the next sector.

Sector 1: Crops
This sector is fallow for a cycle. A pylon stretches up from the ground to the hub of the station.

There is a secured hatch in the ground.

>u
The pylon is slick metal with no obvious handholds.

>gonear red breaker
Center Platform
It's a mesh platform a little below the hub. From here, you are very aware of how the station rotates, but everything is okay as long as you don't look down.

You can see a red circuit breaker here.

>get breaker
That's fixed in place.

>drop breaker
The red circuit breaker is already here.

>look
Center Platform
It's a mesh platform a little below the hub. From here, you are very aware of how the station rotates, but everything is okay as long as you don't look down.

You can see a red circuit breaker here.

* * *

>asw
You can't go that way.

>sw
You can't go that way.

>asw
You can't go that way.

>out
Sector 4: Crops
You are in sector 4.

Your home is here among the crops.

>d
You can't go that way.

>in
Home
The room where you've slept your entire life. The only exit is out from here.

There is a secured hatch in the floor.

You can also see your bed here.

>d
(first opening the floor hatch)
You pull yourself up through the hatch and close it behind yourself.

Below Home
This space is used for storage and as a decompression shelter.

There is a secured hatch in the ceiling.

There is an emergency helmet hanging on the wall.

>look
Below Home
This space is used for storage and as a decompression shelter.

There is a secured hatch in the ceiling.

There is an emergency helmet hanging on the wall.

>exits
The only obvious exit is up (to home).

Type "exits on" to enable the status line exit lister and "exits off" to turn it off.

* * *

>d
(first opening the floor hatch)
You scramble down through the hatch and close it behind yourself.

Cellar
This space is used for storage and as a decompression shelter.

There is a secured hatch in the ceiling.

There is an emergency mask hanging on the wall.

>get helmet
Taken.

>i
You are carrying:
  an emergency helmet
  a green jumpsuit (being worn)

>u
(first opening floor hatch)
You scramble down through the hatch and close it behind yourself.

Home
The room where you've slept your entire life. The only exit is out from here.

There is a secured hatch in the floor.

You can also see your bed here.

>out
Sector 4: Crops
You are in sector 4.

Your home is here. You were told it was built to look like a log cabin on Old Earth.

>out
But you aren't in anything at the moment.

>wear helmet
You put on the emergency helmet.

>i
You are carrying:
  an emergency helmet (being worn)
  a green jumpsuit (being worn)

>x helmet
You used to wear a helmet like this when there were decompression drills every twenty days.

>x jumpsuit
(the green jumpsuit)
You have worn jumpsuits like this since you were small. Originally, the colors had meanings: green for farmers, blue for technicians, and so on, but that distinction died even before the population.

It features a single large pocket, currently empty.

* * *

>get helmet
Taken.

>wear it
You put on the emergency helmet.

* * *

>d
(first opening the floor hatch)
You scramble down through the hatch and close it behind yourself.

Cellar
This space is used for storage and as a decompression shelter.

There is a secured hatch in the ceiling.

There is an emergency mask hanging on the wall.

>scanner, help
Recognized commands are "help", "open", and "scan".

[You can ask the scanner for a list of commands by typing "scanner, help" and give it commands by typing things like "scanner, scan SOMETHING" where SOMETHING is a visible object. As a special abbreviation, you can type "scan SOMETHING".]

>x scanner
The handheld voice-activated scanner that you use to scan electronic modules on the station.

>g
The handheld voice-activated scanner that you use to scan electronic modules on the station.

>g
The handheld voice-activated scanner that you use to scan electronic modules on the station.

>g
The handheld voice-activated scanner that you use to scan electronic modules on the station.

[You can ask the scanner for a list of commands by typing "scanner, help" and give it commands by typing things like "scanner, scan SOMETHING" where SOMETHING is a visible object. As a special abbreviation, you can type "scan SOMETHING".]

>g
The handheld voice-activated scanner that you use to scan electronic modules on the station.

>look
Cellar
This space is used for storage and as a decompression shelter.

There is a secured hatch in the ceiling.

There is an emergency mask hanging on the wall.

>x mask
You wore a mask like this when there were decompression drills every ten days.

>scanner, scan mask
Mask is functional.

>look
Cellar
This space is used for storage and as a decompression shelter.

There is a secured hatch in the ceiling.

There is an emergency mask hanging on the wall.

* * *

>d
(first opening the floor hatch)
You scramble down through the hatch and close it behind yourself.

Cellar
This space is used for storage and as a decompression shelter.

There is a secured hatch in the ceiling.

There is an emergency mask hanging on the wall.

>scanner, scan mask
Mask is functional.

* * *

>look
Cellar
This space is used for storage and as a decompression shelter.

There is a secured hatch in the ceiling.

There is an emergency mask hanging on the wall.

>x scanner
The handheld voice-activated scanner that you use to scan electronic modules on the station.

[You can ask the scanner for a list of commands by typing "scanner, help" and give it commands by typing things like "scanner, scan SOMETHING" where SOMETHING is a visible object. As a special abbreviation, you can type "scan SOMETHING".]

>scanner, help
[That command asks to do something outside of play, so it can only make sense from you to me. The scanner cannot be asked to do this.]

>scanner, help
[That command asks to do something outside of play, so it can only make sense from you to me. The scanner cannot be asked to do this.]

>scanner, go
You'll have to say which direction to go in.

* * *

>d
(first opening the floor hatch)
You scramble down through the hatch and close it behind yourself.

Cellar
This space is used for storage and as a decompression shelter.

There is a secured hatch in the ceiling.

There is an emergency mask hanging on the wall.

>u
(first opening the ceiling hatch)
You pull yourself up through the hatch and close it behind yourself.

Home
The room where you've slept your entire life. The only exit is out from here.

There is a secured hatch in the floor.

>d
(first opening the floor hatch)
You scramble down through the hatch and close it behind yourself.

Cellar
This space is used for storage and as a decompression shelter.

There is a secured hatch in the ceiling.

There is an emergency mask hanging on the wall.

* * *

>u
(first opening the ceiling hatch)
You pull yourself up through the hatch and close it behind yourself.

Home
The room where you've slept your entire life. The only exit is out from here.

There is a secured hatch in the floor.

>u
You can't go that way.

>out
Sector 4: Crops
Your home is here among the crops.

* * *

>sw
You walk a little ways to the next sector.

Sector 5: Forest
A pylon stretches up from among a group of trees to the hub of the station.

The school house is nestled among the trees.

>sw
You walk a little ways to the next sector.

Sector 6: Hydroponics
Your people prefered to grow things the old fashioned way, but in truth the majority of your fruit and vegetables came from this sector when the machines still worked.

There is a secured hatch in the floor.

>sw
You walk a little ways to the next sector.

Sector 7: Livestock
There are pens left from when this was the livestock sector, but nothing is left now. A pylon stretches up from the ground to the hub of the station.

>sw
You walk a little ways to the next sector.

Sector 8: Crops
You still maintain the crops here.

>sw
You walk a little ways to the next sector.

Sector 1: Crops
This sector is fallow this cycle. A pylon stretches up from the ground to the hub of the station.

There is a secured hatch in the floor.

>sw
You walk a little ways to the next sector.

Sector 2: Aquaculture
There is a large, deep pond that serves as part of the water filtration system and is used for raising fish.

>sw
You walk a little ways to the next sector.

Sector 3: Forest
Trees, a house, and a church. A red pylon stretches up from the ground to the hub of the station.

>sw
You walk a little ways to the next sector.

Sector 4: Crops
Your home is here among the crops.

>sw
You walk a little ways to the next sector.

Sector 5: Forest
A pylon stretches up from among a group of trees to the hub of the station.

The school house is nestled among the trees.

* * *

>u
(first opening the ceiling hatch)
You pull yourself up through the hatch and close it behind yourself.

Home
The room where you've slept your entire life. The only exit is out from here.

There is a secured hatch in the floor.

>out
Sector 4: Crops
Your home is here among the crops.

>asw
You walk a little ways to the next sector.

Sector 3: Forest
Trees, a house, and a church. A red pylon stretches up from the ground to the hub of the station.

>x church
It's a church.

* * *

>out
Sector 4: Crops
Your home is here among the crops.

>sw
You walk a little ways to the next sector.

Sector 5: Forest
A group of trees. A pylon stretches up from the ground to the jub of the station.

The school house is nestled among the trees.

>sw
You walk a little ways to the next sector.

Sector 6: Hydroponics
Your people prefered to grow things the old fashioned way, but in truth the majority of your fruit and vegetables came from this sector when the machines still worked.

You can go down.

There is a secured hatch in the floor.

>sw
You walk a little ways to the next sector.

Sector 7: Livestock
There are pens left from when this was the livestock sector, but nothing is left now. A pylon stretches up from the ground to the hub of the station.

* * *

>sw
You walk a little ways to the next sector.

Sector 8: Crops
You still maintain the crops here.

>sw
You walk a little ways to the next sector.

Sector 1: Crops
You maintain the crops in this sector. A pylon stretches up from the ground to the hub of the station.

There is a secured hatch in the floor.

>sw
You walk a little ways to the next sector.

Sector 2: Aquaculture
There is a large, deep pond that serves as part of the water filtration system and is used for raising fish.

>sw
You walk a little ways to the next sector.

Sector 3: Forest
Trees, two homes, and a church. A red pylon stretches up from the ground to the hub of the station.

>sw
You walk a little ways to the next sector.

Sector 4: Crops
You are in sector 4.

Your home is here among the crops. You were told it was built to look like a log cabin on Old Earth.

>sw
You walk a little ways to the next sector.

Sector 5: Forest
A group of trees. A pylon stretches up from the ground to the jub of the station.

The school house is nestled among the trees.

* * *

>u
(first opening the ceiling hatch)
You pull yourself up through the hatch and close it behind yourself.

Home
The room where you've slept your entire life. The only exit is out from here.

There is a secured hatch in the floor.

>sit on bed
You get onto your bed.

>look
Home (on your bed)
The room where you've slept your entire life. The only exit is out from here.

There is a secured hatch in the floor.

>out
You get off your bed.

Home
The room where you've slept your entire life. The only exit is out from here.

There is a secured hatch in the floor.

You can also see your bed here.

>d
(first opening the floor hatch)
You pull yourself up through the hatch and close it behind yourself.

Below Home
Used for storage and as a decompression shelter.

There is a secured hatch in the ceiling.

There is an emergency helmet hanging on the wall.

>d
You can't go that way.

>u
(first opening the ceiling hatch)
You scramble down through the hatch and close it behind yourself.

Home
The room where you've slept your entire life. The only exit is out from here.

There is a secured hatch in the floor.

You can also see your bed here.

>look
Home
The room where you've slept your entire life. The only exit is out from here.

There is a secured hatch in the floor.

You can also see your bed here.

>n
You have heard of compass directions like north, but they don't make any sense here. Instead, you can go spinward, antispinward, port, and starboard.

When you look spinward, port is left and starboard is right. You can also use up, down, in, and out, and you can use abbreviations "sw", "asw", "p", and "s". Also, you can type "exits" if you get confused about geography.

>asw
You can't go that way.

* * *

>sw
You can't go that way.

>out
Sector 4: Crops
You are in sector 4.

Your home is here among the crops.

>asw
You walk a little ways to the next sector.

Sector 3: Forest
Trees, two homes, and a church. A red pylon stretches up from the ground to the hub of the station.

>asw
You walk a little ways to the next sector.

Sector 2: Aquaculture
There is a large, deep pond that serves as part of the water filtration system and is used for raising fish.

>asw
You walk a little ways to the next sector.

Sector 1: Crops
You maintain the crops in this sector. A pylon stretches up from the ground to the hub of the station.

There is a secured hatch in the floor.

>restart
Are you sure you want to restart?

>yes
You awake. You are lonely, so lonely. It was a thousand days ago today. All alone these thousand days. Your parents were the last. No, your father was the last. He held on for nearly a hundred days longer than your mother. No, you are the last. Alone. Adrift.

But maybe it isn't hopeless. There must still be some people in other worlds, and you think you know how to get there.

Today is the day.

Green
An Interactive Space Story by Thomas Insel
Release 1 / Serial number 181119 / Inform 7 build 6M62 (I6/v6.33 lib 6/12N) SD
Type "about" for credits and more information.

Home (on your bed)
The room where you've slept your entire life. The only exit is out from here.

There is a secured hatch in the floor.

>d
(first getting off your bed)
(first opening the floor hatch)
You pull yourself up through the hatch and close it behind yourself.

Below Home
Used for storage and as a decompression shelter.

There is a secured hatch in the ceiling.

There is an emergency helmet hanging on the wall.

* * *

>damn
That's not a verb I recognize.

>darn
That's not a verb I recognize.

>oops
Sorry, that can't be corrected.

* * *

>dig
That's not a verb I recognize.

>look
Home
The room where you've slept your entire life. You can go out towards the crops.

There is a secured hatch in the floor.

>out
Sector 4: Crops
Your home is here among the crops.

* * *

>sw
You walk a little ways to the next sector.

Sector 5: Forest
A pylon stretches up from among a group of trees to the hub of the station.

The school house is nestled among the trees.

>x house
It's little and red, the traditional marking of a school building.

* * *

>e
You have heard of compass directions like east, but they don't make any sense here. Instead, you can go spinward, antispinward, port, and starboard. When you look spinward, port is left and starboard is right.

[You can use the abbreviations "sw", "asw", "p", and "s". You can also go "up", "down", "in", and "out" where appropriate. Type "exits" if you get confused about geography.
]

* * *

>look
Home (on your bed)
The room where you've slept your entire life. The only exit is out from here.

There is a secured hatch in the floor.

>exit symbol
Done.

>look
Home (on your bed)
The room where you've slept your entire life. The only exit is out from here.

There is a secured hatch in the floor.

>exits
The obvious exits are down and outside.

Type "exits off" to disable the status line exit list and "exits on" to turn it back on.

>d
(first getting off your bed)
(first opening the floor hatch)
You scramble down through the hatch and close it behind yourself.

Below Home
This space is used for storage and as a decompression shelter.

There is a secured hatch in the ceiling.

There is an emergency mask hanging on the wall.

>u
(first opening the ceiling hatch)
You pull yourself up through the hatch and close it behind yourself.

Home
The room where you've slept your entire life. The only exit is out from here.

There is a secured hatch in the floor.

You can also see your bed here.

>d
(first opening the floor hatch)
You scramble down through the hatch and close it behind yourself.

Below Home
This space is used for storage and as a decompression shelter.

There is a secured hatch in the ceiling.

There is an emergency mask hanging on the wall.

>u
(first opening the ceiling hatch)
You pull yourself up through the hatch and close it behind yourself.

Home
The room where you've slept your entire life. The only exit is out from here.

There is a secured hatch in the floor.

You can also see your bed here.

>out
Sector 4: Crops
You are in sector 4.

Your home is here among the crops.

>restart
Are you sure you want to restart?

* * *

>exit symbol
Done.

>d
(first getting off your bed)
(first opening the floor hatch)
You scramble down through the hatch and close it behind yourself.

Below Home
This space is used for storage and as a decompression shelter.

There is a secured hatch in the ceiling.

There is an emergency mask hanging on the wall.

* * *

>out
Sector 4: Crops
You are in sector 4.

Your home is here among the crops.

>exit symbol
Done.

>exits
The obvious exits are inside (to home), spinward and antispinward.

Type "exits off" to disable the status line exit list and "exits on" to turn it back on.

>out
But you aren't in anything at the moment.

>exits
The obvious exits are inside (to home), spinward and antispinward.

* * *

>exits
The obvious exits are down and outside.

[Type "exits off" to disable the status line exit list and "exits on" to turn it back on.
]

>d
(first opening the floor hatch)
You scramble down through the hatch and close it behind yourself.

Cellar
This space is used for storage and as a decompression shelter.

There is a secured hatch in the ceiling.

There is an emergency mask hanging on the wall.

>exit
But you aren't in anything at the moment.

>exits
The only obvious exit is up (to home).

>up
(first opening the ceiling hatch)
You pull yourself up through the hatch and close it behind yourself.

Home
The room where you've slept your entire life. The only exit is out from here.

There is a secured hatch in the floor.

>out
Sector 4: Crops
Your home is here among the crops.

>exits
The obvious exits are inside (to home), spinward and antispinward.

>sw
You walk a little ways to the next sector.

Sector 5: Forest
A pylon stretches up from among a group of trees to the hub of the station.

The school house is nestled among the trees.

>sw
You walk a little ways to the next sector.

Sector 6: Hydroponics
Your people prefered to grow things the old fashioned way, but in truth the majority of your fruit and vegetables came from this sector when the machines still worked.

There is a secured hatch in the ground.

>sw
You walk a little ways to the next sector.

Sector 7: Livestock
There are pens left from when this was the livestock sector, but nothing is left now. A pylon stretches up from the ground to the hub of the station.

>asw
You walk a little ways to the next sector.

Sector 6: Hydroponics
Your people prefered to grow things the old fashioned way, but in truth the majority of your fruit and vegetables came from this sector when the machines still worked.

There is a secured hatch in the ground.

>exits
The obvious exits are down, spinward (to sector 7) and antispinward (to sector 5).

>sw
You walk a little ways to the next sector.

Sector 7: Livestock
There are pens left from when this was the livestock sector, but nothing is left now. A pylon stretches up from the ground to the hub of the station.

* * *

>sw
You walk a little ways to the next sector.

Sector 8: Crops
You still maintain the crops here.

>sw
You walk a little ways to the next sector.

Sector 1: Crops
This sector is fallow this cycle. A pylon stretches up from the ground to the hub of the station.

There is a secured hatch in the ground.

>sw
You walk a little ways to the next sector.

Sector 2: Aquaculture
There is a large, deep pond that serves as part of the water filtration system and is used for raising fish.

* * *

>sw
You walk a little ways to the next sector.

Sector 3: Forest
Trees, a house, and a church. A red pylon stretches up from the ground to the hub of the station.

>asw
You walk a little ways to the next sector.

Sector 2: Aquaculture
There is a large, deep pond that serves as part of the water filtration system and is used for raising fish.

>asw
You walk a little ways to the next sector.

Sector 1: Crops
This sector is fallow this cycle. A pylon stretches up from the ground to the hub of the station.

There is a secured hatch in the ground.

>asw
You walk a little ways to the next sector.

Sector 8: Crops
You still maintain the crops here.

>asw
You walk a little ways to the next sector.

Sector 7: Livestock
There are pens left from when this was the livestock sector, but nothing is left now. A pylon stretches up from the ground to the hub of the station.

>asw
You walk a little ways to the next sector.

Sector 6: Hydroponics
Your people prefered to grow things the old fashioned way, but in truth the majority of your fruit and vegetables came from this sector when the machines still worked.

There is a secured hatch in the ground.

>sw
You walk a little ways to the next sector.

Sector 7: Livestock
There are pens left from when this was the livestock sector, but nothing is left now. A pylon stretches up from the ground to the hub of the station.

* * *

>exits
The obvious exits are down and outside.

[Type "exits off" to disable the status line exit list and "exits on" to turn it back on.
]

>gonear red
(the red circuit breaker)
Center Platform
It's a mesh platform a little below the hub. From here, you are very aware of how the station rotates, but everything is okay as long as you don't look down.

You can just reach a red circuit breaker on the hub.

>turn it on
[Your score has just gone up by five points.]

* * *

>gonear barn
That's not a verb I recognize.

>out
Sector 4: Crops
Your home is here among the crops.

* * *

>sw
You walk a little ways to the next sector.

Sector 6: Hydroponics
Your people prefered to grow things the old fashioned way, but in truth the majority of your fruit and vegetables came from this sector when the machines still worked.

There is a secured hatch in the ground.

>sw
You walk a little ways to the next sector.

Sector 7: Livestock
There is a barn left from when this was the livestock sector. A pylon stretches up from the ground to the hub of the station.

>showme
That's not a verb I recognize.

>go barn
Barn
It's a barn.

>out
Sector 7: Livestock
There is a barn left from when this was the livestock sector. A pylon stretches up from the ground to the hub of the station.

>x barn
It's a barn.

>enter barn
Barn
It's a barn.

>out
Sector 7: Livestock
There is a barn left from when this was the livestock sector. A pylon stretches up from the ground to the hub of the station.

>in
Barn
It's a barn.

>out
Sector 7: Livestock
There is a barn left from when this was the livestock sector. A pylon stretches up from the ground to the hub of the station.

>out
But you aren't in anything at the moment.

>exits
The obvious exits are inside (to the barn), spinward and antispinward (to sector 6).

[Type "exits off" to disable the status line exit list and "exits on" to turn it back on.]

>in
Barn
It's a barn.

>exits
The only obvious exit is outside (to sector 7).

>in
You can't go that way.

>out
Sector 7: Livestock
There is a barn left from when this was the livestock sector. A pylon stretches up from the ground to the hub of the station.

* * *

>gonear book
Church
Before everyone left, or died, you celebrated every sabbath here.

The altar stands against the far wall.

On the altar is The Founder's Testament.

>look
Church
Before everyone left, or died, you celebrated every sabbath here.

The altar stands against the far wall.

On the altar is The Founder's Testament.

>read book
The Founder's Testament tells the story of how your people left Old Earth and first settled the station. You have already derived whatever comfort you can from this book.

* * *

>gonear boots
Supply Vault
This room is dim, quiet, and stuffy. There is still a crate of machine parts left. The only exit is antispinward.

You can see some pair of gravity boots here.

>gonear red breaker
Center Platform
It's a mesh platform a little below the hub. From here, you are very aware of how the station rotates, but everything is okay as long as you don't look down [1].

You can see a red circuit breaker here.

"[1]" is a footnote. You can type "note 1" to see the first footnote, or "notes" to see all footnotes so far.

>turn it on
You switch the red circuit breaker on.

>gonear pond
Sector 2: Aquaculture
There is a large, deep pond that serves as part of the water filtration system and is used for raising fish.

>purloin helmet
[Purloined.]

>wear helmet
You put on the emergency helmet.

>d
You can't go that way.

>enter water
You can't see any such thing.

>enter pond
Since you're wearing the emergency helmet, you breath comfortably as you step into the pond. At the bottom, you find a green circuit breaker and flip it on.

You have switched on all three circuit breakers. Since the game isn't finished, that means...

    *** You have won. ***

Would you like to RESTART, RESTORE a saved game, QUIT, or UNDO the last command?

* * *

>gonear boots
Supply Vault
This room is dim, quiet, and stuffy. There is still a crate of machine parts left. The only exit is antispinward.

You can see some pair of gravity boots here.

>x crate
You see nothing special about the crate of machine parts.

>get crate
That's hardly portable.

>touch crate
You feel nothing unexpected.

>search create
You can't see any such thing.

>search crate
You find nothing of interest.

* * *

>gonear cart
There seems to be no such object anywhere in the model world.

>gonear crate
Supply Vault
This room is dim, quiet, and stuffy. There is still a crate of machine parts left. The only exit is antispinward.

You can see some pair of gravity boots here.

>x crate
You see nothing special about the crate of machine parts.

>search crate
You find nothing of interest.

>look in crate
You find nothing of interest.

>take crate
That's just scenery.

* * *

>gonear church
(Church)
Church
Before everyone left or died, you celebrated every sabbath here.

The altar stands against the far wall.

On the altar is The Founder's Testament.

>analyze testament
examining the Founder's Testament:
The Founder's Testament tells the story of how your people left Old Earth and first settled the station. You know the story by heart, and have already derived whatever comfort you can from this book.

looking under the Founder's Testament:
You find nothing of interest.

searching the Founder's Testament:
You find nothing of interest.

listening to the Founder's Testament:
You hear nothing unexpected.

smelling the Founder's Testament:
You smell nothing unexpected.

attacking the Founder's Testament:
Violence isn't the answer to this one.

buying the Founder's Testament:
Nothing is on sale.

climbing the Founder's Testament:
Little is to be achieved by that.

pulling the Founder's Testament:
Nothing obvious happens.

pushing the Founder's Testament:
Nothing obvious happens.

turning the Founder's Testament:
Nothing obvious happens.

pushing the Founder's Testament to outside:
The Founder's Testament cannot be pushed from place to place.

opening the Founder's Testament:
It isn't something you can open.

entering the Founder's Testament:
That's not something you can enter.

getting off the Founder's Testament:
But you aren't on the Founder's Testament at the moment.

closing the Founder's Testament:
It isn't something you can close.

taking the Founder's Testament:
Taken.

switching on the Founder's Testament:
It isn't something you can switch.

switching off the Founder's Testament:
It isn't something you can switch.

wearing the Founder's Testament:
You can't wear that!

taking off the Founder's Testament:
You aren't wearing the Founder's Testament.

(no other people in the location; can't test throwing at.)

(no other people in the location; can't test showing to.)

(no other people in the location; can't test giving to.)

touching the Founder's Testament:
You feel nothing unexpected.

rubbing the Founder's Testament:
You rub the Founder's Testament.

waving the Founder's Testament:
You wave the Founder's Testament.

squeezing the Founder's Testament:
You achieve nothing by this.

burning the Founder's Testament:
This dangerous act would achieve little.

cutting the Founder's Testament:
Cutting it up would achieve little.

tying the Founder's Testament to the altar:
You would achieve nothing by this.

swinging the Founder's Testament:
There's nothing sensible to swing here.

tasting the Founder's Testament:
You taste nothing unexpected.

drinking the Founder's Testament:
There's nothing suitable to drink here.

eating the Founder's Testament:
That's plainly inedible.

dropping the Founder's Testament:
Dropped.

* * *

>gonear church
(Church)
Church
Before everyone left or died, you celebrated every sabbath here.

The altar stands against the far wall.

On the altar is The Founder's Testament.

>buy testament
That's not a verb I recognize.

>analyze testament
examining the Founder's Testament:
The Founder's Testament tells the story of how your people left Old Earth and first settled the station. You know the story by heart, and have already derived whatever comfort you can from this book.

looking under the Founder's Testament:
You find nothing of interest.

searching the Founder's Testament:
You find nothing of interest.

listening to the Founder's Testament:
You hear nothing unexpected.

smelling the Founder's Testament:
You smell nothing unexpected.

attacking the Founder's Testament:
Violence isn't the answer to this one.

buying the Founder's Testament:
Nothing is on sale.

climbing the Founder's Testament:
Little is to be achieved by that.

pulling the Founder's Testament:
Nothing obvious happens.

pushing the Founder's Testament:
Nothing obvious happens.

turning the Founder's Testament:
Nothing obvious happens.

pushing the Founder's Testament to outside:
The Founder's Testament cannot be pushed from place to place.

opening the Founder's Testament:
It isn't something you can open.

entering the Founder's Testament:
That's not something you can enter.

getting off the Founder's Testament:
But you aren't on the Founder's Testament at the moment.

closing the Founder's Testament:
It isn't something you can close.

taking the Founder's Testament:
Taken.

switching on the Founder's Testament:
It isn't something you can switch.

switching off the Founder's Testament:
It isn't something you can switch.

wearing the Founder's Testament:
You can't wear that!

taking off the Founder's Testament:
You aren't wearing the Founder's Testament.

(no other people in the location; can't test throwing at.)

(no other people in the location; can't test showing to.)

(no other people in the location; can't test giving to.)

touching the Founder's Testament:
You feel nothing unexpected.

rubbing the Founder's Testament:
You rub the Founder's Testament.

waving the Founder's Testament:
You wave the Founder's Testament.

squeezing the Founder's Testament:
You achieve nothing by this.

burning the Founder's Testament:
This dangerous act would achieve little.

cutting the Founder's Testament:
Cutting it up would achieve little.

tying the Founder's Testament to yourself:
You would achieve nothing by this.

swinging the Founder's Testament:
There's nothing sensible to swing here.

tasting the Founder's Testament:
You taste nothing unexpected.

drinking the Founder's Testament:
There's nothing suitable to drink here.

eating the Founder's Testament:
That's plainly inedible.

dropping the Founder's Testament:
Dropped.

>try eat
Unknown verb test.

>try eating
eating the pocket:
That's plainly inedible.

eating the altar:
That's plainly inedible.

eating the Founder's Testament:
That's plainly inedible.

eating yourself:
You're plainly inedible.

eating the green jumpsuit:
That's plainly inedible.

>out
Sector 3: Forest
Trees, a house, and a church. A red pylon stretches up from the ground to the hub of the station.

>try eating
eating the pocket:
That's plainly inedible.

eating the pylon:
That's plainly inedible.

eating the church:
That's plainly inedible.

eating the house:
That's plainly inedible.

eating some trees:
They're plainly inedible.

eating yourself:
You're plainly inedible.

eating the green jumpsuit:
That's plainly inedible.

>asw
You walk a little ways to the next sector.

Sector 2: Aquaculture
A deep pond serves as part of the water filtration system and for raising fish.

>try eating
eating the pocket:
That's plainly inedible.

eating the pond:
That's plainly inedible.

eating the fish:
The fish aren't easy to catch.

eating yourself:
You're plainly inedible.

eating the green jumpsuit:
That's plainly inedible.

>asw
You walk a little ways to the next sector.

Sector 1: Crops
This sector is fallow for a cycle. A pylon stretches up from the ground to the hub of the station.

There is a secured hatch in the ground.

>try eating
eating the pocket:
That's plainly inedible.

eating the pylon:
That's plainly inedible.

eating the floor hatch:
That's plainly inedible.

eating yourself:
You're plainly inedible.

eating the green jumpsuit:
That's plainly inedible.

>asw
You walk a little ways to the next sector.

Sector 8: Crops
You still maintain the crops here, and there is a small graveyard.

>try eating
eating the pocket:
That's plainly inedible.

eating yourself:
You're plainly inedible.

eating the green jumpsuit:
That's plainly inedible.

eating the crops:
You're not hungry now.

eating the graveyard:
That's plainly inedible.

>asw
You walk a little ways to the next sector.

Sector 7: Livestock
There are pens left from when this was the livestock sector, but no animals. A pylon stretches up from the ground to the hub of the station.

>try eating
eating the pocket:
That's plainly inedible.

eating yourself:
You're plainly inedible.

eating the green jumpsuit:
That's plainly inedible.

eating the pens:
They're plainly inedible.

eating the pylon:
That's plainly inedible.

>asw
You walk a little ways to the next sector.

Sector 6: Hydroponics
Your people prefered to grow things the old fashioned way, but in truth the majority of your fruit and vegetables came from this sector when the machines still worked.

There is a secured hatch in the ground.

>try eating
eating the pocket:
That's plainly inedible.

eating yourself:
You're plainly inedible.

eating the green jumpsuit:
That's plainly inedible.

eating Hydroponics machines:
The hydroponics machines are just so much junk.

eating the floor hatch:
That's plainly inedible.

>asw
You walk a little ways to the next sector.

Sector 5: Forest
A pylon stretches up from among a group of trees to the hub of the station.

The school house is nestled among the trees.

>try eating
eating the pocket:
That's plainly inedible.

eating yourself:
You're plainly inedible.

eating the green jumpsuit:
That's plainly inedible.

eating the school building:
That's plainly inedible.

eating the pylon:
That's plainly inedible.

eating some trees:
They're plainly inedible.

>asw
You walk a little ways to the next sector.

Sector 4: Crops
Your home is here among the crops.

You have walked the entire ring. Everything is as expected, much is not working. Now, it's time to leave. The pods are below Sector 1.

>try eating
eating the pocket:
That's plainly inedible.

eating your home:
That's plainly inedible.

eating the vegetables:
You're not hungry now.

eating yourself:
You're plainly inedible.

eating the green jumpsuit:
That's plainly inedible.

>purloin boots
[Purloined.]

>don boots
You put on the pair of gravity boots.

>doff boots
You take off the pair of gravity boots.

>look
Sector 4: Crops
Your home is here among the crops.

>restart
Are you sure you want to restart?

>yes
You awake. You are lonely, so lonely. It was a thousand days ago today. All alone these thousand days. Your parents were the last. No, your father was the last. He held on for nearly a hundred days longer than your mother. No, you are the last. Alone. Adrift.

But maybe it isn't hopeless. There must still be some people in other worlds, and you think you know how to get there.

Today is the day.

Green
A Space Story by Thomas Insel
Release 1 / Serial number 181120 / Inform 7 build 6M62 (I6/v6.33 lib 6/12N) SD
Type "about" for credits and more information.

Home
The room where you've slept your entire life. You can go out towards the crops.

There is a secured hatch in the floor.

* * *

>gonear church
(Church)
Church
Before everyone left or died, you celebrated every sabbath here.

The altar stands against the far wall.

On the altar is The Founder's Testament.

>get testament
Taken.

>i
You are carrying:
  The Founder's Testament
  a green jumpsuit (being worn)

>x testament
The Founder's Testament tells the story of how your people left Old Earth and first settled the station.

>read it
The Founder's Testament tells the story of how your people left Old Earth and first settled the station.

* * *

>x testament
The Founder's Testament tells the story of how your people left Old Earth and first settled the station.

>read testament
The Founder's Testament tells the story of how your people left Old Earth and first settled the station.

* * *

>gonear church
(Church)
Church
Before everyone left or died, you celebrated every sabbath here.

The altar stands against the far wall.

On the altar is The Founder's Testament.

>look
Church
Before everyone left, or died, you celebrated every sabbath here.

The altar stands against the far wall.

On the altar is The Founder's Testament.

>out
Sector 3: Forest
Trees, two homes, and a church. A red pylon stretches up from the ground to the hub of the station.

>x church
You can't see any such thing.

* * *

>look
Church
Before everyone left, or died, you celebrated every sabbath here.

The altar stands against the far wall.

On the altar is The Founder's Testament.

>x testament
The Founder's Testament tells the story of how your people left Old Earth and first settled the station. You know the story by heart, and have already derived whatever comfort you can from this book.

>read testmanet
You can't see any such thing.

>look
Church
Before everyone left, or died, you celebrated every sabbath here.

The altar stands against the far wall.

On the altar is The Founder's Testament.

* * *

>gonear church
(Church)
Church
Before everyone left or died, you celebrated every sabbath here.

The altar stands against the far wall.

On the altar is The Founder's Testament.

>out
Sector 3: Forest
Trees, a house, and a church. A red pylon stretches up from the ground to the hub of the station.

>in
You can enter the church or the house.

>go church
Church
It's a church.

>out
Sector 3: Forest
Trees, a house, and a church. A red pylon stretches up from the ground to the hub of the station.

* * *

>go church
Church
It's a church.

>enter church
You can't see any such thing.

>restart
Are you sure you want to restart?

* * *

>out
You get off your bed.

Home
The room where you've slept your entire life. The only exit is out from here.

There is a secured hatch in the floor.

You can also see your bed here.

>go bed
You get onto your bed.

>look
Home (on your bed)
The room where you've slept your entire life. The only exit is out from here.

There is a secured hatch in the floor.

* * *

>out
You get off your bed.

Home
The room where you've slept your entire life. The only exit is out from here.

There is a secured hatch in the floor.

You can also see your bed here.

>out
Sector 4: Crops
You are in sector 4.

Your home is here among the crops.

>go home
Home
The room where you've slept your entire life. The only exit is out from here.

There is a secured hatch in the floor.

You can also see your bed here.

>gonear church
(Church)
Church
It's a church.

>out
Sector 3: Forest
Trees, a house, and a church. A red pylon stretches up from the ground to the hub of the station.

>take church
That's hardly portable.

>look at church
It's a church.

>enter church
Church
It's a church.

>out
Sector 3: Forest
Trees, a house, and a church. A red pylon stretches up from the ground to the hub of the station.

* * *

>in
You can enter the church or the house.

>out
Sector 3: Forest
Trees, two homes, and a church. A red pylon stretches up from the ground to the hub of the station.

>x church
It's a church.

>look
Sector 3: Forest
Trees, two homes, and a church. A red pylon stretches up from the ground to the hub of the station.

* * *

>out
Sector 3: Forest
Trees, a house, and a church. A red pylon stretches up from the ground to the hub of the station.

>u
The red pylon is designated for climbing, but you still can't get a grip.

>purloin boots
[Purloined.]

>wear boots
You put on the pair of gravity boots.

>u
It isn't easy, but with the boots, you are able to climb towards the hub.

Center Platform
It's a mesh platform a little below the hub. From here, you are very aware of how the station rotates, but everything is okay as long as you don't look down.

You can just reach a red circuit breaker on the hub.

>d
You climb down the pylon.

Sector 3: Forest
Trees, a house, and a church. A red pylon stretches up from the ground to the hub of the station.

>remove boots
You take off the pair of gravity boots.

>u
The red pylon is designated for climbing, but you still can't get a grip.

>look
Sector 3: Forest
Trees, a house, and a church. A red pylon stretches up from the ground to the hub of the station.

>x me
As virtuous as ever.

>look
Sector 3: Forest
Trees, a house, and a church. A red pylon stretches up from the ground to the hub of the station.

>look
Sector 3: Forest
Trees, a house, and a church. A red pylon stretches up from the ground to the hub of the station.

>showme
Sector 3: Forest - room
    Maintenance platform - backdrop
    Mirrors - backdrop
    Solar panels - backdrop
    hub - backdrop
    yourself - person
        pair of gravity boots
        green jumpsuit (worn)
            pocket (part of green jumpsuit) - open container
    the pylon - pylon
    the church
    the house
    some trees - forest

>showme mirrors
Mirrors - backdrop
location: in Sector 3: Forest
singular-named, proper-named; unlit, inedible, fixed in place, scenery
list grouping key: none
printed name: "Mirrors"
printed plural name: "backdrops"
indefinite article: none
description: "The mirrors reflect sun light into the station."
initial appearance: none

>x mirros
You can't see any such thing.

* * *

>gonear church
(Church)
Church
Before everyone left or died, you celebrated every sabbath here.

The altar stands against the far wall.

On the altar is The Founder's Testament.

>x altar
Really just a table now.

>get altar
That's fixed in place.

>taste altar
You taste nothing unexpected.

>i
You are carrying:
  a green jumpsuit (being worn)

>purloin mask
[Purloined.]

>put mask on altar
You put the emergency mask on the altar.

>look
Church
Before everyone left, or died, you celebrated every sabbath here.

The altar stands against the far wall.

On the altar is an emergency mask.

>look
Church
Before everyone left, or died, you celebrated every sabbath here.

The altar stands against the far wall.

On the altar is an emergency mask.

>out
Sector 3: Forest
Trees, a house, and a church. A red pylon stretches up from the ground to the hub of the station.

>go hose
You can't see any such thing.

>go house
House
Two families lived here, but not recently.

>look
House
Two families lived here, but not recently.

>in
You can't go that way.

>out
Sector 3: Forest
Trees, a house, and a church. A red pylon stretches up from the ground to the hub of the station.

>look
Sector 3: Forest
Trees, a house, and a church. A red pylon stretches up from the ground to the hub of the station.

>x trees
The community grew trees for tradition, or maybe they help with air processing. You don't remember.

>climb trees
You can't get a good grip.

>look
Sector 3: Forest
Trees, a house, and a church. A red pylon stretches up from the ground to the hub of the station.

>sw
You walk a little ways to the next sector.

Sector 4: Crops
Your home is here among the crops.

>x crops
Greens, carrots, and potatoes.

>x carrots
Greens, carrots, and potatoes.

>x peas
You can't see any such thing.

>x potatoes
Greens, carrots, and potatoes.

>x greens
Greens, carrots, and potatoes.

>look
Sector 4: Crops
Your home is here among the crops.

>sw
You walk a little ways to the next sector.

Sector 5: Forest
A pylon stretches up from among a group of trees to the hub of the station.

The school house is nestled among the trees.

>x pylon
Made of smooth metal, it connects the ground to the hub of the station about 25 meters above [1].

"[1]" is a footnote. You can type "note 1" to see the first footnote, or "notes" to see all footnotes so far.

>look
Sector 5: Forest
A pylon stretches up from among a group of trees to the hub of the station.

The school house is nestled among the trees.

* * *

>gonear church
(Church)
Church
Before everyone left or died, you celebrated every sabbath here.

The altar stands against the far wall.

On the altar is The Founder's Testament.

>x steeple
You can't see any such thing.

>out
Sector 3: Forest
Trees, a house, and a church. A red pylon stretches up from the ground to the hub of the station.

>x steeple
A small white building with a steeple.

>x building
A small white building with a steeple.

>x home
You can't see any such thing.

>x house
It's a house.

* * *

>gonear crate
Supply Vault
This room is dim, quiet, and stuffy. There is still a crate of machine parts left. The only exit is antispinward.

You can see some pair of gravity boots here.

>x crate
These remaining parts never seem to fit where they might be useful.

>get boots
Taken.

>u
You can't go that way.

>asw
An alarm sounds and you jump back as a gate slams shut across the passageway. It quickly retracts.

* * *

>x crate
These remaining parts never seem to fit where they might be useful.

>x parts
These remaining parts never seem to fit where they might be useful.

>search cate
You can't see any such thing.

>search crate
Many miscellaneous parts, but none useful.

>search parts
Many miscellaneous parts, but none useful.

* * *

>gonear desk
School
You had learning machines once. After they broke, some of the older farmers took turns leading the class, then just you, in lessons.

There is a chalkboard on the wall.

You can also see a desk (on which is a clean eraser) here.

>x desk
The learning machines were the first to go, they told you. Your people were practical, plan folk, they said. So, you learned practical things in school: reading, writing, arithmetic, and more importantly practical mechanics and farming. There wasn't too much time for history, if they even remembered it.

On the desk is a clean eraser.

* * *

>gonear display
Pod Control
This room serves as an airlock for the pod bay.

There is a secured hatch in the ceiling.

.

>look
Pod Control
This room serves as an airlock for the pod bay.

There is a secured hatch in the ceiling.

.

* * *

>gonear display
Pod Control
This room serves as an airlock for the pod bay.

There is a secured hatch in the ceiling.

.

>x display
Pod bay locked down
Diagnosis: telemetry sensor array offline
Remediation: reset circuit breaker 36-87/A, location: hub maintenance platform

* * *

>gonear display
Pod Control
This room serves as an airlock for the pod bay.

There is a secured hatch in the ceiling.

.

>x status
Pod bay locked down
Diagnosis: telemetry sensor array offline
Remediation: reset circuit breaker 36-87/A, location: hub maintenance platform

>x display
Pod bay locked down
Diagnosis: telemetry sensor array offline
Remediation: reset circuit breaker 36-87/A, location: hub maintenance platform

>s
You can't go that way.

>asw
(first opening pod bay door)
It seems to be locked.

>unlock door
(with the green jumpsuit)
That doesn't seem to fit the lock.

>look
Pod Control
Beside the antispinward hatch to the pod bay, a status display shows an error message.

There is a secured hatch in the ceiling.

* * *

>gonear eraser
School
You had learning machines once. After they broke, some of the older farmers took turns leading the class, then just you, in lessons.

There is a chalkboard on the wall.

You can also see a desk (on which is a clean eraser) here.

>erase board
You smudge the writing around.

>get eraser
Taken.

>erase board
(with the eraser)
You carefully erase the chalkboard.

>g
The chalkboard is already clean.

>g
The chalkboard is already clean.

>look
School
You had learning machines once. After they broke, some of the older farmers took turns leading the class, then just you, in lessons.

There is a chalkboard on the wall.

You can also see a desk here.

* * *

>gonear eraser
School
You had learning machines once. After they broke, some of the older farmers took turns leading the class, then just you, in lessons.

There is a chalkboard on the wall.

You can also see a desk (on which is a clean eraser) here.

>get eraser
Taken.

>put it in pocket
You put the clean eraser into the pocket.

>erase the board
(with the eraser)
(first taking the clean eraser)
You carefully erase the chalkboard.

>i
You are carrying:
  a dusty eraser
  a green jumpsuit (being worn)

>erase the board
(with the eraser)
The chalkboard is already clean.

>look
School
You had learning machines once. After they broke, some of the older farmers took turns leading the class, then just you, in lessons.

There is a chalkboard on the wall.

You can also see a desk here.

* * *

>gonear eraser
School
You had learning machines once. After they broke, some of the older farmers took turns leading the class, then just you, in lessons.

There is a chalkboard on the wall.

You can also see a desk (on which is a clean eraser) here.

>x desk
You wrote your lessons at this desk. Your people were practical, plain folk, so you learned practical things in school: reading, writing, arithmetic. More importantly, practical mechanics and farming. There wasn't too much time for history, if they even remembered it.

On the desk is a clean eraser.

>x chalkboard
The board is covered in your old arithmetic work.

>restart
Are you sure you want to restart?

>yes
You awake. You are lonely, so lonely. It was a thousand days ago today. All alone these thousand days. Your parents were the last. No, your father was the last. He held on for nearly a hundred days longer than your mother. No, you are the last. Alone. Adrift.

But maybe it isn't hopeless. There were always the rumors, let's call them stories. "Stories" feels more reliable. Stories, then, of other people in other worlds. If the stories are true then you also know how to get there.

Today is the day.

Green
An Interactive Space Story by Thomas Insel
Release 1 / Serial number 181117 / Inform 7 build 6M62 (I6/v6.33 lib 6/12N) SD
Type "about" for credits and more information.

Home (on your bed)
The room where you've slept your entire life. The only exit is out from here.

There is a secured hatch in the floor.

* * *

>gonear hatch
(the floor hatch)
Home
The room where you've slept your entire life. The only exit is out from here.

There is a secured hatch in the floor.

>d
(first opening the floor hatch)
You pull yourself up through the hatch and close it behind yourself.

Below Home
This space is used for storage and as a decompression shelter.

There is a secured hatch in the ceiling.

There is an emergency helmet hanging on the wall.

* * *

>look
Below Home
This space is used for storage and as a decompression shelter.

There is a secured hatch in the ceiling.

There is an emergency helmet hanging on the wall.

>out
But you aren't in anything at the moment.

>gonear status
Pod Control
It's the pod control room.

There is a secured hatch in the ceiling.

Beside the secured antispinward hatch to the pod bay, a status display shows an error message.

* * *

>gonear hatch
(the floor hatch)
Home
The room where you've slept your entire life. The only exit is out from here.

There is a secured hatch in the floor.

>gonear bed
Home
The room where you've slept your entire life. The only exit is out from here.

There is a secured hatch in the floor.

You can also see your bed here.

>d
(first opening the floor hatch)
You scramble down through the hatch and close it behind yourself.

Below Home
This space is used for storage and as a decompression shelter.

There is a secured hatch in the ceiling.

There is an emergency mask hanging on the wall.

>look
Below Home
This space is used for storage and as a decompression shelter.

There is a secured hatch in the ceiling.

There is an emergency mask hanging on the wall.

>x mask
You used to wear a mask like this when there were decompression drills every twenty days.

>gonear status
Pod Control
This room serves as an airlock for the pod bay.

There is a secured hatch in the ceiling.

Beside the secured antispinward hatch, a status display shows an error message.

>x status
Pod bay locked down
Diagnosis: telemetry sensor array offline
Remediation: reset breaker 36-87/A @ hub platform

>look
Pod Control
This room serves as an airlock for the pod bay.

There is a secured hatch in the ceiling.

Beside the secured antispinward hatch, a status display shows an error message.

* * *

>gonear hatch
(the floor hatch)
Home
The room where you've slept your entire life. The only exit is out from here.

There is a secured hatch in the floor.

>gonear center
Center Platform
It's a mesh platform a little below the hub. From here, you are very aware of how the station rotates, but everything is okay as long as you don't look down [1].

You can see a red breaker here.

"[1]" is a footnote. You can type "note 1" to see the first footnote, or "notes" to see all footnotes so far.

* * *

>gonear hatch
(the floor hatch)
Home
The room where you've slept your entire life. The only exit is out from here.

There is a secured hatch in the floor.

>gonear red
Center Platform
It's a mesh platform a little below the hub. From here, you are very aware of how the station rotates, but everything is okay as long as you don't look down [1].

You can see a red circuit breaker here.

"[1]" is a footnote. You can type "note 1" to see the first footnote, or "notes" to see all footnotes so far.

>turn red on
You switch the red circuit breaker on.

>gonear pond
Sector 2: Aquaculture
There is a large, deep pond that serves as part of the water filtration system and is used for raising fish.

* * *

>gonear hatch
(the floor hatch)
Home
The room where you've slept your entire life. The only exit is out from here.

There is a secured hatch in the floor.

>gonear sensor
There seems to be no such object anywhere in the model world.

>gonear status
Pod Control
This room serves as an airlock for the pod bay.

There is a secured hatch in the ceiling.

Beside the secured antispinward hatch, a status display shows an error message.

>x message
Pod bay locked down
Diagnosis: telemetry sensor array offline
Remediation: reset circuit breaker 36-87/A @ hub platform

* * *

>gonear hatch
(the floor hatch)
Home
The room where you've slept your entire life. The only exit is out from here.

There is a secured hatch in the floor.

>out
Sector 4: Crops
Your home is here among the crops.

>x hub
The station rotates around the hub, which extends out to hold solar panels on the starboard side. On the inside, there is a mesh maintenance platform.

* * *

>gonear house
Which do you mean, the house, House, your home, or the school building?

>gonear church
(Church)
Church
Before everyone left, or died, you celebrated every sabbath here.

The altar stands against the far wall.

>out
Sector 3: Forest
Trees, a house, and a church. A red pylon stretches up from the ground to the hub of the station.

* * *

>look
Sector 3: Forest
Trees, a house, and a church. A red pylon stretches up from the ground to the hub of the station.

>x house
What looks like whitewashed siding is really a lightweight plastic.

>x siding
What looks like whitewashed siding is really a lightweight plastic.

>x church
A small white building with a steeple.

>go church
Church
Before everyone left, or died, you celebrated every sabbath here.

The altar stands against the far wall.

>look
Church
Before everyone left, or died, you celebrated every sabbath here.

The altar stands against the far wall.

>x altar
Really just a table now.

>out
Sector 3: Forest
Trees, a house, and a church. A red pylon stretches up from the ground to the hub of the station.

>sw
You walk a little ways to the next sector.

Sector 4: Crops
Your home is here among the crops.

* * *

>sw
You walk a little ways to the next sector.

Sector 6: Hydroponics
Your people prefered to grow things the old fashioned way, but in truth the majority of your fruit and vegetables came from this sector when the machines still worked.

There is a secured hatch in the ground.

>sw
You walk a little ways to the next sector.

Sector 7: Livestock
There are pens left from when this was the livestock sector, but no animals. A pylon stretches up from the ground to the hub of the station.

>sw
You walk a little ways to the next sector.

Sector 8: Crops
You still maintain the crops here.

>x crops
Grain and legumes.

* * *

>gonear house
Which do you mean, the house, House, your home, or the school building?

>gonear sector 3
Sector 3: Forest
Trees, a house, and a church. A red pylon stretches up from the ground to the hub of the station.

>in
You can enter the church or the house.

>x house
It's a house.

>x trees
You can't see any such thing.

>go house
That's not something you can enter.

>enter house
That's not something you can enter.

>go in
You can enter the church or the house.

* * *

>gonear hub
Center Platform
It's a mesh platform a little below the hub. From here, you are very aware of how the station rotates, but everything is okay as long as you don't look down [1].

You can see a red circuit breaker here.

"[1]" is a footnote. You can type "note 1" to see the first footnote, or "notes" to see all footnotes so far.

>out
But you aren't in anything at the moment.

>d
You slide down the pylon.

Sector 3: Forest
Trees, a house, and a church. A red pylon stretches up from the ground to the hub of the station.

>look
Sector 3: Forest
Trees, a house, and a church. A red pylon stretches up from the ground to the hub of the station.

>u
The red pylon is designated for climbing, but you still can't get a grip.

* * *

>purloin boots
[Purloined.]

>u
The red pylon is designated for climbing, but you still can't get a grip.

>wear boots
You put on the pair of gravity boots.

>u
It isn't easy, but with the boots, you are able to climb towards the hub.

Center Platform
It's a mesh platform a little below the hub. From here, you are very aware of how the station rotates, but everything is okay as long as you don't look down [1].

You can see a red circuit breaker here.

>d
You climb down the pylon.

Sector 3: Forest
Trees, a house, and a church. A red pylon stretches up from the ground to the hub of the station.

>u
It isn't easy, but with the boots, you are able to climb towards the hub.

Center Platform
It's a mesh platform a little below the hub. From here, you are very aware of how the station rotates, but everything is okay as long as you don't look down [1].

You can see a red circuit breaker here.

* * *

>d
You climb down the pylon.

Sector 3: Forest
Trees, a house, and a church. A red pylon stretches up from the ground to the hub of the station.

>restart
Are you sure you want to restart?

* * *

>gonear red
Center Platform
It's a mesh platform a little below the hub. From here, you are very aware of how the station rotates, but everything is okay as long as you don't look down [1].

You can see a red circuit breaker here.

"[1]" is a footnote. You can type "note 1" to see the first footnote, or "notes" to see all footnotes so far.

>d
You slide down the pylon.

Sector 3: Forest
Trees, a house, and a church. A red pylon stretches up from the ground to the hub of the station.

>restart
Are you sure you want to restart?

* * *

>gonear church
(Church)
Church
It's a church.

* * *

>out
Sector 3: Forest
Trees, a house, and a church. A red pylon stretches up from the ground to the hub of the station.

>gonear church
(the church)
Sector 3: Forest
Trees, a house, and a church. A red pylon stretches up from the ground to the hub of the station.

>in
You can enter the church or the house.

* * *

>gonear hyrdoponics
There seems to be no such object anywhere in the model world.

>gonear machines
Sector 6: Hydroponics
Your people prefered to grow things the old fashioned way, but in truth the majority of your fruit and vegetables came from this sector when the machines still worked.

There is a secured hatch in the ground.

>x machines
You were thoroughly trained in hydroponics maintenance, but fixing these machines is beyond you.

>x fruit
You can't see any such thing.

>x vegetables
You can't see any such thing.

>out
But you aren't in anything at the moment.

>sw
You walk a little ways to the next sector.

Sector 7: Livestock
There are pens left from when this was the livestock sector, but no animals. A pylon stretches up from the ground to the hub of the station.

>asw
You walk a little ways to the next sector.

Sector 6: Hydroponics
Your people prefered to grow things the old fashioned way, but in truth the majority of your fruit and vegetables came from this sector when the machines still worked.

There is a secured hatch in the ground.

>sw
You walk a little ways to the next sector.

Sector 7: Livestock
There are pens left from when this was the livestock sector, but no animals. A pylon stretches up from the ground to the hub of the station.

>x pens
There are no animals left.

>get pens
They're hardly portable.

>climb pens
Little is to be achieved by that.

* * *

>gonear learning
School
You had learning machines once. After they broke, some of the older farmers took turns leading the class, eventually just you, in lessons.

There is a chalkboard on the wall.

You can also see a learning machine and a desk (on which is a clean eraser) here.

>scan learning
Machine is failed.

>gonear status
Pod Control
This room serves as an airlock for the pod bay.

There is a secured hatch in the ceiling.

Beside the secured port hatch, a status display shows an error message.

You can also see an atmosphere pump and a pump regulator module here.

>scan status
Machine is functional.

>scanner, open status
Machine is unitary.

>x status
Pod bay locked down
Diagnosis: telemetry sensor array offline
Remediation: reset breaker 36-87/A @ hub platform

* * *

>gonear mask
Below Home
This space is used for storage and as a decompression shelter.

There is a secured hatch in the ceiling.

There is an emergency mask hanging on the wall.

>gonear pond
Sector 2: Aquaculture
There is a large, deep pond that serves as part of the water filtration system and is used for raising fish.

>purloin mask
[Purloined.]

>wear mask
You put on the emergency mask.

>i
You are carrying:
  an emergency mask (being worn)
  a green jumpsuit (being worn)

>d
You can't go that way.

>go pond
WIth the air from the emergency mask, you breathe comfortably as you step into the pond. At the bottom, you find a green circuit breaker and flip it on.

>gonear red
Center Platform
It's a mesh platform a little below the hub. From here, you are very aware of how the station rotates, but everything is okay as long as you don't look down [1].

You can see a red circuit breaker here.

"[1]" is a footnote. You can type "note 1" to see the first footnote, or "notes" to see all footnotes so far.

* * *

>turn red on
You switch the red circuit breaker on.

>gonear status
Pod Control
This room serves as an airlock for the pod bay.

There is a secured hatch in the ceiling.

Beside the secured antispinward hatch, a status display glows green.

>look
Pod Control
This room serves as an airlock for the pod bay.

There is a secured hatch in the ceiling.

Beside the secured antispinward hatch, a status display glows green.

>open hatch
Which do you mean, the ceiling hatch or the pod bay hatch?

>ceiling
You open the ceiling hatch.

>secure hatch
Which do you mean, the ceiling hatch or the pod bay hatch?

>x pod bay
You see nothing special about the pod bay hatch.

>open hatch
Which do you mean, the ceiling hatch or the pod bay hatch?

>pod
You open the pod bay hatch.

>look
Pod Control
This room serves as an airlock for the pod bay.

There is an open hatch in the ceiling.

Beside the open antispinward hatch, a status display glows green.

>x display
Pod bay locked down
Secure ceiling hatch

* * *

>gonear me
Home
The room where you've slept your entire life. The only exit is out from here.

There is a secured hatch in the floor.

>gonear church
(Church)
Church
Before everyone left, or died, you celebrated every sabbath here.

The altar stands against the far wall.

>x altar
Really just a table now.

* * *

>sw
You walk a little ways to the next sector.

Sector 5: Forest
A pylon stretches up from among a group of trees to the hub of the station.

The school house is nestled among the trees.

>e
You have heard of compass directions like east, but they don't make any sense here. Instead, you can go spinward, antispinward, port, and starboard.

When you look spinward, port is left and starboard is right. You can also use up, down, in, and out, and you can use abbreviations "sw", "asw", "p", and "s". Also, you can type "exits" if you get confused about geography.

>exits
The obvious exits are inside, spinward and antispinward (to sector 4: crops).

Type "exits off" to disable the status line exit list and "exits on" to turn it back on.

>exits
The obvious exits are inside, spinward and antispinward (to sector 4: crops).

>sw
You walk a little ways to the next sector.

Sector 6: Hydroponics
Your people prefered to grow things the old fashioned way, but in truth the majority of your fruit and vegetables came from this sector when the machines still worked.

There is a secured hatch in the ground.

* * *

>sw
You walk a little ways to the next sector.

Sector 2: Aquaculture
There is a large, deep pond that serves as part of the water filtration system and is used for raising fish.

>exits
The obvious exits are spinward (to sector 3: forest) and antispinward (to sector 1: crops).

>sw
You walk a little ways to the next sector.

Sector 3: Forest
Trees, a house, and a church. A red pylon stretches up from the ground to the hub of the station.

* * *

>asw
You walk a little ways to the next sector.

Sector 4: Crops
Your home is here among the crops.

>exits
The obvious exits are inside (to home), spinward (to sector 5: forest) and antispinward (to sector 3: forest).

>look
Sector 4: Crops
Your home is here among the crops.

* * *

>sw
You walk a little ways to the next sector.

Sector 5: Forest
A pylon stretches up from among a group of trees to the hub of the station.

The school house is nestled among the trees.

>exits
The obvious exits are inside, spinward (to sector 6: hydroponics) and antispinward (to sector 4: crops).

>in
School
You had learning machines once. After they broke, some of the older farmers took turns leading the class, then just you, in lessons.

There is a chalkboard on the wall.

You can also see a desk (on which is a clean eraser) here.

>exits
The only obvious exit is outside (to sector 5: forest).

>out
Sector 5: Forest
A pylon stretches up from among a group of trees to the hub of the station.

The school house is nestled among the trees.

>exits
The obvious exits are inside (to school), spinward (to sector 6: hydroponics) and antispinward (to sector 4: crops).

* * *

>gonear pond
Sector 2: Aquaculture
There is a large, deep pond that serves as part of the water filtration system and is used for raising fish.

>look in pond
The pond looks pretty murky, you can't easily do that from outside.

>look under pond
You find nothing of interest.

>actions
Actions listing on.

>look under pond
[looking under the pond]
You find nothing of interest.

[looking under the pond - succeeded]

* * *

>gonear pond
Sector 2: Aquaculture
There is a large, deep pond that serves as part of the water filtration system and is used for raising fish.

>look under pond
The pond looks pretty murky, you can't easily do that from outside.

>look under water
You find nothing of interest.

* * *

>gonear read
There seems to be no such object anywhere in the model world.

>gonear red
Center Platform
It's a mesh platform a little below the hub. From here, you are very aware of how the station rotates, but everything is okay as long as you don't look down.

You can see a red circuit breaker here.

>turn red on
You switch the red circuit breaker on.

>gonear pond
Sector 2: Aquaculture
A deep pond serves as part of the water filtration system and for raising fish.

>purloin mask . wear it
[Purloined.]

You put on the emergency mask.

>go pond
WIth the air from the emergency mask, you breathe comfortably as you step into the pond. At the bottom, you find a green circuit breaker and flip it on.

HIHIHIH.

>asw
You walk a little ways to the next sector.

Sector 1: Crops
This sector is fallow for a cycle. A pylon stretches up from the ground to the hub of the station.

There is a secured hatch in the ground.

>asw
You walk a little ways to the next sector.

Sector 8: Crops
You still maintain the crops here, and there is a small graveyard.

>scenes
Scene 'Entire Game' playing (for 7 mins now)
Scene 'Wandering' playing (for 7 mins now)
Scene 'Anxious to Leave' playing (for 3 mins now)
(Scene monitoring now switched on. Type "scenes off" to switch it off again.)

>asw
You walk a little ways to the next sector.

Sector 7: Livestock
There are pens left from when this was the livestock sector, but no animals. A pylon stretches up from the ground to the hub of the station.

>asw
You walk a little ways to the next sector.

Sector 6: Hydroponics
Your people prefered to grow things the old fashioned way, but in truth the majority of your fruit and vegetables came from this sector when the machines still worked.

There is a secured hatch in the ground.

>asw
You walk a little ways to the next sector.

Sector 5: Forest
A pylon stretches up from among a group of trees to the hub of the station.

The school house is nestled among the trees.

>asw
You walk a little ways to the next sector.

Sector 4: Crops
Your home is here among the crops.

>asw
You walk a little ways to the next sector.

Sector 3: Forest
Trees, a house, and a church. A red pylon stretches up from the ground to the hub of the station.

[Scene 'Ready to Repair' begins]
You have walked the entire ring. Everything is as expected, much is not working. Now, it's time to leave. The pods are below Sector 1.

[Scene 'Wandering' ends]

>asw
You walk a little ways to the next sector.

Sector 2: Aquaculture
A deep pond serves as part of the water filtration system and for raising fish.

>scenses
That's not a verb I recognize.

>scenes
Scene 'Entire Game' playing (for 13 mins now)
Scene 'Wandering' ended
Scene 'Ready to Repair' playing (for 2 mins now)
Scene 'Anxious to Leave' playing (for 9 mins now)
(Scene monitoring now switched on. Type "scenes off" to switch it off again.)

* * *

>gonear red
(the red circuit breaker)
Center Platform
It's a mesh platform a little below the hub. From here, you are very aware of how the station rotates, but everything is okay as long as you don't look down.

You can just reach a red circuit breaker on the hub.

>get breaker
That's fixed in place.

>turn breaker on
You switch the red circuit breaker on.

[Your score has just gone up by five points.]

>d
You slide down the pylon.

Sector 3: Forest
Trees, a house, and a church. A red pylon stretches up from the ground to the hub of the station.

>u
Center Platform
It's a mesh platform a little below the hub. From here, you are very aware of how the station rotates, but everything is okay as long as you don't look down.

You can just reach a red circuit breaker on the hub.

>d
You slide down the pylon.

Sector 3: Forest
Trees, a house, and a church. A red pylon stretches up from the ground to the hub of the station.

* * *

>gonear red
(the red circuit breaker)
Center Platform
It's a mesh platform a little below the hub. From here, you are very aware of how the station rotates, but everything is okay as long as you don't look down.

You can just reach a red circuit breaker on the hub.

>turn it on
You switch the red circuit breaker on.

[Your score has just gone up by five points.]

* * *

>gonear red
(the red circuit breaker)
Center Platform
It's a mesh platform a little below the hub. From here, you are very aware of how the station rotates, but everything is okay as long as you don't look down.

You can just reach a red circuit breaker on the hub.

>turn red
It is fixed in place.

>turn red on
You switch the red circuit breaker on.

[Your score has just gone up by five points.]

>d
You slide down the pylon.

Sector 3: Forest
Trees, a house, and a church. A red pylon stretches up from the ground to the hub of the station.

>purloin gravity boots
[Purloined.]

>z
Time passes.

>z
Time passes.

>sw
You walk a little ways to the next sector.

Sector 4: Crops
Your home is here among the crops.

* * *

>sw
You walk a little ways to the next sector.

Sector 6: Hydroponics
Your people prefered to grow things the old fashioned way, but in truth the majority of your fruit and vegetables came from this sector when the machines still worked.

There is a secured hatch in the ground.

>d
(first opening the floor hatch)
You scramble down through the hatch and close it behind yourself.

Below Sector 6
There's nothing distinctive about this small room. You can go up or spinward.

There is a secured hatch in the ceiling.

[Your score has just gone up by five points.]

>u
(first opening the ceiling hatch)
You pull yourself up through the hatch and close it behind yourself.

Sector 6: Hydroponics
Your people prefered to grow things the old fashioned way, but in truth the majority of your fruit and vegetables came from this sector when the machines still worked.

There is a secured hatch in the ground.

>sw
You walk a little ways to the next sector.

Sector 7: Livestock
The barn remains from when this was the livestock sector. A pylon stretches up from the ground to the hub of the station.

>sw
You walk a little ways to the next sector.

Sector 8: Crops
You still maintain the crops here, and there is a small graveyard.

>sw
You walk a little ways to the next sector.

Sector 1: Crops
This sector is fallow for a cycle. A pylon stretches up from the ground to the hub of the station.

There is a secured hatch in the ground.

>d
(first opening the floor hatch)
You scramble down through the hatch and close it behind yourself.

Pod Control
This room serves as an airlock for the pod bay.

There is a secured hatch in the ceiling.

Beside the secured port hatch, a status display shows an error message.

You can also see an atmosphere pump here.

>x pump
It is a smooth featureless box.

>scanner, scan pump
Machine is failed.

>x display
[** Programming error: tried to read (something) **]
Pod bay locked down
Diagnosis: pod control atmosphere pump offline
Remediation: scan and repair pump

>trace
[Trace on.]

>x display
[Parsing for the verb 'x' (1 lines)]
[line 0 * noun -> Examine]
[Line successfully parsed]

[** Programming error: tried to read (something) **]
Pod bay locked down
Diagnosis: pod control atmosphere pump offline
Remediation: scan and repair pump

* * *

>gonear red
(the red circuit breaker)
Center Platform
It's a mesh platform a little below the hub. From here, you are very aware of how the station rotates, but everything is okay as long as you don't look down.

You can just reach a red circuit breaker on the hub.

>turn red on
You switch the red circuit breaker on.

[Your score has just gone up by five points.]

>gonear pond
Sector 2: Aquaculture
There is a large, deep pond that serves as part of the water filtration system and is used for raising fish.

* * *

>wear mask
You put on the emergency mask.

>go pond
WIth the air from the emergency mask, you breathe comfortably as you step into the pond. At the bottom, you find a green circuit breaker and flip it on.

>gonear display
Pod Control
This room serves as an airlock for the pod bay.

There is a secured hatch in the ceiling.

Beside the secured antispinward hatch, a status display glows green.

>open hatch
Which do you mean, the ceiling hatch or the pod bay hatch?

* * *

>ceiling
You open the ceiling hatch.

>look
Pod Control
This room serves as an airlock for the pod bay.

There is an open hatch in the ceiling.

Beside the secured antispinward hatch, a status display shows an error message.

>x message
Pod bay locked down
Secure ceiling hatch

>open hatch
Which do you mean, the ceiling hatch or the pod bay hatch?

>pod bay
It seems to be locked.

>u
You scramble down through the hatch and close it behind yourself.

Sector 1: Crops
You maintain the crops in this sector. A pylon stretches up from the ground to the hub of the station.

There is a secured hatch in the floor.

>sw
You walk a little ways to the next sector.

Sector 2: Aquaculture
There is a large, deep pond that serves as part of the water filtration system and is used for raising fish.

* * *

>sw
You walk a little ways to the next sector.

Sector 3: Forest
Trees, two homes, and a church. A red pylon stretches up from the ground to the hub of the station.

>asw
You walk a little ways to the next sector.

Sector 2: Aquaculture
There is a large, deep pond that serves as part of the water filtration system and is used for raising fish.

* * *

>asw
You walk a little ways to the next sector.

Sector 1: Crops
You maintain the crops in this sector. A pylon stretches up from the ground to the hub of the station.

There is a secured hatch in the floor.

>d
(first opening the floor hatch)
You pull yourself up through the hatch and close it behind yourself.

Pod Control
This room serves as an airlock for the pod bay.

There is a secured hatch in the ceiling.

Beside the secured antispinward hatch, a status display glows green.

>look
Pod Control
This room serves as an airlock for the pod bay.

There is a secured hatch in the ceiling.

Beside the secured antispinward hatch, a status display glows green.

>x display
The status display glows green.

* * *

>turn red on
You switch the red circuit breaker on.

[Your score has just gone up by five points.]

>gonear school
Which do you mean, the school building or School?

>building
I only understood you as far as wanting to gonear the church.

>d
You slide down the pylon.

Sector 3: Forest
Trees, a house, and a church. A red pylon stretches up from the ground to the hub of the station.

>sw
You walk a little ways to the next sector.

Sector 4: Crops
Your home is here among the crops.

* * *

>sw
You walk a little ways to the next sector.

Sector 5: Forest
A pylon stretches up from among a group of trees to the hub of the station.

The school house is nestled among the trees.

>go school
School
You had learning machines once. After they broke, some of the older farmers took turns leading the class, eventually just you, in lessons.

There is a chalkboard on the wall.

You can also see a learning machine and a desk (on which is a clean eraser) here.

>scanner, open learning
Opening.

The learning machine swings open.

[Your score has just gone up by five points.]

>get all
power module: Taken.
instruction module: Taken.
clean eraser: (putting the scanner into your pocket to make room)
Taken.

>gonear status
Pod Control
This room serves as an airlock for the pod bay.

There is a secured hatch in the ceiling.

Beside the secured port hatch, a status display shows an error message.

You can also see an atmosphere pump and a pump regulator module here.

>scanner, scan status
No modular technology detected.

>scanner, open status
No electronic technology detected.

>x status
Pod bay locked down
Diagnosis: pod control atmosphere pump offline
Remediation: scan and repair pump

>scanner, open pump
Which do you mean, the atmosphere pump or the pump regulator module?

>showobj
Search error: cannot find showobj pump.

[You can ask the scanner for a list of commands by typing "scanner, help" and give it commands by typing things like "scanner, scan SOMETHING" where SOMETHING is a visible object. As a special abbreviation, you can type "scan SOMETHING".]

>listobj
Founder's Testament
Hydroponics machines (F) (S)
Laser beam (F) (S)
S7B1 (F) (S)
altar (F)
atmosphere pump (F)
chalkboard (F)
clean eraser
crate of machine parts (F) (S)
crops (F) (S)
desk (F)
emergency mask
fish (F) (S)
graveyard (F) (S)
green circuit breaker (F)
green jumpsuit
hub (F) (S)
instruction module
learning machine (F)
light-meter (F) (S)
maintenance platform (F) (S)
mirrors (F) (S)
pair of gravity boots
pocket (P)
pod bay hatch (F)
pond (F) (S)
power module
power module
pump regulator module
pump regulator module
red circuit breaker (F)
scanner
solar panels (F) (S)
some trees (F) (S)
some trees (F) (S)
space suit (F) (S)
status display (F) (S)
the ceiling hatch (F)
the ceiling hatch (F)
the ceiling hatch (F)
the church (F) (S)
the house (F) (S)
the pylon (F) (S)
the pylon (F) (S)
the pylon (F) (S)
the pylon (F) (S)
the school building (F)
vegetables (F) (S)
your home (F) (S)
yourself

>i
You are carrying:
  a clean eraser
  an instruction module
  a power module
  a green jumpsuit (being worn)

Your jumpsuit pocket contains:
  a scanner

>look
Pod Control
This room serves as an airlock for the pod bay.

There is a secured hatch in the ceiling.

Beside the secured port hatch, a status display shows an error message.

You can also see an atmosphere pump and a pump regulator module here.

>get all
pump regulator module: (putting the power module into your pocket to make room)
Taken.

>i
You are carrying:
  a pump regulator module
  a clean eraser
  an instruction module
  a green jumpsuit (being worn)

Your jumpsuit pocket contains:
  a power module
  a scanner

>scanner, open pump
(the atmosphere pump)
Opening.

The atmosphere pump swings open.

>look
Pod Control
This room serves as an airlock for the pod bay.

There is a secured hatch in the ceiling.

Beside the secured port hatch, a status display shows an error message.

You can also see an atmosphere pump (in which are a power module and a pump regulator module) here.

>get all from pump
(the atmosphere pump)
power module: (putting the instruction module into your pocket to make room)
Taken.
pump regulator module: (putting the clean eraser into your pocket to make room)
Taken.

>i
You are carrying:
  two pump regulator modules
  a power module
  a green jumpsuit (being worn)

Your jumpsuit pocket contains:
  a clean eraser
  an instruction module
  a power module
  a scanner

>scan regulator
Component is faulty.

>i
You are carrying:
  a faulty pump regulator module
  an unscanned power module
  an unscanned pump regulator module
  a green jumpsuit (being worn)

Your jumpsuit pocket contains:
  a clean eraser
  an unscanned instruction module
  an unscanned power module
  a scanner

>scan unscanned regulator
Component is functional.

>i
You are carrying:
  a faulty pump regulator module
  an unscanned power module
  a functional pump regulator module
  a green jumpsuit (being worn)

Your jumpsuit pocket contains:
  a clean eraser
  an unscanned instruction module
  an unscanned power module
  a scanner

>put functional regulator in pump
Which do you mean, the atmosphere pump, the faulty pump regulator module, or the functional pump regulator module?

>put functional regulator in atmosphere pump
You put the functional pump regulator module into the atmosphere pump.

>i
You are carrying:
  a faulty pump regulator module
  an unscanned power module
  a green jumpsuit (being worn)

Your jumpsuit pocket contains:
  a clean eraser
  an unscanned instruction module
  an unscanned power module
  a scanner

>scan power module
Component is faulty.

>scan unscanned power module
Component is functional.

>i
You are carrying:
  a faulty pump regulator module
  a faulty power module
  a green jumpsuit (being worn)

Your jumpsuit pocket contains:
  a clean eraser
  an unscanned instruction module
  a functional power module
  a scanner

>put functional power module in pump
(the faulty pump regulator module)
(first taking the functional power module)
That can't contain things.

>put functional power module in atmosphere pump
You put the functional power module into the atmosphere pump.

>x status
Pod bay locked down
Diagnosis: pod control atmosphere pump offline
Remediation: close pump

>close pump
(the faulty pump regulator module)
It isn't something you can close.

>close atmosphere pump
You close the atmosphere pump and it seals without any trace of a seam.

[Your score has just gone up by five points.]

>x status
Pod bay locked down
Diagnosis: launch system cooling loop offline
Remediation: reset circuit breaker 29-63/A @ Sector 2

>gonear pool
There seems to be no such object anywhere in the model world.

>gonear pond
Sector 2: Aquaculture
A deep pond serves as part of the water filtration system and for raising fish.

>purloin mask
[Purloined.]

* * *

>wear mask
You put on the emergency mask.

>go pond
WIth the air from the emergency mask, you breathe comfortably as you step into the pond. At the bottom, you find a green circuit breaker and flip it on.

[Your score has just gone up by ten points.]

>gonear status
Pod Control
This room serves as an airlock for the pod bay.

There is a secured hatch in the ceiling.

Beside the secured port hatch, a status display glows green.

You can also see an atmosphere pump here.

>x status
The status display glows green.

>look
Pod Control
This room serves as an airlock for the pod bay.

There is a secured hatch in the ceiling.

Beside the secured port hatch, a status display glows green.

You can also see an atmosphere pump here.

>port
(first opening the pod bay hatch)

Pod Bay
A open hatch leads starboard.

SInce the game isn't finished, here's some text: You notice that there are no pods left. You despair. But then you find the communications system and call for help. Someone comes.

    *** ...you have won ***

In that game you scored 25 out of a possible 50, in 43 turns.

Would you like to RESTART, RESTORE a saved game, QUIT, or UNDO the last command?

* * *

>gonear red breaker
Center Platform
It's a mesh platform a little below the hub. From here, you are very aware of how the station rotates, but everything is okay as long as you don't look down.

You can see a red circuit breaker here.

>purloin mask
[Purloined.]

>i
You are carrying:
  an emergency mask
  a green jumpsuit (being worn)

>put mask on breaker
Putting things on the red circuit breaker would achieve nothing.

>drop mask
You drop the emergency mask and it spirals off the the ground below.

* * *

>gonear red breaker
Center Platform
It's a mesh platform a little below the hub. From here, you are very aware of how the station rotates, but everything is okay as long as you don't look down.

You can see a red circuit breaker here.

>turn it on
You switch the red breaker on.

Breakers Ready Begins.

>turn it off
The red breaker seems locked on.

* * *

>gonear s3b1
Sector 3: Forest
Trees, a house, and a church. A red pylon stretches up from the ground to the hub of the station.

>in
You can enter the church or the house.

>enter church
Church
It's a church.

>look
Church
It's a church.

>out
Sector 3: Forest
Trees, a house, and a church. A red pylon stretches up from the ground to the hub of the station.

* * *

>gonear scanner
Home
The room where you've slept your entire life. You can go out towards the crops.

There is a secured hatch in the floor.

>gonear status
Pod Control
This room serves as an airlock for the pod bay.

There is a secured hatch in the ceiling.

Beside the secured port hatch, a status display shows an error message.

You can also see an atmosphere pump here.

>x status
Pod bay locked down
Diagnosis: telemetry sensor array offline
Remediation: reset breaker 36-87/A @ hub platform

>gonear red
(the red circuit breaker)
Center Platform
It's a mesh platform a little below the hub. From here, you are very aware of how the station rotates, but everything is okay as long as you don't look down.

You can just reach a red circuit breaker on the hub.

* * *

>turn red on
You switch the red circuit breaker on.

[Your score has just gone up by five points.]

>gonear status
Pod Control
This room serves as an airlock for the pod bay.

There is a secured hatch in the ceiling.

Beside the secured port hatch, a status display shows an error message.

You can also see an atmosphere pump here.

>x status
[** Programming error: tried to read (something) **]
Pod bay locked down
Diagnosis: pod control atmosphere pump offline
Remediation: scan and repair pump

* * *

>gonear sector 3
Sector 3: Forest
Trees, a house, and a church. A red pylon stretches up from the ground to the hub of the station.

>inside
You can enter the church or the house.

>s
You can't go that way.

>p
You can't go that way.

>se
You have heard of compass directions like southeast, but they don't make any sense here. Instead, you can go spinward, antispinward, port, and starboard.

When you look spinward, port is left and starboard is right. You can also use up, down, in, and out, and you can use abbreviations "sw", "asw", "p", and "s". Also, you can type "exits" if you get confused about geography.

* * *

>gonear sector 3
Sector 3: Forest
Trees, a house, and a church. A red pylon stretches up from the ground to the hub of the station.

>u
The red pylon is designated for climbing, but you still can't get a grip.

* * *

>gonear sector 5
Sector 5: Forest
A pylon stretches up from among a group of trees to the hub of the station.

The school house is nestled among the trees.

>x forest
The community grew trees for tradition, or maybe they help with air processing. You don't remember.

>x trees
The community grew trees for tradition, or maybe they help with air processing. You don't remember.

* * *

>gonear status
Pod Control
This room serves as an airlock for the pod bay.

There is a secured hatch in the ceiling.

Beside the secured port hatch, a status display shows an error message.

You can also see an atmosphere pump and a pump regulator module here.

>gonear red
Center Platform
It's a mesh platform a little below the hub. From here, you are very aware of how the station rotates, but everything is okay as long as you don't look down [1].

You can see a red circuit breaker here.

"[1]" is a footnote. You can type "note 1" to see the first footnote, or "notes" to see all footnotes so far.

>turn breaker on
You switch the red circuit breaker on.

>gonear pond
Sector 2: Aquaculture
There is a large, deep pond that serves as part of the water filtration system and is used for raising fish.

* * *

>purloin helmet
[Purloined.]

>wear it
You put on the emergency helmet.

>go pond
Since you're wearing the emergency helmet, you breath comfortably as you step into the pond. At the bottom, you find a green circuit breaker and flip it on.

>gonear status
Pod Control
The pod bay is antispinward. Beside the hatch a status display glows green.

There is a secured hatch in the ceiling.

You can also see pod bay door here.

>asw
(first opening pod bay door)

Pod Bay
You can see pod bay door here.

SInce the game isn't finished...

    *** ...you have won ***

Would you like to RESTART, RESTORE a saved game, QUIT, or UNDO the last command?

>undo
Pod Control
[Previous turn undone.]

>x door
You see nothing special about pod bay door.

>close door
That's already closed.

>open it
You open pod bay door.

>open door
That's already open.

>undo
Pod Control
[Previous turn undone.]

>undo
Pod Control
[Previous turn undone.]

* * *

>x door
You see nothing special about pod bay door.

>look
Pod Control
The pod bay is antispinward. Beside the hatch a status display glows green.

There is a secured hatch in the ceiling.

You can also see pod bay door here.

>asw
(first opening pod bay door)

Pod Bay
You can see pod bay door here.

SInce the game isn't finished...

    *** ...you have won ***

Would you like to RESTART, RESTORE a saved game, QUIT, or UNDO the last command?

* * *

>gonear status
Pod Control
This room serves as an airlock for the pod bay.

There is a secured hatch in the ceiling.

Beside the secured port hatch, a status display shows an error message.

You can also see an atmosphere pump and a pump regulator module here.

>look
Pod Control
The pod bay is antispinward. Beside the hatch a status display shows an error message.

There is a secured hatch in the ceiling.

You can also see pod bay door here.

>x door
You see nothing special about pod bay door.

>open door
It seems to be locked.

>unlock door
That's not a verb I recognize.

>unlock
That's not a verb I recognize.

* * *

>look
Pod Control
The pod bay is antispinward. Beside the hatch a status display shows an error message.

There is a secured hatch in the ceiling.

You can also see pod bay door here.

>x status
Pod bay locked down
Diagnosis: telemetry sensor array offline
Remediation: reset circuit breaker 36-87/A, location: hub maintenance platform

>read it
Diagnosis: telemetry sensor array offline
Remediation: reset circuit breaker 36-87/A, location: hub maintenance platform.

>read status
Diagnosis: telemetry sensor array offline
Remediation: reset circuit breaker 36-87/A, location: hub maintenance platform.

>search status
You find nothing of interest.

* * *

>x status
Pod bay locked down
Diagnosis: telemetry sensor array offline
Remediation: reset circuit breaker 36-87/A, location: hub maintenance platform

>x error
Pod bay locked down
Diagnosis: telemetry sensor array offline
Remediation: reset circuit breaker 36-87/A, location: hub maintenance platform

>x message
Pod bay locked down
Diagnosis: telemetry sensor array offline
Remediation: reset circuit breaker 36-87/A, location: hub maintenance platform

>look
Pod Control
The pod bay is antispinward. Beside the hatch a status display shows an error message.

There is a secured hatch in the ceiling.

>i
You are carrying:
  a green jumpsuit (being worn)

>look
Pod Control
The pod bay is antispinward. Beside the hatch a status display shows an error message.

There is a secured hatch in the ceiling.

* * *

>gonear status
Pod Control
This room serves as an airlock for the pod bay.

There is a secured hatch in the ceiling.

Beside the secured port hatch, a status display shows an error message.

You can also see an atmosphere pump and a pump regulator module here.

>open door
It seems to be locked.

>unlock door
(with the green jumpsuit)
That doesn't seem to fit the lock.

>i
You are carrying:
  a green jumpsuit (being worn)

>close door
That's already closed.

>open door
It seems to be locked.

* * *

>gonear status
Pod Control
This room serves as an airlock for the pod bay.

There is a secured hatch in the ceiling.

Beside the secured port hatch, a status display shows an error message.

You can also see an atmosphere pump and a pump regulator module here.

>open hatch
Which do you mean, the ceiling hatch or the pod bay hatch?

>gonear bed
Home
The room where you've slept your entire life. The only exit is out from here.

There is a secured hatch in the floor.

You can also see your bed here.

>d
(first opening floor hatch)
You pull yourself up through the hatch and close it behind yourself.

Below Home
Used for storage and as a decompression shelter.

There is a secured hatch in the ceiling.

There is an emergency helmet hanging on the wall.

>open hatch
You open ceiling hatch.

>showobj
That's not a verb I recognize.

>showme
Below Home - room
    ceiling hatch - floor hatch
    yourself - person
        green jumpsuit (worn)
            pocket (part of green jumpsuit) - player's holdall
    emergency helmet

* * *

>open hatch
Which do you mean, the ceiling hatch or the pod bay hatch?

>open pod bay hatch
It seems to be locked.

* * *

>open hatch
Which do you mean, the ceiling hatch or the pod bay hatch?

>showme
Pod Control - room
    the ceiling hatch - floor hatch
    yourself - person
        green jumpsuit (worn)
            pocket (part of green jumpsuit) - player's holdall
    pod bay hatch - locked door
    status display

* * *

>gonear status
Pod Control
This room serves as an airlock for the pod bay.

There is a secured hatch in the ceiling.

Beside the secured port hatch, a status display shows an error message.

You can also see an atmosphere pump and a pump regulator module here.

>scan status
Machine is failed.

*** Run-time problem P47 (at paragraph 290 in the source text): Phrase applied to an incompatible kind of value.

>x status
Pod bay locked down
Diagnosis: telemetry sensor array offline
Remediation: reset breaker 36-87/A @ hub platform

>showme status
status display - machine
location: in Pod Control
singular-named, improper-named; unlit, inedible, fixed in place, scenery; opaque, closed, unopenable, unlocked
list grouping key: none
printed name: "status display"
printed plural name: "machines"
indefinite article: none
description: none
initial appearance: none
carrying capacity: 100

>x status display
Pod bay locked down
Diagnosis: telemetry sensor array offline
Remediation: reset breaker 36-87/A @ hub platform

>scan status display
Machine is failed.

*** Run-time problem P47 (at paragraph 290 in the source text): Phrase applied to an incompatible kind of value.

>look
Pod Control
This room serves as an airlock for the pod bay.

There is a secured hatch in the ceiling.

Beside the secured port hatch, a status display shows an error message.

You can also see an atmosphere pump and a pump regulator module here.

>scan hatch
Which do you mean, the ceiling hatch or the pod bay hatch?

>ceiling
No modular technology detected.

>scan error
Machine is failed.

*** Run-time problem P47 (at paragraph 290 in the source text): Phrase applied to an incompatible kind of value.

>scan error message
Machine is failed.

*** Run-time problem P47 (at paragraph 290 in the source text): Phrase applied to an incompatible kind of value.

>scan status display
Machine is failed.

*** Run-time problem P47 (at paragraph 290 in the source text): Phrase applied to an incompatible kind of value.

* * *

>gonear status
Pod Control
This room serves as an airlock for the pod bay.

There is a secured hatch in the ceiling.

Beside the secured port hatch, a status display shows an error message.

You can also see an atmosphere pump and a pump regulator module here.

>secure hatch
That's already closed.

>open hatch
Which do you mean, the ceiling hatch or the pod bay hatch?

* * *

>ceiling
You open the ceiling hatch.

>secure hatch
You close the ceiling hatch.

>gonear read
There seems to be no such object anywhere in the model world.

>turn red on
You can't see any such thing.

>gonear red
Center Platform
It's a mesh platform a little below the hub. From here, you are very aware of how the station rotates, but everything is okay as long as you don't look down [1].

You can see a red circuit breaker here.

"[1]" is a footnote. You can type "note 1" to see the first footnote, or "notes" to see all footnotes so far.

* * *

>gonear pond
Sector 2: Aquaculture
There is a large, deep pond that serves as part of the water filtration system and is used for raising fish.

>purloin mask
There seems to be no such object anywhere in the model world.

>wear msk
You can't see any such thing.

>wear mask
You can't see any such thing.

>purloin helmet
[Purloined.]

* * *

>wear helmet
You put on the emergency helmet.

>go pond
WIth the air from the emergency helmet, you breathe comfortably as you step into the pond. At the bottom, you find a green circuit breaker and flip it on.

>gonear status
Pod Control
This room serves as an airlock for the pod bay.

There is a secured hatch in the ceiling.

Beside the secured antispinward hatch, a status display glows green.

>open hatch
Which do you mean, the ceiling hatch or the pod bay hatch?

>pod bay
You open the pod bay hatch.

>open ceiling
You open the ceiling hatch.

>secure hatch
You close the ceiling hatch.

>g
That's already closed.

>look
Pod Control
This room serves as an airlock for the pod bay.

There is a secured hatch in the ceiling.

Beside the open antispinward hatch, a status display glows green.

* * *

>gonear status
Pod Control
This room serves as an airlock for the pod bay.

There is a secured hatch in the ceiling.

Beside the secured port hatch, a status display shows an error message.

You can also see an atmosphere pump and a pump regulator module here.

>x message
Pod bay locked down
Diagnosis: telemetry sensor array offline
Remediation: reset circuit breaker 36-87/A, location: hub maintenance platform

>open pod
It seems to be locked.

>get pod
That's fixed in place.

>showme pod
(pod bay hatch)
pod bay hatch - locked door
location: in Pod Control
singular-named, proper-named; unlit, inedible, fixed in place; closed, openable, lockable, locked, apparent
list grouping key: none
printed name: "pod bay hatch"
printed plural name: "doors"
indefinite article: none
description: none
initial appearance: "Beside the secured antispinward hatch to the pod bay, a status display shows an error message."
other side: Pod Bay

>open hatch
Which do you mean, the ceiling hatch or pod bay hatch?

>ceiling
You open the ceiling hatch.

>open hatch
Which do you mean, the ceiling hatch or pod bay hatch?

>pod bay
It seems to be locked.

>look
Pod Control
It's the pod control room.

There is an open hatch in the ceiling.

Beside the secured antispinward hatch to the pod bay, a status display shows an error message.

>x hatch
Which do you mean, the ceiling hatch or pod bay hatch?

* * *

>x message
Pod bay locked down
Diagnosis: telemetry sensor array offline
Remediation: reset circuit breaker 36-87/A, location: hub maintenance platform

>x error
You can't see any such thing.

* * *

>gonear status
Pod Control
This room serves as an airlock for the pod bay.

There is a secured hatch in the ceiling.

Beside the secured port hatch, a status display shows an error message.

You can also see an atmosphere pump and a pump regulator module here.

>x status
Pod bay locked down
Diagnosis: telemetry sensor array offline
Remediation: reset breaker 36-87/A @ hub platform

>gonear red
Center Platform
It's a mesh platform a little below the hub. From here, you are very aware of how the station rotates, but everything is okay as long as you don't look down [1].

You can see a red circuit breaker here.

"[1]" is a footnote. You can type "note 1" to see the first footnote, or "notes" to see all footnotes so far.

* * *

>wear mask
You put on the emergency mask.

>go water
WIth the air from the emergency mask, you breathe comfortably as you step into the pond. At the bottom, you find a green circuit breaker and flip it on.

>gonear status
Pod Control
This room serves as an airlock for the pod bay.

There is a secured hatch in the ceiling.

Beside the secured port hatch, a status display glows green.

>x display
The status display glows green.

>port
(first opening the pod bay hatch)

Pod Bay
A open hatch leads starboard.

SInce the game isn't finished...

    *** ...you have won ***

Would you like to RESTART, RESTORE a saved game, QUIT, or UNDO the last command?

>restart
You awake. You are lonely, so lonely. It was a thousand days ago today. All alone these thousand days. Your parents were the last. No, your father was the last. He held on for nearly a hundred days longer than your mother. No, you are the last. Alone. Adrift.

But maybe it isn't hopeless. There must still be some people in other worlds, and you think you know how to get there.

Today is the day.

Green
An Interactive Space Story by Thomas Insel
Release 1 / Serial number 181119 / Inform 7 build 6M62 (I6/v6.33 lib 6/12N) SD
Type "about" for credits and more information.

Home (on your bed)
The room where you've slept your entire life. The only exit is out from here.

There is a secured hatch in the floor.

>d
(first getting off your bed)
(first opening the floor hatch)
You scramble down through the hatch and close it behind yourself.

Below Home
This space is used for storage and as a decompression shelter.

There is a secured hatch in the ceiling.

There is an emergency mask hanging on the wall.

* * *

>out
Sector 4: Crops
You are in sector 4.

Your home is here among the crops.

>in
Home
The room where you've slept your entire life. The only exit is out from here.

There is a secured hatch in the floor.

You can also see your bed here.

>out
Sector 4: Crops
You are in sector 4.

Your home is here among the crops.

* * *

>asw
You walk a little ways to the next sector.

Sector 3: Forest
Trees, two homes, and a church. A red pylon stretches up from the ground to the hub of the station.

>i
You are carrying:
  a green jumpsuit (being worn)

>x jumpsuit
You have worn jumpsuits like this since you were small. Originally, the colors had meanings: green for farmers, blue for technicians, and so on, but that distinction died even before the population.

It features a single large pocket, currently empty.

* * *

>x status
Pod bay locked down
Diagnosis: telemetry sensor array offline
Remediation: reset breaker 36-87/A @ hub platform

>out
But you aren't in anything at the moment.

>u
(first opening the ceiling hatch)
You scramble down through the hatch and close it behind yourself.

Sector 1: Crops
You maintain the crops in this sector. A pylon stretches up from the ground to the hub of the station.

There is a secured hatch in the floor.

>d
(first opening the floor hatch)
You pull yourself up through the hatch and close it behind yourself.

Pod Control
This room serves as an airlock for the pod bay.

There is a secured hatch in the ceiling.

Beside the secured antispinward hatch, a status display shows an error message.

* * *

>gonear status display
Pod Control
This room serves as an airlock for the pod bay.

There is a secured hatch in the ceiling.

Beside the secured port hatch, a status display shows an error message.

You can also see an atmosphere pump here.

>x display
display.

>x pump
It is a smooth featureless box.

* * *

>gonear trees
Sector 3: Forest
Trees, a house, and a church. A red pylon stretches up from the ground to the hub of the station.

>x trees
Trees.

>climb trees
Little is to be achieved by that.

* * *

>i
You are carrying:
  a scanner
  a green jumpsuit (being worn)

>x jumpsuit
You have worn jumpsuits like this since you were small. Originally, the colors had meanings: green for farmers, blue for technicians, and so on, but that distinction died even before the population.

It features a single large pocket, currently empty.

>about
About Green
Green is my second released Inform project, conceived and implemented over a few weeks in the fall of 2018.

Please send your feedback, bug reports, and requests for help to tinsel@tinsel.org. You can always find the current version of this game at http://tinsel.org/IF/ .

This work is Copyright  2017 Thomas Insel but may be freely shared according to the terms of the Creative Commons Attribution 4.0 International license (https://creativecommons.org/licenses/by/4.0/).

* * *

>i
You are carrying:
  a scanner
  a green jumpsuit (being worn)

>purloin testament
[Purloined.]

>drop it
Dropped.

>purloin mask
[Purloined.]

>drop it
Dropped.

>purloin boots
[Purloined.]

>purloin eraser
[Purloined.]

>drop all
clean eraser: Dropped.
pair of gravity boots: Dropped.

>i
You are carrying:
  a green jumpsuit (being worn)

>look
Home
The room where you've slept your entire life. The only exit is out from here.

There is a secured hatch in the floor.

You can also see some pair of gravity boots, a clean eraser, an emergency mask, and The Founder's Testament here.

>get boots
Taken.

>get eraser
Taken.

>i
You are carrying:
  a clean eraser
  some pair of gravity boots
  a green jumpsuit (being worn)

>get mask
Taken.

>i
You are carrying:
  an emergency mask
  a clean eraser
  some pair of gravity boots
  a green jumpsuit (being worn)

>get testament
You're carrying too many things already.

>x pocket
The pocket is empty.

>i
You are carrying:
  an emergency mask
  a clean eraser
  some pair of gravity boots
  a green jumpsuit (being worn)

* * *

>i
You are carrying:
  a scanner
  a green jumpsuit (being worn)

>x scanner
The handheld voice-activated scanner that you use to scan electronic modules on the station.

[You can ask the scanner for a list of commands by typing "scanner, help" and give it commands by typing things like "scanner, scan SOMETHING" where SOMETHING is a visible object. As a special abbreviation, you can type "scan SOMETHING".]

>scanner, scan me
No modular technology detected.

>scanner, help
[That command asks to do something outside of play, so it can only make sense from you to me. The scanner cannot be asked to do this.]

>look
Home
The room where you've slept your entire life. You can go out towards the crops.

There is a secured hatch in the floor.

>d
(first opening the floor hatch)
You scramble down through the hatch and close it behind yourself.

Cellar
This space is used for storage and as a decompression shelter.

There is a secured hatch in the ceiling.

There is an emergency mask hanging on the wall.

>scanner, scan mask
No modular technology detected.

* * *

>listobj
Founder's Testament
Hydroponics machines (F) (S)
Laser beam (F) (S)
Maintenance platform (F) (S)
Mirrors (F) (S)
Solar panels (F) (S)
altar (F)
blue circuit breaker (F)
chalkboard (F)
clean eraser
crate of machine parts (F) (S)
crops (F) (S)
desk (F)
emergency mask
fish (F) (S)
graveyard (F) (S)
green circuit breaker (F)
green jumpsuit
hub (F) (S)
light-meter (F) (S)
pair of gravity boots
pens (F) (S)
pocket (P)
pod bay hatch (F)
pond (F) (S)
red circuit breaker (F)
some trees (F) (S)
some trees (F) (S)
space suit (F) (S)
status display (F) (S)
the church (F) (S)
the floor hatch (F)
the floor hatch (F)
the floor hatch (F)
the house (F) (S)
the pylon (F) (S)
the pylon (F) (S)
the pylon (F) (S)
the pylon (F) (S)
the school building (F)
vegetables (F) (S)
your home (F) (S)
yourself

>gonear altar
Church
Before everyone left or died, you celebrated every sabbath here.

The altar stands against the far wall.

On the altar is The Founder's Testament.

>analyze testament
examining the Founder's Testament:
The Founder's Testament tells the story of how your people left Old Earth and first settled the station. You know the story by heart, and have already derived whatever comfort you can from this book.

looking under the Founder's Testament:
You find nothing of interest.

searching the Founder's Testament:
You find nothing of interest.

listening to the Founder's Testament:
You hear nothing unexpected.

smelling the Founder's Testament:
You smell nothing unexpected.

attacking the Founder's Testament:
Violence isn't the answer to this one.

buying the Founder's Testament:
Nothing is on sale.

climbing the Founder's Testament:
Little is to be achieved by that.

pulling the Founder's Testament:
Nothing obvious happens.

pushing the Founder's Testament:
Nothing obvious happens.

turning the Founder's Testament:
Nothing obvious happens.

pushing the Founder's Testament to outside:
The Founder's Testament cannot be pushed from place to place.

opening the Founder's Testament:
It isn't something you can open.

entering the Founder's Testament:
That's not something you can enter.

getting off the Founder's Testament:
But you aren't on the Founder's Testament at the moment.

closing the Founder's Testament:
It isn't something you can close.

taking the Founder's Testament:
Taken.

switching on the Founder's Testament:
It isn't something you can switch.

switching off the Founder's Testament:
It isn't something you can switch.

wearing the Founder's Testament:
You can't wear that!

taking off the Founder's Testament:
You aren't wearing the Founder's Testament.

(no other people in the location; can't test throwing at.)

(no other people in the location; can't test showing to.)

(no other people in the location; can't test giving to.)

touching the Founder's Testament:
You feel nothing unexpected.

rubbing the Founder's Testament:
You rub the Founder's Testament.

waving the Founder's Testament:
You wave the Founder's Testament.

squeezing the Founder's Testament:
You achieve nothing by this.

burning the Founder's Testament:
This dangerous act would achieve little.

cutting the Founder's Testament:
Cutting it up would achieve little.

tying the Founder's Testament to the altar:
You would achieve nothing by this.

swinging the Founder's Testament:
There's nothing sensible to swing here.

tasting the Founder's Testament:
You taste nothing unexpected.

drinking the Founder's Testament:
There's nothing suitable to drink here.

eating the Founder's Testament:
That's plainly inedible.

dropping the Founder's Testament:
Dropped.

* * *

>look
Home
The room where you've slept your entire life. The only exit is out from here.

There is a secured hatch in the floor.

>out
Sector 4: Crops
Your home is here among the crops.

>x crops
Greens, carrots, and potatoes.

>eat carrots
You're not hungry now.

>sw
You walk a little ways to the next sector.

Sector 5: Forest
A pylon stretches up from among a group of trees to the hub of the station.

The school house is nestled among the trees.

>x house
It's little and red. Apparently, that is the traditional marking of a school building.

* * *

>onear red
That's not a verb I recognize.

>gonear red
(the red circuit breaker)
Center Platform
It's a mesh platform a little below the hub. From here, you are very aware of how the station rotates, but everything is okay as long as you don't look down.

You can just reach a red circuit breaker on the hub.

* * *

>gonear status
Pod Control
This room serves as an airlock for the pod bay.

There is a secured hatch in the ceiling.

Beside the secured port hatch, a status display shows an error message.

You can also see an atmosphere pump here.

>x status
Pod bay locked down
Diagnosis: pod control atmosphere pump offline
Remediation: scan and repair pump

* * *

>out
Sector 4: Crops
Your home is here among the crops.

* * *

>asw
You walk a little ways to the next sector.

Sector 3: Forest
Trees, a house, and a church. A red pylon stretches up from the ground to the hub of the station.

>asw
You walk a little ways to the next sector.

Sector 2: Aquaculture
A deep pond serves as part of the water filtration system and for raising fish.

* * *

>asw
You walk a little ways to the next sector.

Sector 8: Crops
You still maintain the crops here, and there is a small graveyard.

>sw
You walk a little ways to the next sector.

Sector 1: Crops
This sector is fallow for a cycle. A pylon stretches up from the ground to the hub of the station.

There is a secured hatch in the ground.

>d
(first opening the floor hatch)
You scramble down through the hatch and close it behind yourself.

Pod Control
This room serves as an airlock for the pod bay.

There is a secured hatch in the ceiling.

Beside the secured port hatch, a status display shows an error message.

>x error
Pod bay locked down
Diagnosis: telemetry sensor array offline
Remediation: reset breaker 36-87/A @ hub platform

>restart
Are you sure you want to restart?

* * *

>out
Sector 4: Crops
Your home is here among the crops.

* * *

>x crops
Greens, carrots, and potatoes.

>sw
You walk a little ways to the next sector.

Sector 5: Forest
A pylon stretches up from among a group of trees to the hub of the station.

The school house is nestled among the trees.

>x trees
The community grew trees for tradition, or maybe they help with air processing. You don't remember.

>sw
You walk a little ways to the next sector.

Sector 6: Hydroponics
Your people prefered to grow things the old fashioned way, but in truth the majority of your fruit and vegetables came from this sector when the machines still worked.

There is a secured hatch in the ground.

>x vegetables
You can't see any such thing.

>sw
You walk a little ways to the next sector.

Sector 7: Livestock
There are pens left from when this was the livestock sector, but no animals. A pylon stretches up from the ground to the hub of the station.

>sw
You walk a little ways to the next sector.

Sector 8: Crops
You still maintain the crops here, and there is a small graveyard.

* * *

>sw
You walk a little ways to the next sector.

Sector 1: Crops
This sector is fallow for a cycle. A pylon stretches up from the ground to the hub of the station.

There is a secured hatch in the ground.

>asw
You walk a little ways to the next sector.

Sector 8: Crops
You still maintain the crops here, and there is a small graveyard.

>x graveyard
Fenced off but unmarked graves. You buried your parents here.

>x graves
Fenced off but unmarked graves. You buried your parents here.

>x grave
Fenced off but unmarked graves. You buried your parents here.

>x fence
You can't see any such thing.

* * *

>asw
You walk a little ways to the next sector.

Sector 2: Aquaculture
A deep pond serves as part of the water filtration system and for raising fish.

>sw
You walk a little ways to the next sector.

Sector 3: Forest
Trees, a house, and a church. A red pylon stretches up from the ground to the hub of the station.

* * *

>sw
You walk a little ways to the next sector.

Sector 5: Forest
A pylon stretches up from among a group of trees to the hub of the station.

The school house is nestled among the trees.

>go school
School
You had learning machines once. After they broke, some of the older farmers took turns leading the class, eventually just you, in lessons.

There is a chalkboard on the wall.

You can also see a desk (on which is a clean eraser) here.

>look
School
You had learning machines once. After they broke, some of the older farmers took turns leading the class, eventually just you, in lessons.

There is a chalkboard on the wall.

You can also see a desk (on which is a clean eraser) here.

>x school
You can't see any such thing.

>x room
You can't see any such thing.

>x here
You can't see any such thing.

>x board
The board is covered in your old arithmetic work.

>x wall
You can't see any such thing.

>x eraser
A clean eraser.

>x board
The board is covered in your old arithmetic work.

>look
School
You had learning machines once. After they broke, some of the older farmers took turns leading the class, eventually just you, in lessons.

There is a chalkboard on the wall.

You can also see a desk (on which is a clean eraser) here.

>x desk
You wrote your lessons at this desk. Your people were practical, plain folk, so you learned practical things in school: reading, writing, arithmetic. More importantly, practical mechanics and farming. There wasn't too much time for history, if they even remembered it.

On the desk is a clean eraser.

>ne
You have heard of compass directions like northeast, but they don't make any sense here. Instead, you can go spinward, antispinward, port, and starboard.

When you look spinward, port is left and starboard is right. You can also use up, down, in, and out, and you can use abbreviations "sw", "asw", "p", and "s". Also, you can type "exits" if you get confused about geography.

* * *

>asw
You walk a little ways to the next sector.

Sector 3: Forest
Trees, a house, and a church. A red pylon stretches up from the ground to the hub of the station.

>purloin boots
[Purloined.]

* * *

>wear boots
You put on the pair of gravity boots.

>u
It isn't easy, but with the boots, you are able to climb towards the hub.

>look
Sector 3: Forest
Trees, a house, and a church. A red pylon stretches up from the ground to the hub of the station.

* * *

>wear boots
You put on the pair of gravity boots.

>up
It isn't easy, but with the boots, you are able to climb towards the hub.

Center Platform
It's a mesh platform a little below the hub. From here, you are very aware of how the station rotates, but everything is okay as long as you don't look down.

You can just reach a red circuit breaker on the hub.

>x breaker
The red circuit breaker is currently switched off.

>look at breaker
The red circuit breaker is currently switched off.

>turn breaker on
You switch the red circuit breaker on.

>d
You climb down the pylon.

Sector 3: Forest
Trees, a house, and a church. A red pylon stretches up from the ground to the hub of the station.

>look
Sector 3: Forest
Trees, a house, and a church. A red pylon stretches up from the ground to the hub of the station.

* * *

>u
The red pylon is designated for climbing, but you still can't get a grip.

>climb pylon
The red pylon is designated for climbing, but you still can't get a grip.

>acctions
That's not a verb I recognize.

>actions
Actions listing on.

>up
[going up]
[(1) climbing the pylon]
The red pylon is designated for climbing, but you still can't get a grip.
[(1) climbing the pylon - ended without result]

[going up - ended without result]

* * *

>u
The red pylon is designated for climbing, but you still can't get a grip.

>gonear read breaker
There seems to be no such object anywhere in the model world.

>gonear red breaker
Center Platform
It's a mesh platform a little below the hub. From here, you are very aware of how the station rotates, but everything is okay as long as you don't look down.

You can just reach a red circuit breaker on the hub.

>d
You slide down the pylon.

Sector 3: Forest
Trees, a house, and a church. A red pylon stretches up from the ground to the hub of the station.

>exits
The obvious exits are up (to center platform), spinward (to sector 4) and antispinward.

[Type "exits off" to disable the status line exit list and "exits on" to turn it back on.]

>exits
The obvious exits are up (to center platform), spinward (to sector 4) and antispinward.

* * *

>asw
You walk a little ways to the next sector.

Sector 3: Forest
Trees, a house, and a church. A red pylon stretches up from the ground to the hub of the station.

>x house
What looks like whitewashed siding is really a lightweight plastic.

>enter house
House
Two families lived here, but not recently.

>look
House
Two families lived here, but not recently.

>asw
You can't go that way.

>out
Sector 3: Forest
Trees, a house, and a church. A red pylon stretches up from the ground to the hub of the station.

>asw
You walk a little ways to the next sector.

Sector 2: Aquaculture
A deep pond serves as part of the water filtration system and for raising fish.

>x fish
There are still a few fish swimming in the pond, but they taste horrible.

>asw
You walk a little ways to the next sector.

Sector 1: Crops
This sector is fallow for a cycle. A pylon stretches up from the ground to the hub of the station.

There is a secured hatch in the ground.

* * *

>asw
You walk a little ways to the next sector.

Sector 8: Crops
You still maintain the crops here, and there is a small graveyard.

>asw
You walk a little ways to the next sector.

Sector 7: Livestock
There are pens left from when this was the livestock sector, but no animals. A pylon stretches up from the ground to the hub of the station.

* * *

>asw
You walk a little ways to the next sector.

Sector 6: Hydroponics
Your people prefered to grow things the old fashioned way, but in truth the majority of your fruit and vegetables came from this sector when the machines still worked.

There is a secured hatch in the ground.

>asw
You walk a little ways to the next sector.

Sector 5: Forest
A pylon stretches up from among a group of trees to the hub of the station.

The school house is nestled among the trees.

You have walked the entire ring. Everything is as expected, much is not working. Now, it's time to leave. The pods are below Sector 1.

>asw
You walk a little ways to the next sector.

Sector 4: Crops
Your home is here among the crops.

>x home
You were told it was built to look like a log cabin on Old Earth.

>x crops
Greens, carrots, and potatoes.

* * *

>x trees
The community grew trees for tradition, or maybe they help with air processing. You don't remember.

>get trees
They're hardly portable.

>asw
You walk a little ways to the next sector.

Sector 4: Crops
Your home is here among the crops.

* * *

>asw
You walk a little ways to the next sector.

Sector 3: Forest
Trees, a house, and a church. A red pylon stretches up from the ground to the hub of the station.

>restart
Are you sure you want to restart?

>yes
You awake. You are lonely, so lonely. It was a thousand days ago today. All alone these thousand days. Your parents were the last. No, your father was the last. He held on for nearly a hundred days longer than your mother. No, you are the last. Alone. Adrift.

But maybe it isn't hopeless. There must still be some people in other worlds, and you think you know how to get there.

Today is the day.

Green
A Space Story by Thomas Insel
Release 1 / Serial number 181120 / Inform 7 build 6M62 (I6/v6.33 lib 6/12N) SD
Type "about" for credits and more information.

Home
The room where you've slept your entire life. The only exit is out from here.

There is a secured hatch in the floor.

>out
Sector 4: Crops
Your home is here among the crops.

* * *

>asw
You walk a little ways to the next sector.

Sector 3: Forest
Trees, a house, and a church. A red pylon stretches up from the ground to the hub of the station.

>up
The red pylon is designated for climbing, but you still can't get a grip.

>asw
You walk a little ways to the next sector.

Sector 2: Aquaculture
A deep pond serves as part of the water filtration system and for raising fish.

>up
You can't go that way.

* * *

>asw
You walk a little ways to the next sector.

Sector 3: Forest
Trees, a house, and a church. A red pylon stretches up from the ground to the hub of the station.

>x hub
The station rotates around the hub, which extends out to hold solar panels on the starboard side. On the inside, there is a mesh maintenance platform.

>x panel
The primary source of station power.

>x platform
The station rotates around the hub, which extends out to hold solar panels on the starboard side. On the inside, there is a mesh maintenance platform.

* * *

>out
Sector 4: Crops
Your home is here among the crops.

>d
(first opening the floor hatch)
You pull yourself up through the hatch and close it behind yourself.

Below Home
Used for storage and as a decompression shelter.

There is a secured hatch in the ceiling.

There is an emergency helmet hanging on the wall.

>get all
emergency helmet: Taken.

>i
You are carrying:
  an emergency helmet
  a green jumpsuit (being worn)

>x jumpsuit
You have worn jumpsuits like this since you were small. Originally, the colors had meanings: green for farmers, blue for technicians, and so on, but that distinction died even before the population.

It features a single large pocket, currently empty.

>x helmet
You used to wear a helmet like this when there were decompression drills every twenty days.

>x pocket
The pocket is empty.

>x jumpsuit pocket
I only understood you as far as wanting to examine the green jumpsuit.

>x pocket
The pocket is empty.

* * *

>d
(first opening the floor hatch)
You pull yourself up through the hatch and close it behind yourself.

Below Home
Used for storage and as a decompression shelter.

There is a secured hatch in the ceiling.

There is an emergency helmet hanging on the wall.

>out
But you aren't in anything at the moment.

>u
(first opening the ceiling hatch)
You scramble down through the hatch and close it behind yourself.

Home
The room where you've slept your entire life. The only exit is out from here.

There is a secured hatch in the floor.

You can also see your bed here.

>out
Sector 4: Crops
You are in sector 4.

Your home is here among the crops. You were told it was built to look like a log cabin on Old Earth.

>spinward
You walk a little ways to the next sector.

Sector 5: Forest
A group of trees. A pylon stretches up from the ground to the jub of the station.

The school house is nestled among the trees.

* * *

>out
Sector 4: Crops
Your home is here among the crops.

>out
But you aren't in anything at the moment.

>asw
You walk a little ways to the next sector.

Sector 3: Forest
Trees, a house, and a church. A red pylon stretches up from the ground to the hub of the station.

>asw
You walk a little ways to the next sector.

Sector 2: Aquaculture
There is a large, deep pond that serves as part of the water filtration system and is used for raising fish.

>asw
You walk a little ways to the next sector.

Sector 1: Crops
You are in sector 1. A pylon stretches up from the ground to the hub of the station.

There is a secured hatch in the floor.

>asw
You walk a little ways to the next sector.

Sector 8: Crops
You are in sector 8.

>asw
You walk a little ways to the next sector.

Sector 7: Livestock
You are in sector 7. A pylon stretches up from the ground to the hub of the station.

>asw
You walk a little ways to the next sector.

Sector 6: Hydroponics
Your people prefered to grow things the old fashioned way, but in truth the majority of your fruit and vegetables came from this sector when the machines still worked.

You can go down.

>asw
You walk a little ways to the next sector.

Sector 5: Forest
You are in sector 5. A pylon stretches up from the ground to the jub of the station.

The school house is nestled among the trees.

>in
School
You had learning machines once. After they broke, some of the older farmers took turns leading the class, then just you, in lessons.

There is a chalkboard on the wall.

You can also see a desk (on which is a clean eraser) here.

>get eraser
Taken.

* * *

>erase board
(with the eraser)
You carefully erase the chalkboard.

>out
Sector 5: Forest
You are in sector 5. A pylon stretches up from the ground to the jub of the station.

The school house is nestled among the trees.

>sw
You walk a little ways to the next sector.

Sector 6: Hydroponics
Your people prefered to grow things the old fashioned way, but in truth the majority of your fruit and vegetables came from this sector when the machines still worked.

You can go down.

>sw
You walk a little ways to the next sector.

Sector 7: Livestock
You are in sector 7. A pylon stretches up from the ground to the hub of the station.

>sw
You walk a little ways to the next sector.

Sector 8: Crops
You are in sector 8.

>sw
You walk a little ways to the next sector.

Sector 1: Crops
You are in sector 1. A pylon stretches up from the ground to the hub of the station.

>sw
You walk a little ways to the next sector.

Sector 2: Aquaculture
There is a large pond that serves as part of the water filtration system and is used for raising fish.

>sw
You walk a little ways to the next sector.

Sector 3: Forest
Trees, two homes, and a church. A red pylon stretches up from the ground to the hub of the station.

>climb pylon
The red pylon is designated for climbing, but you still can't get a grip.

>s
You can't go that way.

>sw
You walk a little ways to the next sector.

Sector 4: Crops
You are in sector 4.

Your home is here. You were told it was built to look like a log cabin on Old Earth.

>sw
You walk a little ways to the next sector.

Sector 5: Forest
You are in sector 5. A pylon stretches up from the ground to the jub of the station.

The school house is nestled among the trees.

>sw
You walk a little ways to the next sector.

Sector 6: Hydroponics
Your people prefered to grow things the old fashioned way, but in truth the majority of your fruit and vegetables came from this sector when the machines still worked.

You can go down.

* * *

>sw
You walk a little ways to the next sector.

Sector 7: Livestock
You are in sector 7. A pylon stretches up from the ground to the hub of the station.

>asw
You walk a little ways to the next sector.

Sector 6: Hydroponics
Your people prefered to grow things the old fashioned way, but in truth the majority of your fruit and vegetables came from this sector when the machines still worked.

You can go down.

>d
Supply Vault
This fortified room is like a tomb: dim, quiet, stuffy. The only exit is a small passageway up.

You can see some pair of gravity boots here.

>get boots
Taken.

>u
An alarm sounds and you jump back as a gate slams shut across the passageway. It quickly retracts.

>hit eraser
You fill the room with a cloud of dust and you can now see a laser beam scanning across the passageway.

>u
You maneuver around the laser beam.

Sector 6: Hydroponics
Your people prefered to grow things the old fashioned way, but in truth the majority of your fruit and vegetables came from this sector when the machines still worked.

You can go down.

>sw
You walk a little ways to the next sector.

Sector 7: Livestock
You are in sector 7. A pylon stretches up from the ground to the hub of the station.

* * *

>sw
You walk a little ways to the next sector.

Sector 3: Forest
Trees, two homes, and a church. A red pylon stretches up from the ground to the hub of the station.

>up
The red pylon is designated for climbing, but you still can't get a grip.

>i
You are carrying:
  some pair of gravity boots
  a dusty eraser
  a green jumpsuit (being worn)

>wear boots
You put on the pair of gravity boots.

>u
It isn't easy, but with the boots, you are able to climb towards the hub.

Center Platform
It's a mesh platform a little below the hub. From here, you are very aware of how the station rotates, but everything is okay as long as you don't look down [1].

You can see a red breaker here.

"[1]" is a footnote. You can type "note 1" to see the first footnote, or "notes" to see all footnotes so far.

>flip red breaker
That's not a verb I recognize.

>turn red breaker off
That's already off.

>turn red breaker on
You switch the red breaker on.

Breakers Ready Begins.

>turn red breaker off
You switch the red breaker off.

>undo
Center Platform
[Previous turn undone.]

* * *

>asw
You walk a little ways to the next sector.

Sector 1: Crops
You are in sector 1. A pylon stretches up from the ground to the hub of the station.

There is a secured hatch in the floor.

>d
(first opening floor hatch)
You pull yourself up through the hatch and close it behind yourself.

Pod Control
Used for todo.

There is a secured hatch in the ceiling.

You can also see a status display here.

>x display
You see nothing special about the status display.

* * *

>asw
You walk a little ways to the next sector.

Sector 2: Aquaculture
There is a large, deep pond that serves as part of the water filtration system and is used for raising fish.

>x fish
There are still a few fish swimming in the pond, but they taste horrible.

>get fish
The fish aren't easy to catch.

>eat fish
The fish aren't easy to catch.

>x water
Something to do with water filtration, and there are still some fish.

>x fish
There are still a few fish swimming in the pond, but they taste horrible.

* * *

>get fish
The fish aren't easy to catch.

>sw
You walk a little ways to the next sector.

Sector 3: Forest
Trees, a house, and a church. A red pylon stretches up from the ground to the hub of the station.

* * *

>sw
You walk a little ways to the next sector.

Sector 4: Crops
Your home is here among the crops.

>sw
You walk a little ways to the next sector.

Sector 5: Forest
A group of trees. A pylon stretches up from the ground to the jub of the station.

The school house is nestled among the trees.

* * *

>sw
You walk a little ways to the next sector.

Sector 7: Livestock
There are pens left from when this was the livestock sector, but nothing is left now. A pylon stretches up from the ground to the hub of the station.

>x pens
There are no animals left.

>look
Sector 7: Livestock
There are pens left from when this was the livestock sector, but nothing is left now. A pylon stretches up from the ground to the hub of the station.

* * *

>out
But you aren't in anything at the moment.

>d
You can't go that way.

* * *

>in
Home
The room where you've slept your entire life. The only exit is out from here.

There is a secured hatch in the floor.

You can also see your bed here.

>d
(first opening floor hatch)
You pull yourself up through the hatch and close it behind yourself.

Below Home
Used for storage and as a decompression shelter.

There is a secured hatch in the ceiling.

You can also see an emergency helmet here.

>x helmet
You see nothing special about the emergency helmet.

>wear hemet
You can't see any such thing.

>wear helmet
(first taking the emergency helmet)
You put on the emergency helmet.

>gonear pond
There seems to be no such object anywhere in the model world.

>u
(first opening floor hatch)
You scramble down through the hatch and close it behind yourself.

Home
The room where you've slept your entire life. The only exit is out from here.

There is a secured hatch in the floor.

You can also see your bed here.

>u
You can't go that way.

>out
Sector 4: Crops
You are in sector 4.

Your home is here. You were told it was built to look like a log cabin on Old Earth.

>asw
You walk a little ways to the next sector.

Sector 3: Forest
Trees, two homes, and a church. A red pylon stretches up from the ground to the hub of the station.

>asw
You walk a little ways to the next sector.

Sector 2: Aquaculture
There is a large pond that serves as part of the water filtration system and is used for raising fish.

>x pond
You can't see any such thing.

* * *

>out
But you aren't in anything at the moment.

>sw
You walk a little ways to the next sector.

Sector 5: Forest
A pylon stretches up from among a group of trees to the hub of the station.

The school house is nestled among the trees.

>in
School
You had learning machines once. After they broke, some of the older farmers took turns leading the class, eventually just you, in lessons.

There is a chalkboard on the wall.

You can also see a learning machine and a desk (on which is a clean eraser) here.

>get eraser
Taken.

* * *

>out
Sector 5: Forest
You are in sector 5. A pylon stretches up from the ground to the jub of the station.

The school house is nestled among the trees.

>sw
You walk a little ways to the next sector.

Sector 6: Hydroponics
Your people prefered to grow things the old fashioned way, but in truth the majority of your fruit and vegetables came from this sector when the machines still worked.

You can go down.

There is a secured hatch in the floor.

>d
(first opening floor hatch)
You pull yourself up through the hatch and close it behind yourself.

Below Sector 6
It's room. You can go up or spinward.

There is a secured hatch in the ceiling.

>sw
Supply Vault
This room is dim, quiet, and stuffy. The only exit is antispinward.

You can see some pair of gravity boots here.

>get boots
Taken.

>hit eraser
You fill the room with a cloud of dust and you can now see a laser beam scanning across the passageway.

>asw
You maneuver around the laser beam.

Below Sector 6
It's room. You can go up or spinward.

There is a secured hatch in the ceiling.

>u
(first opening floor hatch)
You scramble down through the hatch and close it behind yourself.

Sector 6: Hydroponics
Your people prefered to grow things the old fashioned way, but in truth the majority of your fruit and vegetables came from this sector when the machines still worked.

You can go down.

There is a secured hatch in the floor.

>sw
You walk a little ways to the next sector.

Sector 7: Livestock
You are in sector 7. A pylon stretches up from the ground to the hub of the station.

* * *

>sw
You walk a little ways to the next sector.

Sector 3: Forest
Trees, two homes, and a church. A red pylon stretches up from the ground to the hub of the station.

>u
The red pylon is designated for climbing, but you still can't get a grip.

>flip breaker
That's not a verb I recognize.

>turn breaker on
You can't see any such thing.

>wear boots
You put on the pair of gravity boots.

* * *

>u
It isn't easy, but with the boots, you are able to climb towards the hub.

Center Platform
It's a mesh platform a little below the hub. From here, you are very aware of how the station rotates, but everything is okay as long as you don't look down [1].

You can see a red breaker here.

"[1]" is a footnote. You can type "note 1" to see the first footnote, or "notes" to see all footnotes so far.

>turn on breaker
You switch the red breaker on.

Breakers Ready Begins.

>quit
Are you sure you want to quit?

* * *

>in
School
You had learning machines once. After they broke, some of the older farmers took turns leading the class, eventually just you, in lessons.

There is a chalkboard on the wall.

You can also see a learning machine and a desk (on which is a clean eraser) here.

>x machine
The learning machine broke when you were maybe three thousand days old.

>scan learning machine
Machine is failed.

>scanner, open learning machine
Opening.

The learning machine swings open.

>x machine
The learning machine broke when you were maybe three thousand days old.

In the learning machine are a power module and an instruction module.

>look
School
You had learning machines once. After they broke, some of the older farmers took turns leading the class, eventually just you, in lessons.

There is a chalkboard on the wall.

You can also see a learning machine (in which are a power module and an instruction module) and a desk (on which is a clean eraser) here.

>get all
power module: Taken.
instruction module: Taken.
clean eraser: (putting the scanner into your pocket to make room)
Taken.

>x power module
It is a standardized machine component.

>scan power module
You must be holding the scanner to use it.

>i
You are carrying:
  a clean eraser
  an instruction module
  a power module
  a green jumpsuit (being worn)

Your jumpsuit pocket contains:
  a scanner

>get scanner
(putting the power module into your pocket to make room)
Taken.

* * *

>sw
You walk a little ways to the next sector.

Sector 6: Hydroponics
Your people prefered to grow things the old fashioned way, but in truth the majority of your fruit and vegetables came from this sector when the machines still worked.

There is a secured hatch in the ground.

>d
(first opening the floor hatch)
You scramble down through the hatch and close it behind yourself.

Below Sector 6
There's nothing distinctive about this small room. You can go up or spinward.

There is a secured hatch in the ceiling.

>sw
Supply Vault
This room is dim, quiet, and stuffy. There is still a crate of machine parts left. The only exit is antispinward.

You can see some pair of gravity boots here.

>asw
Below Sector 6
There's nothing distinctive about this small room. You can go up or spinward.

There is a secured hatch in the ceiling.

>sw
Supply Vault
This room is dim, quiet, and stuffy. The only exit is antispinward.

You can see some pair of gravity boots here.

* * *

>get boots
Taken.

>asw
Below Sector 6
It's room. You can go up or spinward.

There is a secured hatch in the ceiling.

* * *

>asw
Below Sector 6
There's nothing distinctive about this small room. You can go up or spinward.

There is a secured hatch in the ceiling.

>u
(first opening the ceiling hatch)
You pull yourself up through the hatch and close it behind yourself.

Sector 6: Hydroponics
Your people prefered to grow things the old fashioned way, but in truth the majority of your fruit and vegetables came from this sector when the machines still worked.

There is a secured hatch in the ground.

>sw
You walk a little ways to the next sector.

Sector 7: Livestock
There are pens left from when this was the livestock sector, but no animals. A pylon stretches up from the ground to the hub of the station.

* * *

>sw
You walk a little ways to the next sector.

Sector 8: Crops
You still maintain the crops here, and there is a small graveyard.

>x graveyard
Fenced off but unmarked graves. You buried your parents here yourself.

>x crops
Grain and legumes.

>sw
You walk a little ways to the next sector.

Sector 1: Crops
This sector is fallow for a cycle. A pylon stretches up from the ground to the hub of the station.

There is a secured hatch in the ground.

* * *

>asw
You walk a little ways to the next sector.

Sector 8: Crops
You still maintain the crops here, and there is a small graveyard.

>get grains
You can't see any such thing.

>get grain
They're hardly portable.

>get legumes
They're hardly portable.

>asw
You walk a little ways to the next sector.

Sector 7: Livestock
There are pens left from when this was the livestock sector, but no animals. A pylon stretches up from the ground to the hub of the station.

>sw
You walk a little ways to the next sector.

Sector 8: Crops
You still maintain the crops here, and there is a small graveyard.

* * *

>sw
You walk a little ways to the next sector.

Sector 1: Crops
This sector is fallow for a cycle. A pylon stretches up from the ground to the hub of the station.

There is a secured hatch in the ground.

>sw
You walk a little ways to the next sector.

Sector 2: Aquaculture
A deep pond serves as part of the water filtration system and for raising fish.

>sw
You walk a little ways to the next sector.

Sector 3: Forest
Trees, a house, and a church. A red pylon stretches up from the ground to the hub of the station.

>x hub
The station rotates around the hub, which extends out to hold solar panels on the starboard side. On the inside, there is a mesh maintenance platform.

>x panels
You can't see any such thing.

* * *

>sw
You walk a little ways to the next sector.

Sector 6: Hydroponics
Your people prefered to grow things the old fashioned way, but in truth the majority of your fruit and vegetables came from this sector when the machines still worked.

There is a secured hatch in the ground.

>sw
You walk a little ways to the next sector.

Sector 7: Livestock
You are in sector 7. There are pens left from when this was the livestock sector, but nothing is left now. A pylon stretches up from the ground to the hub of the station.

>sw
You walk a little ways to the next sector.

Sector 8: Crops
You are in sector 8.

>sw
You walk a little ways to the next sector.

Sector 1: Crops
You are in sector 1. A pylon stretches up from the ground to the hub of the station.

There is a secured hatch in the floor.

>d
(first opening floor hatch)
You pull yourself up through the hatch and close it behind yourself.

Pod Control
Used for todo.

There is a secured hatch in the ceiling.

You can also see a status display here.

>look
Pod Control
Used for todo.

There is a secured hatch in the ceiling.

* * *

>d
(first opening floor hatch)
You pull yourself up through the hatch and close it behind yourself.

Pod Control
Used for todo.

There is a secured hatch in the ceiling.

You can also see a status display here.

>sw
You can't go that way.

>asw
You can't enter the pod bay yet.

>gonear red breaker
Center Platform
It's a mesh platform a little below the hub. From here, you are very aware of how the station rotates, but everything is okay as long as you don't look down [1].

You can see a red circuit breaker here.

"[1]" is a footnote. You can type "note 1" to see the first footnote, or "notes" to see all footnotes so far.

>turn breaker on
You switch the red circuit breaker on.

* * *

>wear it
You put on the emergency helmet.

>d
You can't go that way.

>enter pond
Since you're wearing the emergency helmet, you breath comfortably as you step into the pond. At the bottom, you find a green circuit breaker and flip it on.

>swim
That's not a verb I recognize.

>gonear display
Pod Control
Used for todo.

There is a secured hatch in the ceiling.

You can also see a status display here.

>asw
Pod Bay

>sw
Pod Control
Used for todo.

There is a secured hatch in the ceiling.

You can also see a status display here.

* * *

>sw
You walk a little ways to the next sector.

Sector 1: Crops
You are in sector 1. A pylon stretches up from the ground to the hub of the station.

There is a secured hatch in the floor.

>e
You have heard of compass directions like east, but they don't make any sense here. Instead, you can go spinward, antispinward, port, and starboard.

When you look spinward, port is left and starboard is right. You can also use up, down, in, and out, and you can use abbreviations "sw", "asw", "p", and "s". Also, you can type "exits" if you get confused about geography.

* * *

>sw
You walk a little ways to the next sector.

Sector 1: Crops
You are in sector 1. A pylon stretches up from the ground to the hub of the station.

There is a secured hatch in the floor.

>sw
You walk a little ways to the next sector.

Sector 2: Aquaculture
There is a large pond that serves as part of the water filtration system and is used for raising fish.

>go pond
Nope.

>purloin helmet
[Purloined.]

* * *

>wear it
You put on the emergency helmet.

>go pond
OK.

>swim
That's not a verb I recognize.

* * *

>sw
You walk a little ways to the next sector.

Sector 2: Aquaculture
There is a large pond that serves as part of the water filtration system and is used for raising fish.

>x pond
Something to do with water filtration, and there are still some fish.

>drink pond
It's a bit fishy for that.

>feel pond
You feel nothing unexpected.

>take pond
That's hardly portable.

>go pond
That's not something you can enter.

* * *

>sw
You walk a little ways to the next sector.

Sector 5: Forest
A pylon stretches up from among a group of trees to the hub of the station.

The school house is nestled among the trees.

>x trees
You see nothing special about some trees.

>x forest
You can't see any such thing.

>climb trees
Little is to be achieved by that.

>get trees
They're hardly portable.

* * *

>out
But you aren't in anything at the moment.

>test one
(Testing.)

>[1] gonear red breaker
Center Platform
It's a mesh platform a little below the hub. From here, you are very aware of how the station rotates, but everything is okay as long as you don't look down.

You can see a red circuit breaker here.

>[2] turn red breaker on
You switch the red circuit breaker on.

>[3] gonear pond
Sector 2: Aquaculture
A deep pond serves as part of the water filtration system and for raising fish.

>[4] purloin mask
[Purloined.]

>[5] wear it
You put on the emergency mask.

>[6] go water
WIth the air from the emergency mask, you breathe comfortably as you step into the pond. At the bottom, you find a green circuit breaker and flip it on.

>[7] gonear display
Pod Control
This room serves as an airlock for the pod bay.

There is a secured hatch in the ceiling.

Beside the secured port hatch, a status display glows green.

It is time to say goodbye to the station. You are ready to leave in a pod.

>out
But you aren't in anything at the moment.

>port
(first opening the pod bay hatch)

Pod Bay
A open hatch leads starboard.

SInce the game isn't finished...
You notice that there are no pods left. You despair. But then you find the communications system and call for help. Someone comes.

    *** ...you have won ***

Would you like to RESTART, RESTORE a saved game, QUIT, or UNDO the last command?

* * *

>out
But you aren't in anything at the moment.

>x crops
Greens, carrots, and potatoes.

>x greens
Greens, carrots, and potatoes.

>eat greens
They're plainly inedible.

* * *

>out
But you aren't in anything at the moment.

>x home
You were told it was built to look like a log cabin on Old Earth.

* * *

>x crops
Greens, carrots, and potatoes.

>get carrots
They're hardly portable.

>sw
You walk a little ways to the next sector.

Sector 5: Forest
A group of trees. A pylon stretches up from the ground to the jub of the station.

The school house is nestled among the trees.

>x trees
The community grew trees for tradition, or maybe they help with air processing. You don't remember.

* * *

>climb trees
You can't get a good grip.

>sw
You walk a little ways to the next sector.

Sector 6: Hydroponics
Your people prefered to grow things the old fashioned way, but in truth the majority of your fruit and vegetables came from this sector when the machines still worked.

You can go down.

There is a secured hatch in the floor.

>x hyrdoponics
You can't see any such thing.

>x hydroponics
You can't see any such thing.

>sw
You walk a little ways to the next sector.

Sector 7: Livestock
There are pens left from when this was the livestock sector, but nothing is left now. A pylon stretches up from the ground to the hub of the station.

* * *

>x pens
There are no animals left.

>sw
You walk a little ways to the next sector.

Sector 8: Crops
You still maintain the crops here.

* * *

>x crops
Grain and legumes.

>get grain
They're hardly portable.

* * *

>get legumes
They're hardly portable.

>sw
You walk a little ways to the next sector.

Sector 1: Crops
This sector is fallow this cycle. A pylon stretches up from the ground to the hub of the station.

There is a secured hatch in the floor.

>x crops
You can't see any such thing.

>x pylon
Made of smooth metal, it connects the ground to the hub of the station about 25 meters above [1].

"[1]" is a footnote. You can type "note 1" to see the first footnote, or "notes" to see all footnotes so far.

>sw
You walk a little ways to the next sector.

Sector 2: Aquaculture
There is a large, deep pond that serves as part of the water filtration system and is used for raising fish.

>x pond
Something to do with water filtration, and there are still some fish.

>x fish
You can't see any such thing.

* * *

>asw
You walk a little ways to the next sector.

Sector 3: Forest
Trees, a house, and a church. A red pylon stretches up from the ground to the hub of the station.

>enter church
Church
Before everyone left or died, you celebrated every sabbath here.

The altar stands against the far wall.

On the altar is The Founder's Testament.

>x testament
The Founder's Testament tells the story of how your people left Old Earth and first settled the station. You know the story by heart, and have already derived whatever comfort you can from this book.

>read testament
The Founder's Testament tells the story of how your people left Old Earth and first settled the station. You know the story by heart, and have already derived whatever comfort you can from this book.

>get it
Taken.

>i
You are carrying:
  The Founder's Testament
  a green jumpsuit (being worn)

>look
Church
Before everyone left or died, you celebrated every sabbath here.

The altar stands against the far wall.

>put testament in pocket
You put the Founder's Testament into the pocket.

>i
You are carrying:
  a green jumpsuit (being worn)

Your jumpsuit pocket contains:
  The Founder's Testament

* * *

>sw
You walk a little ways to the next sector.

Sector 5: Forest
A pylon stretches up from among a group of trees to the hub of the station.

The school house is nestled among the trees.

>climb pylon
The pylon is slick metal with no obvious handholds.

>sw
You walk a little ways to the next sector.

Sector 6: Hydroponics
Your people prefered to grow things the old fashioned way, but in truth the majority of your fruit and vegetables came from this sector when the machines still worked.

There is a secured hatch in the ground.

* * *

>sw
You walk a little ways to the next sector.

Sector 2: Aquaculture
A deep pond serves as part of the water filtration system and for raising fish.

>sw
You walk a little ways to the next sector.

Sector 3: Forest
Trees, a house, and a church. A red pylon stretches up from the ground to the hub of the station.

You have walked the entire ring. Everything is as expected, much is not working. Now, it's time to leave. The pods are below Sector 1.

>climb pylon
The pylon is slick metal with no obvious handholds.

>purloin boots
[Purloined.]

* * *

>wear boots
You put on the pair of gravity boots.

>climb pylon
The pylon is slick metal with no obvious handholds.

>look
Sector 3: Forest
Trees, a house, and a church. A red pylon stretches up from the ground to the hub of the station.

>x pylon
Made of smooth metal, anodized red, it connects the ground to the hub of the station about 25 meters above.

* * *

>in
School
You had learning machines once. After they broke, some of the older farmers took turns leading the class, eventually just you, in lessons.

There is a chalkboard on the wall.

You can also see a learning machine and a desk (on which is a clean eraser) here.

>scanner, scan machine
Machine is failed.

>scanner, open machine
Opening.

The learning machine swings open.

>look
School
You had learning machines once. After they broke, some of the older farmers took turns leading the class, eventually just you, in lessons.

There is a chalkboard on the wall.

You can also see a learning machine (in which are a power module and an instruction module) and a desk (on which is a clean eraser) here.

* * *

>get all
power module: Taken.
instruction module: Taken.
clean eraser: (putting the scanner into your pocket to make room)
Taken.

>scan power module
Component is functional.

>i
You are carrying:
  a clean eraser
  an unscanned instruction module
  a functional power module
  a green jumpsuit (being worn)

Your jumpsuit pocket contains:
  a scanner

>scan instruction module
Component is faulty.

>i
You are carrying:
  a clean eraser
  a faulty instruction module
  a functional power module
  a green jumpsuit (being worn)

Your jumpsuit pocket contains:
  a scanner

>look
School
You had learning machines once. After they broke, some of the older farmers took turns leading the class, eventually just you, in lessons.

There is a chalkboard on the wall.

You can also see a learning machine (empty) and a desk here.

>out
Sector 5: Forest
A pylon stretches up from among a group of trees to the hub of the station.

The school house is nestled among the trees.

>purloin mask
[Purloined.]

>scanner, open mask
No electronic technology detected.

* * *

>sw
You walk a little ways to the next sector.

Sector 5: Forest
A pylon stretches up from among a group of trees to the hub of the station.

The school house is nestled among the trees.

>out
Sector 4: Crops
Your home is here among the crops.

* * *

>sw
You walk a little ways to the next sector.

Sector 8: Crops
You still maintain the crops here.

>x crops
You can't see any such thing.

* * *

>x trees
The community grew trees for tradition, or maybe they help with air processing. You don't remember.

>climb tree
You can't get a good grip.

>climb trees
You can't get a good grip.

>purloin boots
[Purloined.]

* * *

>wear boots
You put on the pair of gravity boots.

>climb trees
Trees aren't magnetized, so the boots won't help.

>look
Sector 5: Forest
A group of trees. A pylon stretches up from the ground to the jub of the station.

The school house is nestled among the trees.

>s house
That's not a verb I recognize.

>x house
It's little and red. Apparently, that is the traditional marking of a school building.

>go house
School
You had learning machines once. After they broke, some of the older farmers took turns leading the class, then just you, in lessons.

There is a chalkboard on the wall.

You can also see a desk (on which is a clean eraser) here.

>out
Sector 5: Forest
A group of trees. A pylon stretches up from the ground to the jub of the station.

The school house is nestled among the trees.

>sw
You walk a little ways to the next sector.

Sector 6: Hydroponics
Your people prefered to grow things the old fashioned way, but in truth the majority of your fruit and vegetables came from this sector when the machines still worked.

You can go down.

There is a secured hatch in the floor.

* * *

>sw
You walk a little ways to the next sector.

Sector 8: Crops
You still maintain the crops here.

>asw
You walk a little ways to the next sector.

Sector 7: Livestock
There are pens left from when this was the livestock sector, but nothing is left now. A pylon stretches up from the ground to the hub of the station.

>x pens
You can't see any such thing.

>x hubs
You can't see any such thing.

>x pylon
Made of smooth metal, it connects the ground to the hub of the station about 25 meters above [1].

"[1]" is a footnote. You can type "note 1" to see the first footnote, or "notes" to see all footnotes so far.

>climb pylon
The pylon is slick metal with no obvious handholds.

>note 1
[1] The circumference of the main wheel is composed of eight sectors of 20 meters each, so 2r = 160, and r  25.

* * *

>x crops
Greens, carrots, and potatoes.

>sw
You walk a little ways to the next sector.

Sector 5: Forest
A group of trees. A pylon stretches up from the ground to the jub of the station.

The school house is nestled among the trees.

* * *

>sw
You walk a little ways to the next sector.

Sector 7: Livestock
There are pens left from when this was the livestock sector, but nothing is left now. A pylon stretches up from the ground to the hub of the station.

>asw
You walk a little ways to the next sector.

Sector 6: Hydroponics
Your people prefered to grow things the old fashioned way, but in truth the majority of your fruit and vegetables came from this sector when the machines still worked.

You can go down.

There is a secured hatch in the floor.

* * *

>sw
You walk a little ways to the next sector.

Sector 6: Hydroponics
Your people prefered to grow things the old fashioned way, but in truth the majority of your fruit and vegetables came from this sector when the machines still worked.

There is a secured hatch in the ground.

>sw
You walk a little ways to the next sector.

Sector 7: Livestock
The barn remains from when this was the livestock sector. A pylon stretches up from the ground to the hub of the station.

* * *

>sw
You walk a little ways to the next sector.

Sector 2: Aquaculture
A deep pond serves as part of the water filtration system and for raising fish.

>sw
You walk a little ways to the next sector.

Sector 3: Forest
Trees, a house, and a church. A red pylon stretches up from the ground to the hub of the station.

TEXT.

>sw
You walk a little ways to the next sector.

Sector 4: Crops
Your home is here among the crops.

>as
That's not a verb I recognize.

>asw
You walk a little ways to the next sector.

Sector 3: Forest
Trees, a house, and a church. A red pylon stretches up from the ground to the hub of the station.

* * *

>asw
You walk a little ways to the next sector.

Sector 1: Crops
This sector is fallow for a cycle. A pylon stretches up from the ground to the hub of the station.

There is a secured hatch in the ground.

>d
(first opening the floor hatch)
You scramble down through the hatch and close it behind yourself.

Pod Control
This room serves as an airlock for the pod bay.

There is a secured hatch in the ceiling.

Beside the secured port hatch, a status display shows an error message.

* * *

>sw
You walk a little ways to the next sector.

Sector 6: Hydroponics
Your people prefered to grow things the old fashioned way, but in truth the majority of your fruit and vegetables came from this sector when the machines still worked.

There is a secured hatch in the ground.

>d
(first opening the floor hatch)
You scramble down through the hatch and close it behind yourself.

Below Sector 6
It's a room. You can go up or spinward.

There is a secured hatch in the ceiling.

>sw
Supply Vault
This room is dim, quiet, and stuffy. There is still a crate of machine parts left. The only exit is antispinward.

You can see some pair of gravity boots here.

>x boots
Black work boots with red stripes. They don't really make gravity, but they do stick to some maintenance walkways to help workers get around in low gravity or on the outside of a rotating station.

>get boots
Taken.

>asw
An alarm sounds and you jump back as a gate slams shut across the passageway. It quickly retracts.

* * *

>sw
You walk a little ways to the next sector.

Sector 6: Hydroponics
Your people prefered to grow things the old fashioned way, but in truth the majority of your fruit and vegetables came from this sector when the machines still worked.

There is a secured hatch in the ground.

>x hatch
There is a secured hatch in the ground.

>d
(first opening the floor hatch)
You scramble down through the hatch and close it behind yourself.

Below Sector 6
It's a room. You can go up or spinward.

There is a secured hatch in the ceiling.

>look
Below Sector 6
It's a room. You can go up or spinward.

There is a secured hatch in the ceiling.

>sw
Supply Vault
This room is dim, quiet, and stuffy. There is still a crate of machine parts left. The only exit is antispinward.

You can see some pair of gravity boots here.

* * *

>x graveyard
Fenced off but unmarked graves. You buried your parents here yourself.

>sw
You walk a little ways to the next sector.

Sector 1: Crops
This sector is fallow for a cycle. A pylon stretches up from the ground to the hub of the station.

There is a secured hatch in the ground.

>sw
You walk a little ways to the next sector.

Sector 2: Aquaculture
There is a large, deep pond that serves as part of the water filtration system and for raising fish.

* * *

>sw
You walk a little ways to the next sector.

Sector 7: Livestock
The barn remains from when this was the livestock sector. A pylon stretches up from the ground to the hub of the station.

>x barn
It's a barn.

>in
Barn
Not fancy: livestock on one side and feed on the other, but nothing remains of either.

>x barn
You can't see any such thing.

>look
Barn
Not fancy: livestock on one side and feed on the other, but nothing remains of either.

* * *

>x barn
It's a barn.

>look
Sector 7: Livestock
There is a barn left from when this was the livestock sector. A pylon stretches up from the ground to the hub of the station.

>x barn
It's a barn.

>in
You can't, since S7B1 leads nowhere.

* * *

>sw
You walk a little ways to the next sector.

Sector 6: Hydroponics
Your people prefered to grow things the old fashioned way, but in truth the majority of your fruit and vegetables came from this sector when the machines still worked.

There is a secured hatch in the ground.

>x hydroponics
You were thoroughly trained in hydroponics maintenance, but fixing these machines is beyond you.

>x machines
You were thoroughly trained in hydroponics maintenance, but fixing these machines is beyond you.

>x machine
You were thoroughly trained in hydroponics maintenance, but fixing these machines is beyond you.

>get machine
Those are just junk.

>climb machine
Those are just junk.

* * *

>sw
You walk a little ways to the next sector.

Sector 5: Forest
A pylon stretches up from among a group of trees to the hub of the station.

The school house is nestled among the trees.

>x pylon
Made of smooth metal, it connects the ground to the hub of the station about 25 meters above.

>sw
You walk a little ways to the next sector.

Sector 6: Hydroponics
Your people prefered to grow things the old fashioned way, but in truth the majority of your fruit and vegetables came from this sector when the machines still worked.

There is a secured hatch in the ground.

>x fruit
You can't see any such thing.

>x hydroponics
You can't see any such thing.

* * *

>out
Sector 4: Crops
Your home is here among the crops.

>x hub
The station rotates around the hub, which extends out to hold solar panels on the port and mirrors on the starboard side. On the inside, there is a mesh maintenance platform.

>out
Sector 4: Crops
You are in sector 4.

Your home is here among the crops.

>x hub
You see nothing special about the hub.

>touch hub
You feel nothing unexpected.

>gonear red
Center Platform
It's a mesh platform a little below the hub. From here, you are very aware of how the station rotates, but everything is okay as long as you don't look down [1].

You can see a red circuit breaker here.

"[1]" is a footnote. You can type "note 1" to see the first footnote, or "notes" to see all footnotes so far.

>x hub
You see nothing special about the hub.

* * *

>touch hub
You feel nothing unexpected.

>x hub
You see nothing special about the hub.

* * *

>x hub
The station rotates around the hub, which extends out to hold solar panels on the port and mirrors on the starboard side. On the inside, there is a mesh maintenance platform.

>x panels
The primary source of station power.

>x mirrors
The mirrors reflect sun light into the station.

>x sun
The mirrors reflect sun light into the station.

* * *

>x panels
The primary source of station power.

>x panel
You can't see any such thing.

>asw
You walk a little ways to the next sector.

Sector 3: Forest
Trees, a house, and a church. A red pylon stretches up from the ground to the hub of the station.

* * *

>d
(first opening the floor hatch)
You scramble down through the hatch and close it behind yourself.

Pod Control
This room serves as an airlock for the pod bay.

There is a secured hatch in the ceiling.

Beside the secured port hatch, a status display shows an error message.

>x status
Pod bay locked down
Diagnosis: telemetry sensor array offline
Remediation: reset breaker 36-87/A @ hub platform

>x message
Pod bay locked down
Diagnosis: telemetry sensor array offline
Remediation: reset breaker 36-87/A @ hub platform

* * *

>out
Sector 4: Crops
Your home is here among the crops.

>x platform
Since the main power and sensor feeds pass through the hub, there is a platform where you can perform various maintenance tasks.

>enter platform
You will need to climb a pylon to get there.

* * *

>x platform
Since the main power and sensor feeds pass through the hub, there is a platform where you can perform various maintenance tasks.

>x hub
The station rotates around the hub, which extends out to hold solar panels on the starboard side. On the inside, there is a mesh maintenance platform.

>x panels
The primary source of station power.

>get panels
You are too far away to do that.

>tast panels
That's not a verb I recognize.

>taste panels
You are too far away to do that.

* * *

>purloin all
[Purloined.]
[Can't move Home: it would contain itself.]
[Purloined.]
[Purloined.]
[Purloined.]
[Purloined.]
[Purloined.]
[Purloined.]
[Can't move pocket: it's part of the green jumpsuit.]
[Purloined.]
[Purloined.]
[Purloined.]
[Purloined.]
[Purloined.]
[Purloined.]
[Purloined.]
[Purloined.]
[Purloined.]
[Purloined.]
[Purloined.]
[Purloined.]
[Purloined.]
[Purloined.]
[Purloined.]
[Purloined.]
[Purloined.]
[Purloined.]
[Purloined.]
[Purloined.]
[Purloined.]
[Purloined.]
[Purloined.]
[Purloined.]
[Purloined.]
[Purloined.]
[Purloined.]
[Purloined.]
[Purloined.]
[Purloined.]
[Purloined.]
[Purloined.]
[Purloined.]
[Purloined.]
[Purloined.]
[Purloined.]
[Purloined.]
[Purloined.]
[Purloined.]
[Purloined.]
[Purloined.]
[Purloined.]
[Purloined.]
[Purloined.]
[Purloined.]
[Purloined.]
[Purloined.]
[Purloined.]
[Purloined.]
[Purloined.]
[Purloined.]
[Purloined.]
[Purloined.]
[Purloined.]
[Purloined.]
[Purloined.]
[Purloined.]
[Purloined.]
[Purloined.]
[Purloined.]
[Purloined.]
[Purloined.]
[Purloined.]
[Purloined.]
[Purloined.]
[Purloined.]
[Purloined.]

>restart
Are you sure you want to restart?

* * *

>purloin mask and boots
[Purloined.]
[Purloined.]

>purloin book
[Purloined.]

>i
You are carrying:
  The Founder's Testament
  some pair of gravity boots
  an emergency mask
  a green jumpsuit (being worn)

>purloin eraser
[Purloined.]

>drop all
clean eraser: Dropped.
Founder's Testament: Dropped.
pair of gravity boots: Dropped.
emergency mask: Dropped.

>get eraser
Taken.

>get book
Taken.

>get boots
Taken.

>get mask
(putting the clean eraser into your pocket to make room)
That can't contain things.

>x pocket
You see nothing special about the pocket.

>put eraser into pocket
That can't contain things.

* * *

>purloin boots
[Purloined.]

>purloin book
[Purloined.]

>purloin erase
There seems to be no such object anywhere in the model world.

>purloin eraser
[Purloined.]

>purloin mask
[Purloined.]

>drop all
emergency mask: Dropped.
clean eraser: Dropped.
Founder's Testament: Dropped.
pair of gravity boots: Dropped.

>i
You are carrying:
  a green jumpsuit (being worn)

>get mask
Taken.

>get eraser
Taken.

* * *

>get book
Taken.

>get boots
You're carrying too many things already.

* * *

>purloin boots and mask and book and eraser
[Purloined.]
[Purloined.]
[Purloined.]
[Purloined.]

>rop all
That's not a verb I recognize.

>drop all
clean eraser: Dropped.
Founder's Testament: Dropped.
emergency mask: Dropped.
pair of gravity boots: Dropped.

>get boots
Taken.

>get mask
Taken.

>get book
Taken.

>get eraser
(putting the pair of gravity boots into your pocket to make room)
Taken.

>i
You are carrying:
  a clean eraser
  The Founder's Testament
  an emergency mask
  a green jumpsuit (being worn)

Your jumpsuit pocket contains:
  some pair of gravity boots

>look
Home
The room where you've slept your entire life. The only exit is out from here.

There is a secured hatch in the floor.

>get boots
(putting the emergency mask into your pocket to make room)
Taken.

>wear boots
You put on the pair of gravity boots.

>get mask
Taken.

>i
You are carrying:
  an emergency mask
  some pair of gravity boots (being worn)
  a clean eraser
  The Founder's Testament
  a green jumpsuit (being worn)

>wear mask
You put on the emergency mask.

>i
You are carrying:
  an emergency mask (being worn)
  some pair of gravity boots (being worn)
  a clean eraser
  The Founder's Testament
  a green jumpsuit (being worn)

>look
Home
The room where you've slept your entire life. The only exit is out from here.

There is a secured hatch in the floor.

* * *

>s
You can't go that way.

>n
You have heard of compass directions like north, but they don't make any sense here. Instead, you can go spinward, antispinward, port, and starboard. When you look spinward, port is left and starboard is right.

[You can use the abbreviations "sw", "asw", "p", and "s". You can also go "up", "down", "in", and "out" where appropriate. Type "exits" if you get confused about geography.]

>n
You have heard of compass directions like north, but they don't make any sense here. Instead, you can go spinward, antispinward, port, and starboard. When you look spinward, port is left and starboard is right.

>exits
The obvious exits are down and outside.

[Type "exits off" to disable the status line exit list and "exits on" to turn it back on.]

>score
You have so far scored 0 out of a possible 50, in 4 turns.

* * *

>s hatch
I only understood you as far as wanting to (go) s.

>x hatch
There is a secured hatch in the floor..

>d
(first getting off your bed)
(first opening the floor hatch)
You pull yourself up through the hatch and close it behind yourself.

Below Home
This space is used for storage and as a decompression shelter.

There is a secured hatch in the ceiling.

There is an emergency helmet hanging on the wall.

>x hatch
There is a secured hatch in the ceiling..

* * *

>scenes
Scene 'Entire Game' playing (for 0 mins now)
(Scene monitoring now switched on. Type "scenes off" to switch it off again.)

>asw
You can't go that way.

* * *

>sw
You walk a little ways to the next sector.

Sector 2: Aquaculture
A deep pond serves as part of the water filtration system and for raising fish.

>sw
You walk a little ways to the next sector.

Sector 3: Forest
Trees, a house, and a church. A red pylon stretches up from the ground to the hub of the station.

[Scene 'Ready to Repair' begins]
You have walked to entire ring. Everything is as expected, much is not working. Now, it's time to leave. The pods are below Sector 1.

>scenes
Scene 'Entire Game' playing (for 9 mins now)
Scene 'Wandering' playing (for 9 mins now)
Scene 'Ready to Repair' playing (for 1 mins now)
(Scene monitoring now switched on. Type "scenes off" to switch it off again.)

* * *

>scenes
Scene 'Entire Game' playing (for 0 mins now)
(Scene monitoring now switched on. Type "scenes off" to switch it off again.)

>gonear red breaker
Center Platform
It's a mesh platform a little below the hub. From here, you are very aware of how the station rotates, but everything is okay as long as you don't look down.

You can see a red circuit breaker here.

>turn red breaker on
You switch the red circuit breaker on.

>gonear pond
Sector 2: Aquaculture
A deep pond serves as part of the water filtration system and for raising fish.

* * *

>purloin mask
[Purloined.]

>go pond
You can't hold your breath long enough to make that worthwhile.

>enter pond
You can't hold your breath long enough to make that worthwhile.

>wear mask
You put on the emergency mask.

>enter pond
WIth the air from the emergency mask, you breathe comfortably as you step into the pond. At the bottom, you find a green circuit breaker and flip it on.

>enter pond
You have already turned the green breaker on.

>remove mask
You take off the emergency mask.

>asw
You walk a little ways to the next sector.

Sector 1: Crops
This sector is fallow for a cycle. A pylon stretches up from the ground to the hub of the station.

There is a secured hatch in the ground.

>d
(first opening the floor hatch)
You scramble down through the hatch and close it behind yourself.

Pod Control
This room serves as an airlock for the pod bay.

There is a secured hatch in the ceiling.

Beside the secured port hatch, a status display glows green.

[Scene 'Anxious to Leave' begins]
HIHIHIH.

* * *

>scenes
Scene 'Entire Game' playing (for 0 mins now)
(Scene monitoring now switched on. Type "scenes off" to switch it off again.)

>out
Sector 4: Crops
Your home is here among the crops.

* * *

>sw
You walk a little ways to the next sector.

Sector 8: Crops
You still maintain the crops here, and there is a small graveyard.

>asw
You walk a little ways to the next sector.

Sector 7: Livestock
There are pens left from when this was the livestock sector, but no animals. A pylon stretches up from the ground to the hub of the station.

* * *

>asw
You walk a little ways to the next sector.

Sector 6: Hydroponics
Your people prefered to grow things the old fashioned way, but in truth the majority of your fruit and vegetables came from this sector when the machines still worked.

There is a secured hatch in the ground.

>asw
You walk a little ways to the next sector.

Sector 5: Forest
A pylon stretches up from among a group of trees to the hub of the station.

The school house is nestled among the trees.

[Scene 'Ready to Repair' begins]
You have walked to entire ring. Everything is as expected, much is not working. Now, it's time to leave. The pods are below Sector 1.
[Scene 'Wandering' ends]

* * *

>out
Sector 4: Crops
Your home is here among the crops.

>gonear red
Center Platform
It's a mesh platform a little below the hub. From here, you are very aware of how the station rotates, but everything is okay as long as you don't look down.

You can see a red circuit breaker here.

>turn breaker off
That's already off.

>turn breaker on
You switch the red circuit breaker on.

>turn breaker off
The red circuit breaker seems to be locked on.

>gonear pond
Sector 2: Aquaculture
A deep pond serves as part of the water filtration system and for raising fish.

* * *

>purloin mask
[Purloined.]

>turn breaker on
You can't see any such thing.

>wear mask
You put on the emergency mask.

>go water
WIth the air from the emergency mask, you breathe comfortably as you step into the pond. At the bottom, you find a green circuit breaker and flip it on.

[Scene 'Anxious to Leave' begins]
HIHIHIH.

>asw
You walk a little ways to the next sector.

Sector 1: Crops
This sector is fallow for a cycle. A pylon stretches up from the ground to the hub of the station.

There is a secured hatch in the ground.

* * *

>asw
You walk a little ways to the next sector.

Sector 4: Crops
Your home is here among the crops.

>asw
You walk a little ways to the next sector.

Sector 3: Forest
Trees, a house, and a church. A red pylon stretches up from the ground to the hub of the station.

[Scene 'Ready to Repair' begins]
You have walked the entire ring. Everything is as expected, much is not working. Now, it's time to leave. The pods are below Sector 1.

>scenes
Scene 'Entire Game' playing (for 15 mins now)
Scene 'Ready to Repair' playing (for 1 mins now)
Scene 'Anxious to Leave' playing (for 8 mins now)
(Scene monitoring now switched on. Type "scenes off" to switch it off again.)

* * *

>score
You have so far scored 0 out of a possible 50, in 1 turn.

>full
That's not a verb I recognize.

>out
Sector 4: Crops
Your home is here among the crops.

* * *

>asw
You walk a little ways to the next sector.

Sector 3: Forest
Trees, a house, and a church. A red pylon stretches up from the ground to the hub of the station.

>sw
You walk a little ways to the next sector.

Sector 4: Crops
Your home is here among the crops.

* * *

>go school
School
You had learning machines once. After they broke, some of the older farmers took turns leading the class, eventually just you, in lessons.

There is a chalkboard on the wall.

You can also see a desk (on which is a clean eraser) here.

>get eraser
Taken.

>clean board
(with the eraser)
You carefully erase the chalkboard.

>out
Sector 5: Forest
A pylon stretches up from among a group of trees to the hub of the station.

The school house is nestled among the trees.

>sw
You walk a little ways to the next sector.

Sector 6: Hydroponics
Your people prefered to grow things the old fashioned way, but in truth the majority of your fruit and vegetables came from this sector when the machines still worked.

There is a secured hatch in the ground.

* * *

>sw
Supply Vault
This room is dim, quiet, and stuffy. There is still a crate of machine parts left. The only exit is antispinward.

You can see some pair of gravity boots here.

>get boots
Taken.

* * *

>asw
An alarm sounds and you jump back as a gate slams shut across the passageway. It quickly retracts.

>i
You are carrying:
  some pair of gravity boots
  a dusty eraser
  a green jumpsuit (being worn)

>drop boots
Dropped.

>asw
Below Sector 6
There's nothing distinctive about this small room. You can go up or spinward.

There is a secured hatch in the ceiling.

>sw
Supply Vault
This room is dim, quiet, and stuffy. There is still a crate of machine parts left. The only exit is antispinward.

You can see some pair of gravity boots here.

>hit eraser
You fill the room with a cloud of dust and you can now see a laser beam scanning across the passageway.

>sw
You can't go that way.

>asw
You maneuver around the laser beam.

Below Sector 6
There's nothing distinctive about this small room. You can go up or spinward.

There is a secured hatch in the ceiling.

>sw
Supply Vault
This room is dim, quiet, and stuffy. There is still a crate of machine parts left. The only exit is antispinward.

You see a laser beam scan across the exit.

You can see some pair of gravity boots here.

>get boots
Taken.

>sw
You can't go that way.

>asw
An alarm sounds and you jump back as a gate slams shut across the passageway. It quickly retracts.

>hit eraser
You fill the room with a cloud of dust and you can now see a laser beam scanning across the passageway.

>asw
You maneuver around the laser beam.

Below Sector 6
There's nothing distinctive about this small room. You can go up or spinward.

There is a secured hatch in the ceiling.

[Your score has just gone up by ten points.]

>score
You have so far scored 10 out of a possible 50, in 27 turns.

>out
But you aren't in anything at the moment.

[Your score has just gone up by ten points.]

>i
You are carrying:
  some pair of gravity boots
  a dusty eraser
  a green jumpsuit (being worn)

[Your score has just gone up by ten points.]

>showme boots
pair of gravity boots - thing
location: carried by yourself in Below Sector 6
plural-named, improper-named; unlit, inedible, portable, wearable, handled
list grouping key: none
printed name: "pair of gravity boots"
printed plural name: none
indefinite article: none
description: "Black work boots with red stripes. They don't really make gravity, but they do stick to some maintenance walkways to help workers get around in low gravity or on the outside of a rotating station."
initial appearance: none

* * *

>score
You have so far scored 0 out of a possible 50, in 1 turn.

>gonear red
(the red circuit breaker)
Center Platform
It's a mesh platform a little below the hub. From here, you are very aware of how the station rotates, but everything is okay as long as you don't look down.

You can just reach a red circuit breaker on the hub.

>turn on red
[Your score has just gone up by ten points.]

>gonear pond
Sector 2: Aquaculture
A deep pond serves as part of the water filtration system and for raising fish.

* * *

>wear mask
You put on the emergency mask.

>swim
WIth the air from the emergency mask, you breathe comfortably as you step into the pond. At the bottom, you find a green circuit breaker and flip it on.

[Your score has just gone up by ten points.]

>spinward
You walk a little ways to the next sector.

Sector 3: Forest
Trees, a house, and a church. A red pylon stretches up from the ground to the hub of the station.

>ne
You have heard of compass directions like northeast, but they don't make any sense here. Instead, you can go spinward, antispinward, port, and starboard.

When you look spinward, port is left and starboard is right. You can also use up, down, in, and out, and you can use abbreviations "sw", "asw", "p", and "s". Also, you can type "exits" if you get confused about geography.

* * *

>score
You have so far scored 0 out of a possible 50, in 1 turn.

>look
Home
The room where you've slept your entire life. You can go out towards the crops.

There is a secured hatch in the floor.

* * *

>se
You have heard of compass directions like southeast, but they don't make any sense here. Instead, you can go spinward, antispinward, port, and starboard.

[When you look spinward, port is left and starboard is right. You can also use up, down, in, and out, and you can use abbreviations "sw", "asw", "p", and "s". Also, you can type "exits" if you get confused about geography.]

>gonear red
(the red circuit breaker)
Center Platform
It's a mesh platform a little below the hub. From here, you are very aware of how the station rotates, but everything is okay as long as you don't look down.

You can just reach a red circuit breaker on the hub.

* * *

>turn it on
You switch the red circuit breaker on.

[Your score has just gone up by five points.]

>exits
The only obvious exit is down.

[Type "exits off" to disable the status line exit list and "exits on" to turn it back on.
]

* * *

>showme
Home - room
    the floor hatch - floor hatch
    yourself - person
        green jumpsuit (worn)
            pocket (part of green jumpsuit) - open container

>out
Sector 4: Crops
Your home is here among the crops.

* * *

>x barn
It's a barn.

>go barn
Barn
It's a barn.

>out
Sector 7: Livestock
The barn remains from when this was the livestock sector. A pylon stretches up from the ground to the hub of the station.

* * *

>out
Sector 4: Crops
Your home is here among the crops.

>showme
Sector 4: Crops - room
    maintenance platform - backdrop
    mirrors - backdrop
    solar panels - backdrop
    hub - backdrop
    yourself - person
        green jumpsuit (worn)
            pocket (part of green jumpsuit) - open container
    your home - building
    vegetables

>asw
You walk a little ways to the next sector.

Sector 3: Forest
Trees, a house, and a church. A red pylon stretches up from the ground to the hub of the station.

>showme
Sector 3: Forest - room
    maintenance platform - backdrop
    mirrors - backdrop
    solar panels - backdrop
    hub - backdrop
    yourself - person
        green jumpsuit (worn)
            pocket (part of green jumpsuit) - open container
    the pylon - pylon
    the church
    the house
    some trees - forest

>close pocket
It isn't something you can close.

>in
You can enter the church or the house.

>enter church
Church
Before everyone left or died, you celebrated every sabbath here.

The altar stands against the far wall.

On the altar is The Founder's Testament.

>x altar
Really just a table now.

On the altar is The Founder's Testament.

>x testament
The Founder's Testament tells the story of how your people left Old Earth and first settled the station. You know the story by heart, and have already derived whatever comfort you can from this book.

>read it
The Founder's Testament tells the story of how your people left Old Earth and first settled the station. You know the story by heart, and have already derived whatever comfort you can from this book.

>listobj
Founder's Testament
Hydroponics machines (F) (S)
Laser beam (F) (S)
altar (F)
blue circuit breaker (F)
chalkboard (F)
clean eraser
crate of machine parts (F) (S)
crops (F) (S)
desk (F)
emergency mask
fish (F) (S)
graveyard (F) (S)
green circuit breaker (F)
green jumpsuit
hub (F) (S)
light-meter (F) (S)
maintenance platform (F) (S)
mirrors (F) (S)
pair of gravity boots
pens (F) (S)
pocket (P)
pod bay hatch (F)
pond (F) (S)
red circuit breaker (F)
solar panels (F) (S)
some trees (F) (S)
some trees (F) (S)
space suit (F) (S)
status display (F) (S)
the church (F) (S)
the floor hatch (F)
the floor hatch (F)
the floor hatch (F)
the house (F) (S)
the pylon (F) (S)
the pylon (F) (S)
the pylon (F) (S)
the pylon (F) (S)
the school building (F)
vegetables (F) (S)
your home (F) (S)
yourself

>out
Sector 3: Forest
Trees, a house, and a church. A red pylon stretches up from the ground to the hub of the station.

>x mirrors
The mirrors reflect sun light into the station.

>x mirror
The mirrors reflect sun light into the station.

>look
Sector 3: Forest
Trees, a house, and a church. A red pylon stretches up from the ground to the hub of the station.

>x crops
You can't see any such thing.

>x forest
The community grew trees for tradition, or maybe they help with air processing.

>x trees
The community grew trees for tradition, or maybe they help with air processing.

>x house
What looks like whitewashed siding is really a lightweight plastic.

>sw
You walk a little ways to the next sector.

Sector 4: Crops
Your home is here among the crops.

>x home
You were told it was built to look like a log cabin on Old Earth.

* * *

>x carrots
Greens, carrots, and potatoes.

>sw
You walk a little ways to the next sector.

Sector 5: Forest
A pylon stretches up from among a group of trees to the hub of the station.

The school house is nestled among the trees.

* * *

>x pylon
Made of smooth metal, it connects the ground to the hub of the station about 25 meters above.

>x school
Little and red, the traditional markings of a school building.

I beg your pardon?

>sw
You walk a little ways to the next sector.

Sector 6: Hydroponics
Your people prefered to grow things the old fashioned way, but in truth the majority of your fruit and vegetables came from this sector when the machines still worked.

There is a secured hatch in the ground.

* * *

>x hatch
There is a secured hatch in the ground.

>d
(first opening the floor hatch)
You scramble down through the hatch and close it behind yourself.

Below Sector 6
There's nothing distinctive about this small room. You can go up or spinward.

There is a secured hatch in the ceiling.

* * *

>u
(first opening the ceiling hatch)
You pull yourself up through the hatch and close it behind yourself.

Sector 6: Hydroponics
Your people prefered to grow things the old fashioned way, but in truth the majority of your fruit and vegetables came from this sector when the machines still worked.

There is a secured hatch in the ground.

>u
You can't go that way.

>sw
You walk a little ways to the next sector.

Sector 7: Livestock
There are pens left from when this was the livestock sector, but no animals. A pylon stretches up from the ground to the hub of the station.

* * *

>sw
You walk a little ways to the next sector.

Sector 1: Crops
This sector is fallow for a cycle. A pylon stretches up from the ground to the hub of the station.

There is a secured hatch in the ground.

>sw
You walk a little ways to the next sector.

Sector 2: Aquaculture
A deep pond serves as part of the water filtration system and for raising fish.

You have walked the entire ring. Everything is as expected, much is not working. Now, it's time to leave. The pods are below Sector 1.

>sw
You walk a little ways to the next sector.

Sector 3: Forest
Trees, a house, and a church. A red pylon stretches up from the ground to the hub of the station.

* * *

>showme central platform
There seems to be no such object anywhere in the model world.

>gonear center platform
Center Platform
It's a mesh platform a little below the hub. From here, you are very aware of how the station rotates, but everything is okay as long as you don't look down [1].

You can see a red circuit breaker here.

"[1]" is a footnote. You can type "note 1" to see the first footnote, or "notes" to see all footnotes so far.

>showme center platform
Center Platform - room
    hub - backdrop
    yourself - person
        green jumpsuit (worn)
            pocket (part of green jumpsuit) - player's holdall
    red circuit breaker - circuit breaker
singular-named, proper-named; lighted, visited, apparent, stellar
list grouping key: none
printed name: "Center Platform"
printed plural name: none
indefinite article: none
description: "It's a mesh platform a little below the hub. From here, you are very aware of how the station rotates, but everything is okay as long as you don't look down [1]."
destination name: none

* * *

>sleep
You aren't feeling especially drowsy.

>wake
The dreadful truth is, this is not a dream.

* * *

>swim
There's nothing to swim in.

>gonear pond
Sector 2: Aquaculture
A deep pond serves as part of the water filtration system and for raising fish.

>swim
You can't hold your breath long enough to make that worthwhile.

>purloin mask
[Purloined.]

* * *

>wear mask
You put on the emergency mask.

>swim
WIth the air from the emergency mask, you breathe comfortably as you step into the pond. At the bottom, you find a green circuit breaker and flip it on.

>actions
Actions listing on.

>rub pond
[rubbing the pond]
You rub the pond.
[rubbing the pond - succeeded]

* * *

>swim
There's nothing to swim in.

>swimming
That's not a verb I recognize.

>gonear pond
Sector 2: Aquaculture
A deep pond serves as part of the water filtration system and for raising fish.

* * *

>swim
You can't hold your breath long enough to make that worthwhile.

>actions
Actions listing on.

>swim
[swimming]
[(1) entering the pond]
You can't hold your breath long enough to make that worthwhile.
[(1) entering the pond - failed]

[swimming - failed]

>gonear home
(Home)
[(1) looking]
Home
The room where you've slept your entire life. You can go out towards the crops.

There is a secured hatch in the floor.

[(1) looking - succeeded]

>swim
You can't see any such thing.

>jksdjflk
That's not a verb I recognize.

* * *

>test 1
>--> The following tests are available:
'test one'

>test one
(Testing.)

>[1] gonear red breaker
Center Platform
It's a mesh platform a little below the hub. From here, you are very aware of how the station rotates, but everything is okay as long as you don't look down.

You can see a red circuit breaker here.

>[2] turn red breaker on
You switch the red circuit breaker on.

>[3] gonear pond
Sector 2: Aquaculture
A deep pond serves as part of the water filtration system and for raising fish.

>[4] purloin mask
[Purloined.]

>[5] wear it
You put on the emergency mask.

>[6] go water
WIth the air from the emergency mask, you breathe comfortably as you step into the pond. At the bottom, you find a green circuit breaker and flip it on.

>[7] gonear display
Pod Control
This room serves as an airlock for the pod bay.

There is a secured hatch in the ceiling.

Beside the secured port hatch, a status display glows green.

It is time to say goodbye to the station. You are ready to leave in a pod.

>z
Time passes.

>z
Time passes.

12:10 am = 10

>z
Time passes.

* * *

>test one
(Testing.)

>[1] gonear red breaker
Center Platform
It's a mesh platform a little below the hub. From here, you are very aware of how the station rotates, but everything is okay as long as you don't look down.

You can see a red circuit breaker here.

>[2] turn red breaker on
You switch the red circuit breaker on.

>[3] gonear pond
Sector 2: Aquaculture
A deep pond serves as part of the water filtration system and for raising fish.

>[4] purloin mask
[Purloined.]

>[5] wear it
You put on the emergency mask.

>[6] go water
WIth the air from the emergency mask, you breathe comfortably as you step into the pond. At the bottom, you find a green circuit breaker and flip it on.

>[7] gonear display
Pod Control
This room serves as an airlock for the pod bay.

There is a secured hatch in the ceiling.

Beside the secured port hatch, a status display glows green.

It is time to say goodbye to the station. You are ready to leave in a pod.

>port
(first opening the pod bay hatch)

Pod Bay
A open hatch leads starboard.

SInce the game isn't finished, here's some text: You notice that there are no pods left. You despair. But then you find the communications system and call for help. Someone comes.

    *** ...you have won ***

Would you like to RESTART, RESTORE a saved game, QUIT, or UNDO the last command?

* * *

>time
That's not a verb I recognize.

>z
Time passes.

12:01 am

>z
Time passes.

12:02 am

>z
Time passes.

12:03 am

* * *

>u
(first opening the ceiling hatch)
You pull yourself up through the hatch and close it behind yourself.

Sector 1: Crops
This sector is fallow for a cycle. A pylon stretches up from the ground to the hub of the station.

There is a secured hatch in the ground.

>sw
You walk a little ways to the next sector.

Sector 2: Aquaculture
A deep pond serves as part of the water filtration system and for raising fish.

* * *

>sw
You walk a little ways to the next sector.

Sector 1: Crops
This sector is fallow for a cycle. A pylon stretches up from the ground to the hub of the station.

There is a secured hatch in the ground.

>sw
You walk a little ways to the next sector.

Sector 2: Aquaculture
A deep pond serves as part of the water filtration system and for raising fish.

There is nothing left for you here. It's time to take a pod and leave.

>sw
You walk a little ways to the next sector.

Sector 3: Forest
Trees, a house, and a church. A red pylon stretches up from the ground to the hub of the station.

* * *

>sw
You walk a little ways to the next sector.

Sector 2: Aquaculture
A deep pond serves as part of the water filtration system and for raising fish.

>asw
You walk a little ways to the next sector.

Sector 1: Crops
This sector is fallow for a cycle. A pylon stretches up from the ground to the hub of the station.

There is a secured hatch in the ground.

>d
(first opening the floor hatch)
You scramble down through the hatch and close it behind yourself.

Pod Control
This room serves as an airlock for the pod bay.

There is a secured hatch in the ceiling.

Beside the secured port hatch, a status display glows green.

There is nothing left for you here. It's time to take a pod and leave.

>port
(first opening the pod bay hatch)

Pod Bay
A open hatch leads starboard.

SInce the game isn't finished...

    *** ...you have won ***

Would you like to RESTART, RESTORE a saved game, QUIT, or UNDO the last command?

* * *

>z
Time passes.

>z.z.z.z.z.z..z
Time passes.

12:09 am = 9
Time passes.

12:10 am = 10
Time passes.

12:11 am = 11
Time passes.

12:12 am = 12
Time passes.

12:13 am = 13
Time passes.

12:14 am = 14
That's not a verb I recognize.

>z.z..z.z.z
Time passes.

12:15 am = 15
Time passes.

12:16 am = 16
That's not a verb I recognize.

>z.z.z.z.z
Time passes.

12:17 am = 17
Time passes.

12:18 am = 18
Time passes.

12:19 am = 19
Time passes.

12:20 am = 20
Time passes.

12:21 am = 21

>z.z.z.z.z
Time passes.

12:22 am = 22
Time passes.

12:23 am = 23
Time passes.

12:24 am = 24
Time passes.

12:25 am = 25
Time passes.

12:26 am = 26

>z.z.z.z.z
Time passes.

12:27 am = 27
Time passes.

12:28 am = 28
Time passes.

12:29 am = 29
Time passes.

12:30 am = 30
Time passes.

12:31 am = 31

>z.z.z.z.z
Time passes.

12:32 am = 32
Time passes.

12:33 am = 33
Time passes.

12:34 am = 34
Time passes.

12:35 am = 35
Time passes.

12:36 am = 36

>z.z.z.z.z
Time passes.

12:37 am = 37
Time passes.

12:38 am = 38
Time passes.

12:39 am = 39
Time passes.

12:40 am = 40
Time passes.

12:41 am = 41

>z.z.z.z.z
Time passes.

12:42 am = 42
Time passes.

12:43 am = 43
Time passes.

12:44 am = 44
Time passes.

12:45 am = 45
Time passes.

12:46 am = 46

>z.z.z.z.z
Time passes.

12:47 am = 47
Time passes.

12:48 am = 48
Time passes.

12:49 am = 49
Time passes.

12:50 am = 50
Time passes.

12:51 am = 51

>z.z.z.z.z
Time passes.

12:52 am = 52
Time passes.

12:53 am = 53
Time passes.

12:54 am = 54
Time passes.

12:55 am = 55
Time passes.

12:56 am = 56

>z.z.z.z.z
Time passes.

12:57 am = 57
Time passes.

12:58 am = 58
Time passes.

12:59 am = 59
Time passes.

1:00 am = 0
Time passes.

1:01 am = 1

* * *

>u
You can't go that way.

* * *

>x panels
The primary source of station power.

>x platform
Since the main power and sensor feeds pass through the hub, there is a platform where you can perform various maintenance tasks.

>go platform
You are too far away to do that.

* * *

>ut
That's not a verb I recognize.

>out
Sector 4: Crops
Your home is here among the crops.

* * *

>look
Sector 3: Forest
Trees, a house, and a church. A red pylon stretches up from the ground to the hub of the station.

>wear boots
You put on the pair of gravity boots.

>u
It isn't easy, but with the boots, you are able to climb towards the hub.

Center Platform
It's a mesh platform a little below the hub. From here, you are very aware of how the station rotates, but everything is okay as long as you don't look down.

You can see a red circuit breaker here.

>look
Center Platform
It's a mesh platform a little below the hub. From here, you are very aware of how the station rotates, but everything is okay as long as you don't look down.

You can see a red circuit breaker here.

>sw
You can't go that way.

>d
You climb down the pylon.

Sector 3: Forest
Trees, a house, and a church. A red pylon stretches up from the ground to the hub of the station.

>up
It isn't easy, but with the boots, you are able to climb towards the hub.

Center Platform
It's a mesh platform a little below the hub. From here, you are very aware of how the station rotates, but everything is okay as long as you don't look down.

You can see a red circuit breaker here.

>d
You climb down the pylon.

Sector 3: Forest
Trees, a house, and a church. A red pylon stretches up from the ground to the hub of the station.

* * *

>wake
That's not a verb I recognize.

>actins
That's not a verb I recognize.

>look
Home
The room where you've slept your entire life. The only exit is out from here.

There is a secured hatch in the floor.

* * *

>out
Sector 4: Crops
Your home is here among the crops.

>look
Sector 4: Crops
Your home is here among the crops.

>sw
You walk a little ways to the next sector.

Sector 5: Forest
A group of trees. A pylon stretches up from the ground to the jub of the station.

The school house is nestled among the trees.

* * *

>x hatch
There is a secured hatch in the floor.

>d
(first getting off your bed)
(first opening the floor hatch)
You pull yourself up through the hatch and close it behind yourself.

Below Home
This space is used for storage and as a decompression shelter.

There is a secured hatch in the ceiling.

There is an emergency helmet hanging on the wall.

>up
(first opening floor hatch)
You scramble down through the hatch and close it behind yourself.

Home
The room where you've slept your entire life. The only exit is out from here.

There is a secured hatch in the floor.

You can also see your bed here.

>look
Home
The room where you've slept your entire life. The only exit is out from here.

There is a secured hatch in the floor.

You can also see your bed here.

>gonear status
Pod Control
The pod bay is antispinward. Beside the hatch a status display shows an error message.

There is a secured hatch in the ceiling.

You can also see pod bay door here.

>look
Pod Control
The pod bay is antispinward. Beside the hatch a status display shows an error message.

There is a secured hatch in the ceiling.

You can also see pod bay door here.

* * *

>d
(first getting off your bed)
(first opening the floor hatch)
You pull yourself up through the hatch and close it behind yourself.

Below Home
This space is used for storage and as a decompression shelter.

There is a secured hatch in the ceiling.

There is an emergency helmet hanging on the wall.

>x hatch
There is a secured hatch in the ceiling.

* * *

>x hub
You can't see any such thing.

>out
You get off your bed.

Home
The room where you've slept your entire life. The only exit is out from here.

There is a secured hatch in the floor.

You can also see your bed here.

* * *

>out
Sector 4: Crops
You are in sector 4.

Your home is here among the crops.

>x hub
The station rotates around the hub, which extends out to hold solar panels on the starboard side. On the inside, there is a mesh maintenance platform.

>gonear red
Center Platform
It's a mesh platform a little below the hub. From here, you are very aware of how the station rotates, but everything is okay as long as you don't look down [1].

You can see a red circuit breaker here.

"[1]" is a footnote. You can type "note 1" to see the first footnote, or "notes" to see all footnotes so far.

>x hub
The station rotates around the hub, which extends out to hold solar panels on the starboard side.

>touch hub
You feel nothing unexpected.

>gonear church
(Church)
Church
It's a church.

* * *

>out
Sector 3: Forest
Trees, a house, and a church. A red pylon stretches up from the ground to the hub of the station.

>x hub
The station rotates around the hub, which extends out to hold solar panels on the starboard side. On the inside, there is a mesh maintenance platform.

>touch hub
You are too far away from the hub.

* * *

>x me
As good-looking as ever.

* * *

>xyzzy
Your mother never would have approved of such blasphemy, but you say that word out loud. You feel free, but it still feels a little wrong.

>g
Once was enough.