You awake. You are lonely, so lonely. It was a thousand days ago today. All alone these thousand days. Your parents were the last. No, your father was the last. He held on for nearly a hundred days longer. No, you are the last. Alone. Adrift.

But maybe it isn't hopeless. There must still be other people in other worlds, and you think you know how to get there.

Today is the day.

Founder's Mercy
A Space Story by Thomas Insel
Release 1 / Serial number 181123 / Inform 7 build 6M62 (I6/v6.33 lib 6/12N) SD
Type "about" for credits and more information.

Home
The room where you've slept your entire life. You can go out towards the crops.

There is a secured hatch in the floor.

>* minimal walkthrough
(Noted.)

>d
(first opening the floor hatch)
You scramble down through the hatch and close it behind yourself.

Cellar
A decompression shelter and space for storage.

There is a secured hatch in the ceiling.

There is an emergency mask hanging on the wall.

* * *

>in
School
One broken learning machine remains in a corner, but mostly the older farmers took turns leading the class. There is a desk and a chalkboard hangs on one wall.

On the desk is a clean eraser.

>get eraser
Taken.

* * *

>search crate
You find an instruction module.
(putting the dusty eraser into your pocket to make room)

>g
You find a pressure regulator module.
(putting the power module into your pocket to make room)

>get boots
(putting the instruction module into your pocket to make room)
Taken.

* * *

>enter pond
WIth the air from the emergency mask, you breathe comfortably as you step into the pond. At the bottom, you find a green circuit breaker and flip it on.

[Your score has just gone up by ten points.]

>asw
You walk a little ways to the next sector.

Sector 1: Crops
You still maintain the crops here. There is a small graveyard and the barn remains from when this was the livestock sector. A pylon stretches up from the ground to the hub of the station. You can walk spinward or antispinward.

There is a secured hatch in the ground.

You have walked the entire ring. Everything is as expected, much is not working. Now, it's time to leave. The pods are below Sector 1.

>d
(first opening the floor hatch)
You scramble down through the hatch and close it behind yourself.

Pod Control
This room serves as an airlock for the pod bay, and holds an old space suit and various machinery such as the atmosphere pump. There is a brass plaque on the wall.

There is a secured hatch in the ceiling.

Beside the secured port hatch, a status display shows an error message.

>scanner, open pump
Opening.

The atmosphere pump swings open.

>get all from pump
power module: Taken.
pressure regulator module: (putting the pressure regulator module into your pocket to make room)
Taken.

>scan regulator
Component is faulty.

* * *

>scan unscanned regulator
Component is functional.

>put functional regulator in pump
(first taking the functional pressure regulator module)
(putting the dusty eraser into your pocket to make room)
You put the functional pressure regulator module into the atmosphere pump.

>scan power module
Component is faulty.

* * *

>put functional power module in pump
(first taking the functional power module)
You put the functional power module into the atmosphere pump.

>close pump
You close the atmosphere pump and it begins to hum.

It is time to say goodbye to the station. You are ready to leave in a pod.

[Your score has just gone up by five points.]

>port
(first opening the wall hatch)
You close the hatch behind yourself.

Pod Bay
There are four berths for transit pods. Sadly, all are empty.

A secured hatch leads starboard.

Someone left a communications unit on the floor.

This is troubling. You counted. You were sure there would be one pod left for you, but there are none.

[Your score has just gone up by ten points.]

>get communications unit
Taken.

* * *

>sw
You walk a little ways to the next sector.

Sector 3: Forest
Trees, a house, and a church. A red pylon stretches up from the ground to the hub of the station. You can walk spinward or antispinward.

>go church
Church
Before everyone left or died, you celebrated every sabbath here. The altar stands against one wall, and an organ stands against the other.

On the altar is The Founder's Testament.

You can also see an audio unit and a gray cable (plugged into the organ and an audio unit) here.

>unplug cable from organ
You unplug the gray cable from the organ.

>plug cable into comms unit
You plug the gray cable into the communications unit.

>scanner, open audio
Opening.

The audio unit swings open.

>get power module from audio
(putting the faulty pressure regulator module into your pocket to make room)
Taken.

>put functional power into audio
You put the functional power module into the audio unit.

>close audio
You close the audio unit and it seals without any trace of a seam.

With the communications unit and attached to a functional audio unit, you call for help. I need to write this bit.

    *** You win. ***

In that game you scored 50 out of a possible 50, in 54 turns.

Would you like to RESTART, RESTORE a saved game, QUIT, or UNDO the last command?

>x me
Please give one of the answers above.

Would you like to RESTART, RESTORE a saved game, QUIT, or UNDO the last command?

* * *

>* scratch
(Noted.)

>cut me
Imperfect vessel that you are, that is not the answer.

>burn me
There is no open flame on the station.

>pray
You sing a hymn about virtue.

>turn scanner on
It isn't something you can switch.

>turn scanner of
I only understood you as far as wanting to turn the scanner.

* * *

>* scratch
(Noted.)

>gonear pond
Sector 2: Aquaculture
A deep pond is used as part of the water filtration system and for raising fish. You can walk spinward or antispinward.

>taste pond
It's a bit fishy.

>drink pond
It's a bit fishy.

>eat pond
That's plainly inedible.

>look
Sector 2: Aquaculture
A deep pond is used as part of the water filtration system and for raising fish. You can walk spinward or antispinward.

>look
Sector 2: Aquaculture
A deep pond is used as part of the water filtration system and for raising fish. You can walk spinward or antispinward.

>x pond
Something to do with water filtration, and there are still some fish.

>enter pond
You can't hold your breath long enough to make that worthwhile.

>swim in pond
You can't hold your breath long enough to make that worthwhile.

>search pond
The pond is pretty murky, but you can see a few fish from here.

>x fish
There are still a few fish swimming in the pond, but they taste horrible.

* * *

>get fish
The fish aren't easy to catch.

>look
Sector 2: Aquaculture
A deep pond is used as part of the water filtration system and for raising fish. You can walk spinward or antispinward.

>touch fish
The fish aren't easy to catch.

>kiss fish
You can only do that to something animate.

* * *

>* scratch
(Noted.)

>hit me
The Founder said that violence is never the answer.

>out
Sector 4: Crops
Your home is here among the crops. You can walk spinward or antispinward.

* * *

>in
School
One broken learning machine remains in a corner, but mostly the older farmers took turns leading the class. There is a desk and a chalkboard hangs on one wall.

On the desk is a clean eraser.

>hit eraser
(first taking the clean eraser)
Nothing happens.

>get eraser
You already have that.

>erase board
(with the eraser)
You carefully erase the chalkboard.

>i
You are carrying:
  a dusty eraser
  a scanner
  a green jumpsuit (being worn)

>hit eraser
You fill the room with a cloud of dust, which quickly clears.

>look
School
One broken learning machine remains in a corner, but mostly the older farmers took turns leading the class. There is a desk and a chalkboard hangs on one wall.

* * *

>* scratch
(Noted.)

>kiss scanner
You can only do that to something animate.

>kiss me
You don't get much from that.

>i
You are carrying:
  a scanner
  a green jumpsuit (being worn)

>out
Sector 4: Crops
Your home is here among the crops. You can walk spinward or antispinward.

* * *

>sw
You walk a little ways to the next sector.

Sector 5: Forest
The school house is nestled among the trees. A pylon stretches up from the same grove to the hub of the station. You can walk spinward or antispinward.

>go house
School
One broken learning machine remains in a corner, but mostly the older farmers took turns leading the class. There is a desk and a chalkboard hangs on one wall.

On the desk is a clean eraser.

>out
Sector 5: Forest
The school house is nestled among the trees. A pylon stretches up from the same grove to the hub of the station. You can walk spinward or antispinward.

* * *

>asw
You walk a little ways to the next sector.

Sector 3: Forest
Trees, a house, and a church. A red pylon stretches up from the ground to the hub of the station. You can walk spinward or antispinward.

>go house
House
Two families lived here, but not recently.

Someone has left a doll on the well swept floor.

>out
Sector 3: Forest
Trees, a house, and a church. A red pylon stretches up from the ground to the hub of the station. You can walk spinward or antispinward.

>sw
You walk a little ways to the next sector.

Sector 4: Crops
Your home is here among the crops. You can walk spinward or antispinward.

>in
Home
The room where you've slept your entire life. You can go out towards the crops.

There is a secured hatch in the floor.

>unlock hatch
What do you want to unlock the floor hatch with?

>i
You are carrying:
  a scanner
  a green jumpsuit (being worn)

>unlock door
You can't see any such thing.

>out
Sector 4: Crops
Your home is here among the crops. You can walk spinward or antispinward.

>unlock door
You can't see any such thing.

>out
But you aren't in anything at the moment.

>unlock house
What do you want to unlock your home with?

>lock house
What do you want to lock your home with?

>open house
It isn't something you can open.

>look
Sector 4: Crops
Your home is here among the crops. You can walk spinward or antispinward.

>out
But you aren't in anything at the moment.

>analyze scanner
examining the scanner:
The handheld voice-activated scanner you use when working on the station's machines.

[You can ask the scanner for a list of commands by typing "scanner, help" and give it voice commands by typing phrases such as "scanner, scan SOMETHING" or "scanner, open SOMETHING" where SOMETHING is a visible object.]

looking under the scanner:
You find nothing of interest.

searching the scanner:
You find nothing of interest.

listening to the scanner:
You hear nothing unexpected.

smelling the scanner:
You smell nothing unexpected.

attacking the scanner:
The Founder said that violence is never the answer.

buying the scanner:
Nothing is on sale.

climbing the scanner:
Little is to be achieved by that.

pulling the scanner:
Nothing obvious happens.

pushing the scanner:
Nothing obvious happens.

turning the scanner:
Nothing obvious happens.

pushing the scanner to antispinward:
The scanner cannot be pushed from place to place.

opening the scanner:
It isn't something you can open.

entering the scanner:
That's not something you can enter.

getting off the scanner:
But you aren't on the scanner at the moment.

closing the scanner:
It isn't something you can close.

taking the scanner:
You already have that.

switching on the scanner:
It isn't something you can switch.

switching off the scanner:
It isn't something you can switch.

wearing the scanner:
You can't wear that!

taking off the scanner:
You aren't wearing the scanner.

(no other people in the location; can't test throwing at.)

(no other people in the location; can't test showing to.)

(no other people in the location; can't test giving to.)

touching the scanner:
You feel nothing unexpected.

rubbing the scanner:
You rub the scanner.

waving the scanner:
You wave the scanner.

squeezing the scanner:
You achieve nothing by this.

burning the scanner:
This dangerous act would achieve little.

cutting the scanner:
Cutting it up would achieve little.

tying the scanner to the vegetables:
You would achieve nothing by this.

swinging the scanner:
There's nothing sensible to swing here.

tasting the scanner:
You taste nothing unexpected.

drinking the scanner:
There's nothing suitable to drink here.

eating the scanner:
That's plainly inedible.

dropping the scanner:
Dropped.

>out
But you aren't in anything at the moment.

>look
Sector 4: Crops
Your home is here among the crops. You can walk spinward or antispinward.

You can see a scanner here.

>sw
You walk a little ways to the next sector.

Sector 5: Forest
The school house is nestled among the trees. A pylon stretches up from the same grove to the hub of the station. You can walk spinward or antispinward.

>analyze forest
examining the some trees:
The community grew trees for tradition, or maybe they help with air processing.

looking under the some trees:
You find nothing of interest.

searching the some trees:
You find nothing of interest.

listening to the some trees:
You hear nothing unexpected.

smelling the some trees:
You smell nothing unexpected.

attacking the some trees:
The Founder said that violence is never the answer.

buying the some trees:
Nothing is on sale.

climbing the some trees:
You can't get a good grip.

pulling the some trees:
They are fixed in place.

pushing the some trees:
They are fixed in place.

turning the some trees:
They are fixed in place.

pushing the some trees to spinward:
The some trees cannot be pushed from place to place.

opening the some trees:
They aren't something you can open.

entering the some trees:
They're not something you can enter.

getting off the some trees:
But you aren't on the some trees at the moment.

closing the some trees:
They aren't something you can close.

taking the some trees:
They're hardly portable.

switching on the some trees:
They aren't something you can switch.

switching off the some trees:
They aren't something you can switch.

wearing the some trees:
(first taking the some trees)
They're hardly portable.

taking off the some trees:
You aren't wearing the some trees.

touching the some trees:
You feel nothing unexpected.

rubbing the some trees:
You rub the some trees.

waving the some trees:
But you aren't holding those.

squeezing the some trees:
You achieve nothing by this.

burning the some trees:
This dangerous act would achieve little.

cutting the some trees:
Cutting them up would achieve little.

tying the some trees to the school building:
You would achieve nothing by this.

swinging the some trees:
There's nothing sensible to swing here.

tasting the some trees:
You taste nothing unexpected.

drinking the some trees:
There's nothing suitable to drink here.

eating the some trees:
They're plainly inedible.

dropping the some trees:
The some trees are already here.

* * *

>* scratch
(Noted.)

>look
Home
The room where you've slept your entire life. You can go out towards the crops.

There is a secured hatch in the floor.

>d
(first opening the floor hatch)
You scramble down through the hatch and close it behind yourself.

Cellar
Used for storage and as a decompression shelter.

There is a secured hatch in the ceiling.

There is an emergency mask hanging on the wall.

>i
You are carrying:
  a scanner
  a green jumpsuit (being worn)

>x scanner
The handheld voice-activated scanner you use to scan electronic modules on the station.

[You can ask the scanner for a list of commands by typing "scanner, help" and give it voice commands by typing phrases such as "scanner, scan SOMETHING" or "scanner, open SOMETHING" where SOMETHING is a visible object.]

>i
You are carrying:
  a scanner
  a green jumpsuit (being worn)

>look
Cellar
Used for storage and as a decompression shelter.

There is a secured hatch in the ceiling.

There is an emergency mask hanging on the wall.

>x scanner
The handheld voice-activated scanner you use to scan electronic modules on the station.

>look
Cellar
Used for storage and as a decompression shelter.

There is a secured hatch in the ceiling.

There is an emergency mask hanging on the wall.

* * *

>* scratch
(Noted.)

>u
You can't go that way.

>d
(first opening the floor hatch)
You scramble down through the hatch and close it behind yourself.

Cellar
Used for storage and as a decompression shelter.

There is a secured hatch in the ceiling.

There is an emergency mask hanging on the wall.

* * *

>about
About Founder's Mercy
Founder's Mercy is my second released Inform project, conceived and implemented in November of 2018. It should be impossible to put this game into an unwinnable state.

Thanks to Graham Nelson, Andrew Plotkin, Emily Short, and everyone else who worked on the Inform and Glulx ecosystem. Thanks also to Eric Eve for the Exit Lister extension, Juhana Leinonen for the Object Response Tests extension, and Sean Turner for the Plugs and Sockets extension. The cover art is adapted from Figure 1.1 from NASA SP-413, Space Settlements: A Design Study, edited by Richard D. Johnson and Charles Holbrow, and available from The Internet Archive at https://archive.org/details/SpaceSettlementsADesignStudy1977 .

Please send your feedback, bug reports, and requests for help to tinsel@tinsel.org. You can always find the current version of this game at http://tinsel.org/IF/ .

This work is Copyright © 2018 Thomas Insel but may be freely shared according to the terms of the Creative Commons Attribution 4.0 International license (https://creativecommons.org/licenses/by/4.0/).

>hint
That's not a verb I recognize.

>help
That's not a verb I recognize.

>look
Home
The room where you've slept your entire life. You can go out towards the crops.

There is a secured hatch in the floor.

* * *

>version
Founder's Mercy
A Space Story by Thomas Insel
Release 1 / Serial number 181123 / Inform 7 build 6M62 (I6/v6.33 lib 6/12N) SD
Type "about" for credits and more information.
Identification number: //BCC61E7F-CE8E-4C25-9E9D-5550D1138D8C//
Interpreter version 0.5.2 / VM 3.1.2 / Library serial number 080126
Standard Rules version 3/120430 by Graham Nelson
Unicode Character Names by Graham Nelson
Exit Lister version 11 by Eric Eve
Plugs and Sockets version 4 by Sean Turner
Object Response Tests version 7 by Juhana Leinonen

>gonear organ
Church
Before everyone left or died, you celebrated every sabbath here. The altar stands against one wall, and an organ stands against the other.

On the altar is The Founder's Testament.

You can also see the audio unit and a gray cable (plugged into the organ and the audio unit) here.

>x cable
It's a USB 7.2 Type-F cable.

It is plugged into the organ and the audio unit.

>x organ
It's really just a keyboard. It has a single socket you would use to connect it to an audio unit.

The organ has a gray cable plugged into it.

>score
You have so far scored 0 out of a possible 50, in 4 turns.

>about
About Founder's Mercy
Founder's Mercy is my second released Inform project, conceived and implemented in November of 2018. It should be impossible to put this game into an unwinnable state.

Thanks also to Graham Nelson, Andrew Plotkin, Emily Short, and everyone else who worked on the Inform and Glulx ecosystem. Thanks also to Eric Eve for the Exit Lister extension, Juhana Leinonen for the Object Response Tests extension, and Sean Turner for the Plugs and Sockets extension. The cover art is adapted from Figure 1.1 from NASA SP-413, Space Settlements: A Design Study, edited by Richard D. Johnson and Charles Holbrow, and available from The Internet Archive at https://archive.org/details/SpaceSettlementsADesignStudy1977 .

Please send your feedback, bug reports, and requests for help to tinsel@tinsel.org. You can always find the current version of this game at http://tinsel.org/IF/ .

This work is Copyright © 2018 Thomas Insel but may be freely shared according to the terms of the Creative Commons Attribution 4.0 International license (https://creativecommons.org/licenses/by/4.0/).

* * *

>analyze me
examining yourself:
As virtuous as ever.

looking under yourself:
You find nothing of interest.

searching yourself:
You find nothing of interest.

listening to yourself:
You hear nothing unexpected.

smelling yourself:
You smell nothing unexpected.

attacking yourself:
The Founder said that violence is never the answer.

buying yourself:
Nothing is on sale.

climbing yourself:
Little is to be achieved by that.

pulling yourself:
You might not like that.

pushing yourself:
You might not like that.

turning yourself:
You might not like that.

pushing yourself to down:
You cannot be pushed from place to place.

opening yourself:
You aren't something you can open.

entering yourself:
You're not something you can enter.

getting off yourself:
But you aren't on yourself at the moment.

closing yourself:
You aren't something you can close.

taking yourself:
You are always self-possessed.

switching on yourself:
You aren't something you can switch.

switching off yourself:
You aren't something you can switch.

wearing yourself:
(first taking yourself)
You are always self-possessed.

taking off yourself:
You aren't wearing yourself.

throwing the scanner at yourself:
You lack the nerve when it comes to the crucial moment.

showing the scanner to yourself:
The handheld voice-activated scanner you use when working on the station's machines.

[You can ask the scanner for a list of commands by typing "scanner, help" and give it voice commands by typing phrases such as "scanner, scan SOMETHING" or "scanner, open SOMETHING" where SOMETHING is a visible object.]

giving the scanner to yourself:
You can't give the scanner to yourself.

waking yourself:
That seems unnecessary.

kissing yourself:
You don't get much from that.

touching yourself:
You achieve nothing by this.

rubbing yourself:
You rub yourself.

waving yourself:
But you aren't holding you.

squeezing yourself:
You might not like that.

burning yourself:
There is no source of ignition on the station.

cutting yourself:
Imperfect vessel that you are, that is not the answer.

Cutting you up would achieve little.

tying yourself to the floor hatch:
You would achieve nothing by this.

swinging yourself:
There's nothing sensible to swing here.

tasting yourself:
You taste nothing unexpected.

drinking yourself:
There's nothing suitable to drink here.

eating yourself:
You're plainly inedible.

dropping yourself:
You lack the dexterity.

>nounless
taking inventory:
You are carrying:
  a scanner
  a green jumpsuit (being worn)

jumping:
You jump on the spot.

thinking:
What a good idea.

waiting:
Time passes.

sleeping:
You aren't feeling especially drowsy.

waking up:
The dreadful truth is, this is not a dream.

waving hands:
You wave.

saying yes:
That was a rhetorical question.

saying no:
That was a rhetorical question.

nounless listening:
You hear nothing unexpected.

nounless smelling:
You smell nothing unexpected.

* * *

I beg your pardon?

>cut me
Imperfect vessel that you are, that is not the answer.

Cutting you up would achieve little.

* * *

>attack me
Imperfect vessel that you are, that is not the answer.

>cut me
Imperfect vessel that you are, that is not the answer.

>attack hatch
The Founder said that violence is never the answer.

>hit hatch
The Founder said that violence is never the answer.

>analyze hatch
examining the floor hatch:
You have been well-trained, because the hatch in the floor is secured shut.

looking under the floor hatch:
You find nothing of interest.

searching the floor hatch:
You find nothing of interest.

listening to the floor hatch:
You hear nothing unexpected.

smelling the floor hatch:
You smell nothing unexpected.

attacking the floor hatch:
The Founder said that violence is never the answer.

buying the floor hatch:
Nothing is on sale.

climbing the floor hatch:
Little is to be achieved by that.

pulling the floor hatch:
It is fixed in place.

pushing the floor hatch:
It is fixed in place.

turning the floor hatch:
It is fixed in place.

pushing the floor hatch to down:
the floor hatch cannot be pushed from place to place.

opening the floor hatch:
You open the floor hatch.

entering the floor hatch:
Cellar
A decompression shelter and space for storage.

There is an open hatch in the ceiling.

There is an emergency mask hanging on the wall.

getting off the ceiling hatch:
But you aren't on the ceiling hatch at the moment.

closing the ceiling hatch:
You close the ceiling hatch.

taking the ceiling hatch:
That's fixed in place.

switching on the ceiling hatch:
It isn't something you can switch.

switching off the ceiling hatch:
It isn't something you can switch.

wearing the ceiling hatch:
(first taking the ceiling hatch)
That's fixed in place.

taking off the ceiling hatch:
You aren't wearing the ceiling hatch.

touching the ceiling hatch:
You feel nothing unexpected.

rubbing the ceiling hatch:
You rub the ceiling hatch.

waving the ceiling hatch:
But you aren't holding that.

squeezing the ceiling hatch:
You achieve nothing by this.

burning the ceiling hatch:
There is no open flame on the station.

cutting the ceiling hatch:
Cutting it up would achieve little.

tying the ceiling hatch to the emergency mask:
You would achieve nothing by this.

swinging the ceiling hatch:
There's nothing sensible to swing here.

tasting the ceiling hatch:
You taste nothing unexpected.

drinking the ceiling hatch:
There's nothing suitable to drink here.

eating the ceiling hatch:
That's plainly inedible.

dropping the ceiling hatch:
the ceiling hatch is already here.

* * *

>burn hatch
x.

* * *

>burn me
There is no open flame on the station.

>cut me
Imperfect vessel that you are, that is not the answer.

>cut door
You can't see any such thing.

>cut hatch
The Founder said that violence is never the answer.

>listen
You hear nothing unexpected.

>listen to me
You hear nothing unexpected.

* * *

>goear boots
That's not a verb I recognize.

>gonear boots
Supply Vault
This room is dim, quiet, and stuffy. There is still a crate of machine parts left.

There is a secured hatch in the ceiling.

You can also see some pair of gravity boots, the organ, the communications unit, the audio unit, a grey cable (plugged into the organ and the audio unit), and a meter here.

>x organ
You see nothing special about the organ.

The organ has a grey cable plugged into it.

>play organ
That's not a verb I recognize.

* * *

>gonear audio
Supply Vault
This room is dim, quiet, and stuffy. There is still a crate of machine parts left.

There is a secured hatch in the ceiling.

You can also see some pair of gravity boots, the organ, the communications unit, the audio unit, and a gray cable (plugged into the organ and the audio unit) here.

>scan audio
Machine failed.

>scan comms
Machine functional. No output available.

>remove cable from organ
You unplug the gray cable from the organ.

>plug cable into comms
You plug the gray cable into the communications unit.

>x comms
The communications unit is attached to the wall and has a single socket you would use to connect it to an audio unit.

The communications unit has a gray cable plugged into it.

>scan comms
Machine functional. Input and output connected.

>scan audio
Machine failed.

>open audio
You will need to use the scanner to do that.

>scanner, open audio
Opening.

The audio unit swings open.

>scan audio
Machine failed.

>x audio
The portable audio unit incorporates a speaker, a microphone, and a single socket you would use to connect it to another device.

In the audio unit is a power module.

The audio unit has a gray cable plugged into it.

>get power module
Taken.

>scan it
Component is faulty.

>purloin unscanned audio modules
There seems to be no such object anywhere in the model world.

>purloin unscanned power modules
[Purloined.]
[Purloined.]

>i
You are carrying:
  two unscanned power modules
  a faulty power module
  a scanner
  a green jumpsuit (being worn)

>scan unscanned module
Component is functional.

>g
Component is faulty.

>g
You can't see any such thing.

>look
Supply Vault
This room is dim, quiet, and stuffy. There is still a crate of machine parts left.

There is a secured hatch in the ceiling.

You can also see some pair of gravity boots, the organ, the communications unit, the audio unit (empty), and a gray cable (plugged into the communications unit and the audio unit) here.

>i
You are carrying:
  a functional power module
  two faulty power modules
  a scanner
  a green jumpsuit (being worn)

>put functional power module in audio unit
You put the functional power module into the audio unit.

>close audio unit
You close the audio unit and it seals without any trace of a seam.

You call for help.

    *** You win. ***

In that game you scored 10 out of a possible 50, in 21 turns.

Would you like to RESTART, RESTORE a saved game, QUIT, or UNDO the last command?

* * *

>gonear audio unit
Supply Vault
This room is dim, quiet, and stuffy. There is still a crate of machine parts left.

There is a secured hatch in the ceiling.

You can also see some pair of gravity boots, the organ, the communications unit, the audio unit, and a gray cable (plugged into the organ and the audio unit) here.

>showme audio
audio unit - machine
    usb socket (part of audio unit) - usb socket
    power module - power module
location: in Supply Vault
singular-named, improper-named; unlit, inedible, portable; opaque, closed, openable, unlocked; list grouping key: none
printed name: "audio unit"
printed plural name: "machines"
indefinite article: "the"
description: "The portable audio unit incorporates a speaker, a microphone, and a single socket you would use to connect it to another device."
initial appearance: none
carrying capacity: 1

>scan audio
Machine failed.

* * *

>gonear boots
Supply Vault
This room is dim, quiet, and stuffy. There is still a crate of machine parts left.

There is a secured hatch in the ceiling.

You can also see some pair of gravity boots, the organ, the communications unit, the audio unit, and a grey cable (plugged into the organ and the audio unit) here.

>scan audio unit
Machine failed.

>scan communications unit
No modular technology detected.

>scanner, open audio unit
Machine is unitary.

* * *

>scan audio unit
Machine failed.

>scanner, open audio unit
Opening.

The audio unit swings open.

>purloin all power units
There seems to be no such object anywhere in the model world.

>purloin all power modules
[Purloined.]
[Purloined.]

>i
You are carrying:
  two power modules
  a scanner
  a green jumpsuit (being worn)

>scan power module
Component is functional.

>g
Which do you mean, the functional power module or the unscanned power module?

>unscanned
Component is faulty.

>look
Supply Vault
This room is dim, quiet, and stuffy. There is still a crate of machine parts left.

There is a secured hatch in the ceiling.

You can also see some pair of gravity boots, the organ, the communications unit, the audio unit (empty), a grey cable (plugged into the organ and the audio unit), and a meter here.

>x audio module
I only understood you as far as wanting to examine the audio unit.

>x audio unit
The portable audio unit is a standardized machine component which includes both speaker/amplifier and microphone functionality, although only the first is used with the organ.

There is space for one more module.

The audio unit has a grey cable plugged into it.

>get audio unit
(putting the scanner into your pocket to make room)
Taken.

>i
You are carrying:
  the audio unit (open but empty)
  a functional power module
  a faulty power module
  a green jumpsuit (being worn)

Your jumpsuit pocket contains:
  a scanner

>x audio unit
The portable audio unit is a standardized machine component which includes both speaker/amplifier and microphone functionality, although only the first is used with the organ.

There is space for one more module.

The audio unit has a grey cable plugged into it.

>put functional power in audio unit
You put the functional power module into the audio unit.

>close audio
You close the audio unit and it seals without any trace of a seam.

>x audio
The portable audio unit is a standardized machine component which includes both speaker/amplifier and microphone functionality, although only the first is used with the organ.

The audio unit has a grey cable plugged into it.

>scan audio
Machine function. Input connected.

>showme audio
audio unit - machine
    USB-socket (part of audio unit) - USB-socket
    functional power module - power module
location: carried by yourself in Supply Vault
singular-named, improper-named; unlit, inedible, portable, handled; opaque, closed, openable, unlocked; list grouping key: none
printed name: "audio unit"
printed plural name: "machines"
indefinite article: "the"
description: "The portable audio unit is a standardized machine component which includes both speaker/amplifier and microphone functionality, although only the first is used with the organ."
initial appearance: none
carrying capacity: 1

>scan organ
Machine functional. Output connected.

>look
Supply Vault
This room is dim, quiet, and stuffy. There is still a crate of machine parts left.

There is a secured hatch in the ceiling.

You can also see some pair of gravity boots, the organ, the communications unit, a grey cable (plugged into the organ and the audio unit), and a meter here.

>scan organ
Machine functional. Output connected.

>scan audio
Machine function. Input connected.

>unplug cable from organ
You unplug the grey cable from the organ.

>plug cable into communications
You plug the grey cable into the communications unit.

>scan organ
Machine functional. No connection.

>scan communications
Machine function. Input and output connected.

>scan audio
Machine function. Input and output connected.

>scan meter
No modular technology detected.

>x meter
Audio/Comms!

>scan cable
No modular technology detected.

>look
Supply Vault
This room is dim, quiet, and stuffy. There is still a crate of machine parts left.

There is a secured hatch in the ceiling.

You can also see some pair of gravity boots, the organ, the communications unit, a grey cable (plugged into the communications unit and the audio unit), and a meter here.

* * *

>gonear church
(Church)
Church
Before everyone left or died, you celebrated every sabbath here. The altar stands against the far wall.

On the altar is The Founder's Testament.

>drop church
You can't see any such thing.

>out
Sector 3: Forest
Trees, a house, and a church. A red pylon stretches up from the ground to the hub of the station. You can walk spinward or antispinward.

>drop church
the church is already here.

* * *

>gonear organ
Church
Before everyone left or died, you celebrated every sabbath here. The altar stands against one wall, and an organ stands against the other.

On the altar is The Founder's Testament.

You can also see the audio unit and a gray cable (plugged into the organ and the audio unit) here.

>disconnect gray
The gray cable is plugged into more than one thing.

[Try "unplug gray cable from SOMETHING".]

>connect
That's not a verb I recognize.

* * *

>disconnect gray
The gray cable is plugged into more than one thing.

[Try "unplug gray cable from SOMETHING".]

>remove gray
The gray cable is plugged into more than one thing.

[Try "unplug gray cable from SOMETHING".]

* * *

>gonear organ
Church
Before everyone left or died, you celebrated every sabbath here. The altar stands against one wall, and an organ stands against the other.

On the altar is The Founder's Testament.

You can also see the audio unit and a gray cable (plugged into the organ and the audio unit) here.

>disconnect gray cable
That's not a verb I recognize.

>remove gray cable
The gray cable is plugged into more than one thing.

[Try "unplug gray cable from SOMETHING".]

>undo
Church
[Previous turn undone.]

* * *

>gonear organ
Church
Before everyone left or died, you celebrated every sabbath here. The altar stands against one wall, and an organ stands against the other.

On the altar is The Founder's Testament.

You can also see the audio unit and a gray cable (plugged into the organ and the audio unit) here.

>play organ
Nothing happens.

>look
Supply Vault
This room is dim, quiet, and stuffy. There is still a crate of machine parts left.

There is a secured hatch in the ceiling.

You can also see some pair of gravity boots, the organ, the communications unit, the audio unit, and a gray cable (plugged into the organ and the audio unit) here.

* * *

>play organ
Nothing happens.

>scan organ
Machine functional. No connection.

* * *

>gonear organ
Church
Before everyone left or died, you celebrated every sabbath here. The altar stands against one wall, and an organ stands against the other.

On the altar is The Founder's Testament.

You can also see the audio unit and a gray cable (plugged into the organ and the audio unit) here.

>remove gray from organ
You unplug the gray cable from the organ.

>connect gray to comms
You can't see any such thing.

>purloin comms
[Purloined.]

>connect gray to comms
You plug the gray cable into the communications unit.

>look
Church
Before everyone left or died, you celebrated every sabbath here. The altar stands against one wall, and an organ stands against the other.

On the altar is The Founder's Testament.

You can also see the audio unit and a gray cable (plugged into the communications unit and the audio unit) here.

>out
It is impractical to leave with the communications unit attached to the gray cable.

>drop comms
Dropped.

>out
Sector 3: Forest
Trees, a house, and a church. A red pylon stretches up from the ground to the hub of the station. You can walk spinward or antispinward.

>in
You can enter the church or the house.

>go church
Church
Before everyone left or died, you celebrated every sabbath here. The altar stands against one wall, and an organ stands against the other.

On the altar is The Founder's Testament.

You can also see the communications unit, the audio unit, and a gray cable (plugged into the communications unit and the audio unit) here.

>x gray cable
It's a USB 7.2 Type-F cable.

It is plugged into the communications unit and the audio unit.

* * *

>gonear organ
Church
Before everyone left or died, you celebrated every sabbath here. The altar stands against one wall, and an organ stands against the other.

On the altar is The Founder's Testament.

You can also see the audio unit and a gray cable (plugged into the organ and the audio unit) here.

>scan organ
Machine functional. No output available.

>scan audio
Machine failed.

>scan communications
Machine function. No output available.

>x organ
You see nothing special about the organ.

The organ has a gray cable plugged into it.

>x audio
The portable audio unit is a standardized machine component which includes both speaker/amplifier and microphone functionality. It has a single socket you would use to connect it to another device.

The audio unit has a gray cable plugged into it.

>x comms
You can't see any such thing.

>x communications
You see nothing special about the communications unit.

The communications unit has nothing plugged into it.

* * *

>gonear organ
Church
Before everyone left or died, you celebrated every sabbath here. The altar stands against one wall, and an organ stands against the other.

On the altar is The Founder's Testament.

You can also see the audio unit and a gray cable (plugged into the organ and the audio unit) here.

>scanner, open audio
Opening.

The audio unit swings open.

>purloin power units
There seems to be no such object anywhere in the model world.

>x audio
The portable audio unit incorporates a speaker, a microphone, and a single socket you would use to connect it to another device.

There is space for one more module.

The audio unit has a gray cable plugged into it.

* * *

>gonear organ
Church
Before everyone left or died, you celebrated every sabbath here. The altar stands against one wall, and an organ stands against the other.

On the altar is The Founder's Testament.

You can also see the audio unit and a gray cable (plugged into the organ and the audio unit) here.

>undo
Home
[Previous turn undone.]

* * *

>gonear organ
Church
Before everyone left or died, you celebrated every sabbath here. The altar stands against one wall, and an organ stands against the other.

On the altar is The Founder's Testament.

You can also see the audio unit and a gray cable (plugged into the organ and the audio unit) here.

>x audio
The audio unit incorporates a speaker, a microphone, and a single socket you would use to connect it to another device.

The audio unit has a gray cable plugged into it.

>x audio
The audio unit incorporates a speaker, a microphone, and a single socket you would use to connect it to another device.

The audio unit has a gray cable plugged into it.

>scan audio
Machine failed.

>look
Supply Vault
This room is dim, quiet, and stuffy. There is still a crate of machine parts left.

There is a secured hatch in the ceiling.

You can also see some pair of gravity boots, the organ, the communications unit, the audio unit, and a gray cable (plugged into the organ and the audio unit) here.

>scan communications
Machine functional. No output available.

>san organ
That's not a verb I recognize.

>scan organ
Machine functional. No output available.

* * *

>x cable
It's a USB 7.2 Type-F cable.

It is plugged into the organ and the audio unit.

>unplug cable from orga
You can't see any such thing.

>unplug cable from orgab
You can't see any such thing.

>unplug cable from organ
You unplug the gray cable from the organ.

>plug cable into comms
You plug the gray cable into the communications unit.

You call for help.

    *** You win. ***

In that game you scored 10 out of a possible 50, in 4 turns.

Would you like to RESTART, RESTORE a saved game, QUIT, or UNDO the last command?

>undo
Supply Vault
[Previous turn undone.]

>scan comms
Machine function. No output available.

* * *

>gonear organ
Church
Before everyone left or died, you celebrated every sabbath here. The altar stands against one wall, and an organ stands against the other.

On the altar is The Founder's Testament.

You can also see the audio unit and a gray cable (plugged into the organ and the audio unit) here.

>x organ
It's really just a keyboard. It has a single socket you would use to connect it to an audio unit.

The organ has a gray cable plugged into it.

>look
Supply Vault
This room is dim, quiet, and stuffy. There is still a crate of machine parts left.

There is a secured hatch in the ceiling.

You can also see some pair of gravity boots, the organ, the communications unit, the audio unit, and a gray cable (plugged into the organ and the audio unit) here.

>scan organ
Machine functional. No output available.

>x organ
It's really just a keyboard. It has a single socket you would use to connect it to an audio unit.

The organ has a gray cable plugged into it.

>x socket
It is a female standard connector of the organ. It has the gray cable plugged into it.

>x keyboard
It's really just a keyboard. It has a single socket you would use to connect it to an audio unit.

The organ has a gray cable plugged into it.

>play organ
Nothing happens.

>x organ
It's really just a keyboard. It has a single socket you would use to connect it to an audio unit.

The organ has a gray cable plugged into it.

>x organ's socket
You can't see any such thing.

>x socket
It is a female standard connector of the organ. It has the gray cable plugged into it.

>look
Supply Vault
This room is dim, quiet, and stuffy. There is still a crate of machine parts left.

There is a secured hatch in the ceiling.

You can also see some pair of gravity boots, the organ, the communications unit, the audio unit, and a gray cable (plugged into the organ and the audio unit) here.

>x audio
The portable audio unit incorporates a speaker, a microphone, and a single socket you would use to connect it to another device.

The audio unit has a gray cable plugged into it.

>x communications
The communications unit is attached to the wall and has a single socket you would use to conenct it to an audio unit.

The communications unit has nothing plugged into it.

>x socet
You can't see any such thing.

>x socket
It is a female standard connector of the organ. It has the gray cable plugged into it.

I beg your pardon?

I beg your pardon?

>x organ
It's really just a keyboard. It has a single socket you would use to connect it to an audio unit.

The organ has a gray cable plugged into it.

>x sckt
You can't see any such thing.

>x socket
It is a female standard connector of the organ. It has the gray cable plugged into it.

>x comms
The communications unit is attached to the wall and has a single socket you would use to conenct it to an audio unit.

The communications unit has nothing plugged into it.

>x socket
It is a female standard connector of the organ. It has the gray cable plugged into it.

>x communications unit socket
I only understood you as far as wanting to examine the communications unit.

>showme
Supply Vault - room
    the ceiling hatch - floor hatch
    yourself - person
        scanner
        green jumpsuit (worn)
            pocket (part of green jumpsuit) - open container
    crate of machine parts
    pair of gravity boots
    organ - machine
        usb socket (part of organ) - usb socket
    communications unit - machine
        usb socket (part of communications unit) - usb socket
    audio unit - machine
        usb socket (part of audio unit) - usb socket
    gray cable
        usb plug (part of gray cable) - usb plug
        usb plug (part of gray cable) - usb plug

>x usb socket in the organ
You can't see any such thing.

>x usb socket in the communications
You can't see any such thing.

>x audio unit
The portable audio unit incorporates a speaker, a microphone, and a single socket you would use to connect it to another device.

The audio unit has a gray cable plugged into it.

>get it
Taken.

>version
Founder's Mercy
A Space Story by Thomas Insel
Release 1 / Serial number 181123 / Inform 7 build 6M62 (I6/v6.33 lib 6/12N) SD
Type "about" for credits and more information.
Identification number: //BCC61E7F-CE8E-4C25-9E9D-5550D1138D8C//
Interpreter version 0.5.2 / VM 3.1.2 / Library serial number 080126
Standard Rules version 3/120430 by Graham Nelson
Unicode Character Names by Graham Nelson
Exit Lister version 11 by Eric Eve
Plugs and Sockets version 4 by Sean Turner
Object Response Tests version 7 by Juhana Leinonen

* * *

>x organ
It's really just a keyboard. It has a single socket you would use to connect it to an audio unit.

The organ has a gray cable plugged into it.

>scan organ
Machine functional. No connection.

>x audio
The portable audio unit is a standardized machine component which includes both speaker/amplifier and microphone functionality. It has a single socket you would use to connect it to another device.

There is space for one more module.

The audio unit has a grey cable plugged into it.

>x communications
You see nothing special about the communications unit.

There is space for one hundred more modules.

The communications unit has nothing plugged into it.

>gonear learnong
There seems to be no such object anywhere in the model world.

>gonear learning
School
One broken learning machine remains in a corner, but mostly the older farmers took turns leading the class. There is a desk and a chalkboard hangs on one wall.

On the desk is a clean eraser.

>x learning
This last learning machine broke when you were maybe three thousand days old.

>scanner, open learning
Opening.

The learning machine swings open.

[Your score has just gone up by five points.]

>x learning
This last learning machine broke when you were maybe three thousand days old.

In the learning machine are a power module and an instruction module.

>get all
power module: Taken.
instruction module: Taken.
clean eraser: (putting the scanner into your pocket to make room)
Taken.

>close learning
You close the learning machine and it seals without any trace of a seam.

>x learning
This last learning machine broke when you were maybe three thousand days old.

There is space for two more modules.

* * *

>gonear plaque
Pod Control
This room serves as an airlock for the pod bay, and holds an old space suit and various machinery such as the atmosphere pump. There is a brass plaque on the wall.

There is a secured hatch in the ceiling.

Beside the secured port hatch, a status display shows an error message.

>look
Pod Control
This room serves as an airlock for the pod bay, and holds an old space suit and various machinery such as the atmosphere pump. There is a plaque on the wall.

There is a secured hatch in the ceiling.

Beside the secured port hatch, a status display shows an error message.

>x plaque
It reads "RWSS Founder's Mercy, laid down 2533, launched 2537, May His mercy shine upon us.

>read plaque
It reads "RWSS Founder's Mercy, laid down 2533, launched 2537, May His mercy shine upon us.

* * *

>gonear plaque
Pod Control
This room serves as an airlock for the pod bay, and holds an old space suit and various machinery such as the atmosphere pump. There is a brass plaque on the wall.

There is a secured hatch in the ceiling.

Beside the secured port hatch, a status display shows an error message.

>x plaque
It reads:

    RWSS Founder's Mercy
    Laid down 2533, Launched 2537.
    "May His mercy shine upon us."

>get plaque
That's hardly portable.

>look
Pod Control
This room serves as an airlock for the pod bay, and holds an old space suit and various machinery such as the atmosphere pump. There is a brass plaque on the wall.

There is a secured hatch in the ceiling.

Beside the secured port hatch, a status display shows an error message.

>x plaque
It reads:

    RWSS Founder's Mercy
    Laid down 2533, Launched 2537.
    "May His mercy shine upon us."

>look
Pod Control
This room serves as an airlock for the pod bay, and holds an old space suit and various machinery such as the atmosphere pump. There is a brass plaque on the wall.

There is a secured hatch in the ceiling.

Beside the secured port hatch, a status display shows an error message.

* * *

>gonear red church
There seems to be no such object anywhere in the model world.

>gonear red pylon
Sector 3: Forest
Trees, a house, and a church. A red pylon stretches up from the ground to the hub of the station. You can walk spinward or antispinward.

>drop church
church is already here.

>showme church
(church)
church - building
location: in Sector 3: Forest
singular-named, proper-named; unlit, inedible, fixed in place, scenery; open, unopenable, unlocked, apparent
list grouping key: none
printed name: "church"
printed plural name: "buildings"
indefinite article: none
description: "A small white building with a steeple."
initial appearance: none
other side: Church

>showme scanner
scanner - thing
location: carried by yourself in Sector 3: Forest
singular-named, improper-named; unlit, inedible, portable, handled, machinelike, addressable; list grouping key: none
printed name: "scanner"
printed plural name: none
indefinite article: none
description: "The handheld voice-activated scanner you use when working on the station's machines."
initial appearance: none

* * *

>gonear red pylon
Sector 3: Forest
Trees, a house, and a church. A red pylon stretches up from the ground to the hub of the station. You can walk spinward or antispinward.

>drop church
The church is already here.

>drop building
The church is already here.

>frop house
That's not a verb I recognize.

>drop house
the house is already here.

>as
That's not a verb I recognize.

>asw
You walk a little ways to the next sector.

Sector 2: Aquaculture
A deep pond is used as part of the water filtration system and for raising fish. You can walk spinward or antispinward.

* * *

>asw
You walk a little ways to the next sector.

Sector 1: Crops
You still maintain the crops here. There is a small graveyard and the barn remains from when this was the livestock sector. A pylon stretches up from the ground to the hub of the station. You can walk spinward or antispinward.

There is a secured hatch in the ground.

>sw
You walk a little ways to the next sector.

Sector 2: Aquaculture
A deep pond is used as part of the water filtration system and for raising fish. You can walk spinward or antispinward.

* * *

>sw
You walk a little ways to the next sector.

Sector 4: Crops
Your home is here among the crops. You can walk spinward or antispinward.

>x home
You were told it was built to look like a log cabin on Old Earth.

>drop home
your home is already here.

* * *

>gonear red pylon. drop church
Sector 3: Forest
Trees, a house, and a church. A red pylon stretches up from the ground to the hub of the station. You can walk spinward or antispinward.

church is already here.

>showme church
(church)
church - building
location: in Sector 3: Forest
singular-named, proper-named; unlit, inedible, fixed in place, scenery; open, unopenable, unlocked, apparent
list grouping key: none
printed name: "church"
printed plural name: "buildings"
indefinite article: none
description: "A small white building with a steeple."
initial appearance: none
other side: Church

* * *

>gonear station
There seems to be no such object anywhere in the model world.

>gonear red
(the red circuit breaker)
Center Platform
It's a mesh platform a little below the hub. You feel much lighter here, and you are very aware of how the station rotates, but everything is okay as long as you don't look down.

You can just reach a red circuit breaker on the hub.

>jump
Yes, definitely pseudogravity is much lighter here.

>d
You slide down the pylon.

Sector 3: Forest
Trees, a house, and a church. A red pylon stretches up from the ground to the hub of the station. You can walk spinward or antispinward.

>jump
You jump on the spot.

* * *

>hit me
The Founder said that violence is never the answer.

>cut me
Imperfect vessel that you are, that is not the answer.

* * *

>in
School
One broken learning machine remains in a corner, but mostly the older farmers took turns leading the class. There is a desk and a chalkboard hangs on one wall.

On the desk is a clean eraser.

>hit eraser
The Founder said that violence is never the answer.

>get eraser
Taken.

>hit
What do you want to hit?

>erase boar
You can't see any such thing.

>erase board
(with the eraser)
You carefully erase the chalkboard.

>hit eraser
The Founder said that violence is never the answer.

* * *

>i
You are carrying:
  a scanner
  a green jumpsuit (being worn)

>d
(first opening the floor hatch)
You scramble down through the hatch and close it behind yourself.

Cellar
Used for storage and as a decompression shelter.

There is a secured hatch in the ceiling.

There is an emergency mask hanging on the wall.

* * *

>look
Cellar
Used for storage and as a decompression shelter.

There is a secured hatch in the ceiling.

There is an emergency mask hanging on the wall.

>remove jump suit
Your nudity is pure and innocent, but still a little uncomfortable ... and cold.

>look
Cellar
Used for storage and as a decompression shelter.

There is a secured hatch in the ceiling.

There is an emergency mask hanging on the wall.

>look
Cellar
Used for storage and as a decompression shelter.

There is a secured hatch in the ceiling.

There is an emergency mask hanging on the wall.

>out
But you aren't in anything at the moment.

>u
(first opening the ceiling hatch)
You pull yourself up through the hatch and close it behind yourself.

Home
The room where you've slept your entire life. You can go out towards the crops.

There is a secured hatch in the floor.

* * *

>asw
You walk a little ways to the next sector.

Sector 3: Forest
Trees, a house, and a church. A red pylon stretches up from the ground to the hub of the station. You can walk spinward or antispinward.

>sw
You walk a little ways to the next sector.

Sector 4: Crops
Your home is here among the crops. You can walk spinward or antispinward.

* * *

>in
School
One broken learning machine remains in a corner, but mostly the older farmers took turns leading the class. There is a desk and a chalkboard hangs on one wall.

On the desk is a clean eraser.

>erase board
You smudge the writing around.

* * *

>i
You are carrying:
  a scanner
  a green jumpsuit (being worn)

>x scanner
The handheld voice-activated scanner you use when working on the station's machines.

[You can ask the scanner for a list of commands by typing "scanner, help" and give it voice commands by typing phrases such as "scanner, scan SOMETHING" or "scanner, open SOMETHING" where SOMETHING is a visible object.]

* * *

>listen
You hear only the hum of the station.

>listen to me
You hear nothing unexpected.

>listen
You hear only the hum of the station.

* * *

>listen to me
You hear nothing unexpected.

>listen
You hear nothing unexpected.

>actions
Actions listing on.

>listen
[listening to Home]
You hear nothing unexpected.
[listening to Home - succeeded]

* * *

>look
Home
The room where you've slept your entire life. You can go out towards the crops.

There is a secured hatch in the floor.

>d
(first opening the floor hatch)
You scramble down through the hatch and close it behind yourself.

Cellar
A decompression shelter and space for storage.

There is a secured hatch in the ceiling.

There is an emergency mask hanging on the wall.

>x hatch
There is a secured hatch in the ceiling.

* * *

>look
Home
The room where you've slept your entire life. You can go out towards the crops.

There is a secured hatch in the floor.

>x hatch
You have been well-trained, because the hatch in the floor is secured shut.

>open hatch
You open the floor hatch.

>x hatch
You have been trained to keep hatches closed as a precaution against decompression, but the hatch in the floor is open.

>d
You scramble down through the hatch and close it behind yourself.

Cellar
A decompression shelter and space for storage.

There is a secured hatch in the ceiling.

There is an emergency mask hanging on the wall.

>x hatch
You have been well-trained, because the hatch in the ceiling is secured shut.

>look
Cellar
A decompression shelter and space for storage.

There is a secured hatch in the ceiling.

There is an emergency mask hanging on the wall.

>look
Cellar
A decompression shelter and space for storage.

There is a secured hatch in the ceiling.

There is an emergency mask hanging on the wall.

>gonear pond
Sector 2: Aquaculture
A deep pond is used as part of the water filtration system and for raising fish. You can walk spinward or antispinward.

>eat pond
That's plainly inedible.

>taste pond
You taste nothing unexpected.

* * *

>oout
That's not a verb I recognize.

>out
Sector 4: Crops
Your home is here among the crops. You can walk spinward or antispinward.

* * *

>in
You can enter the church or the house.

>go church
Church
Before everyone left or died, you celebrated every sabbath here. The altar stands against the far wall.

On the altar is The Founder's Testament.

>get testament
Taken.

>i
You are carrying:
  The Founder's Testament
  a scanner
  a green jumpsuit (being worn)

>look
Church
Before everyone left or died, you celebrated every sabbath here. The altar stands against the far wall.

>listen
You hear nothing unexpected.

* * *

>out
Sector 4: Crops
Your home is here among the crops. You can walk spinward or antispinward.

* * *

>asw
You walk a little ways to the next sector.

Sector 2: Aquaculture
A deep pond is used as part of the water filtration system and for raising fish. You can walk spinward or antispinward.

>analyze pond
examining the pond:
Something to do with water filtration, and there are still some fish.

looking under the pond:
The pond is pretty murky, but you can see a few fish from here.

searching the pond:
The pond is pretty murky, but you can see a few fish from here.

listening to the pond:
You hear nothing unexpected.

smelling the pond:
You smell nothing unexpected.

attacking the pond:
The Founder said that violence is never the answer.

buying the pond:
Nothing is on sale.

climbing the pond:
Little is to be achieved by that.

pulling the pond:
It is fixed in place.

pushing the pond:
It is fixed in place.

turning the pond:
It is fixed in place.

pushing the pond to spinward:
The pond cannot be pushed from place to place.

opening the pond:
It isn't something you can open.

entering the pond:
You can't hold your breath long enough to make that worthwhile.

getting off the pond:
But you aren't on the pond at the moment.

closing the pond:
It isn't something you can close.

taking the pond:
That's hardly portable.

switching on the pond:
It isn't something you can switch.

switching off the pond:
It isn't something you can switch.

wearing the pond:
(first taking the pond)
That's hardly portable.

taking off the pond:
You aren't wearing the pond.

touching the pond:
You feel nothing unexpected.

rubbing the pond:
You rub the pond.

waving the pond:
But you aren't holding that.

squeezing the pond:
You achieve nothing by this.

burning the pond:
There is no open flame on the station.

cutting the pond:
The Founder said that violence is never the answer.

tying the pond to the hub:
You would achieve nothing by this.

swinging the pond:
There's nothing sensible to swing here.

tasting the pond:
It's a bit fishy.

drinking the pond:
It's a bit fishy.

eating the pond:
That's plainly inedible.

dropping the pond:
The pond is already here.

>look under pond
The pond is pretty murky, but you can see a few fish from here.

>look under water
The pond is pretty murky, but you can see a few fish from here.

>sw
You walk a little ways to the next sector.

Sector 3: Forest
Trees, a house, and a church. A red pylon stretches up from the ground to the hub of the station. You can walk spinward or antispinward.

>x pylon
Made of smooth metal, anodized red, it connects the ground to the hub of the station many meters above.

>search funder
You can't see any such thing.

>search pylon
You find nothing of interest.

>analyze pylon
examining the pylon:
Made of smooth metal, anodized red, it connects the ground to the hub of the station many meters above.

looking under the pylon:
You find nothing of interest.

searching the pylon:
You find nothing of interest.

listening to the pylon:
You hear nothing unexpected.

smelling the pylon:
You smell nothing unexpected.

attacking the pylon:
The Founder said that violence is never the answer.

buying the pylon:
Nothing is on sale.

climbing the pylon:
The red pylon is designated for climbing, but you can't get a grip.

pulling the pylon:
It is fixed in place.

pushing the pylon:
It is fixed in place.

turning the pylon:
It is fixed in place.

pushing the pylon to port:
the pylon cannot be pushed from place to place.

opening the pylon:
It isn't something you can open.

entering the pylon:
That's not something you can enter.

getting off the pylon:
But you aren't on the pylon at the moment.

closing the pylon:
It isn't something you can close.

taking the pylon:
That's hardly portable.

switching on the pylon:
It isn't something you can switch.

switching off the pylon:
It isn't something you can switch.

wearing the pylon:
(first taking the pylon)
That's hardly portable.

taking off the pylon:
You aren't wearing the pylon.

touching the pylon:
You feel nothing unexpected.

rubbing the pylon:
You rub the pylon.

waving the pylon:
But you aren't holding that.

squeezing the pylon:
You achieve nothing by this.

burning the pylon:
There is no open flame on the station.

cutting the pylon:
The Founder said that violence is never the answer.

tying the pylon to the mirrors:
You would achieve nothing by this.

swinging the pylon:
There's nothing sensible to swing here.

tasting the pylon:
You taste nothing unexpected.

drinking the pylon:
There's nothing suitable to drink here.

eating the pylon:
That's plainly inedible.

dropping the pylon:
the pylon is already here.

>drop me
You lack the dexterity.

>drop school
You can't see any such thing.

>look
Sector 3: Forest
Trees, a house, and a church. A red pylon stretches up from the ground to the hub of the station. You can walk spinward or antispinward.

>drop house
the house is already here.

>drop church
church is already here.

>get church
That's hardly portable.

>i
You are carrying:
  a scanner
  a green jumpsuit (being worn)

>x church
A small white building with a steeple.

>showme church
(church)
church - building
location: in Sector 3: Forest
singular-named, proper-named; unlit, inedible, fixed in place, scenery; open, unopenable, unlocked, apparent
list grouping key: none
printed name: "church"
printed plural name: "buildings"
indefinite article: none
description: "A small white building with a steeple."
initial appearance: none
other side: Church

* * *

>showme scanner
scanner - thing
location: carried by yourself in Sector 3: Forest
singular-named, improper-named; unlit, inedible, portable, handled, machinelike, addressable; list grouping key: none
printed name: "scanner"
printed plural name: none
indefinite article: none
description: "The handheld voice-activated scanner you use when working on the station's machines."
initial appearance: none

>drop scanner
Dropped.

>g
The scanner is already here.

* * *

>asw
You walk a little ways to the next sector.

Sector 3: Forest
Trees, a house, and a church. A red pylon stretches up from the ground to the hub of the station. You can walk spinward or antispinward.

>go church
Church
Before everyone left or died, you celebrated every sabbath here. The altar stands against one wall, and an organ stands against the other.

On the altar is The Founder's Testament.

You can also see the audio unit and a gray cable (plugged into the organ and the audio unit) here.

>x church
You can't see any such thing.

>x altar
You can't see any such thing.

* * *

>go church
Church
Before everyone left or died, you celebrated every sabbath here. The altar stands against one wall, and an organ stands against the other.

On the altar is The Founder's Testament.

You can also see the audio unit and a gray cable (plugged into the organ and the audio unit) here.

>x organ
It's really just a keyboard. It has a single socket you would use to connect it to an audio unit.

The organ has a gray cable plugged into it.

* * *

>go church
Church
Before everyone left or died, you celebrated every sabbath here. The altar stands against one wall, and an organ stands against the other.

On the altar is The Founder's Testament.

You can also see the audio unit and a gray cable (plugged into the organ and the audio unit) here.

>x testament
The Founder's Testament tells how your people left Old Earth and first settled the station. You know the story by heart, and have already derived whatever comfort you can from this book.

>look
Church
Before everyone left or died, you celebrated every sabbath here. The altar stands against one wall, and an organ stands against the other.

On the altar is The Founder's Testament.

You can also see the audio unit and a gray cable (plugged into the organ and the audio unit) here.

* * *

>in
You can enter the church or the house.

>enter church
Church
Before everyone left or died, you celebrated every sabbath here. The altar stands against one wall, and an organ stand against the other.

On the altar is The Founder's Testament.

You can also see the audio unit and a gray cable (plugged into the organ and the audio unit) here.

>x organ
It's really just a keyboard. It has a single socket you would use to connect it to an audio unit.

The organ has a gray cable plugged into it.

* * *

>out
Sector 4: Crops
Your home is here among the crops. You can walk spinward or antispinward.

>drop home
The home is already here.

>showme home
(the home)
home - building
location: in Sector 4: Crops
singular-named, improper-named; unlit, inedible, fixed in place, scenery; open, unopenable, unlocked, apparent
list grouping key: none
printed name: "home"
printed plural name: "buildings"
indefinite article: "your"
description: "You were told it was built to look like a log cabin on Old Earth."
initial appearance: none
other side: Home

* * *

>sw
You walk a little ways to the next sector.

Sector 5: Forest
The school house is nestled among the trees. A pylon stretches up from the same grove to the hub of the station. You can walk spinward or antispinward.

>asw
You walk a little ways to the next sector.

Sector 4: Crops
Your home is here among the crops. You can walk spinward or antispinward.

>asw
You walk a little ways to the next sector.

Sector 3: Forest
Trees, a house, and a church. A red pylon stretches up from the ground to the hub of the station. You can walk spinward or antispinward.

You can see the organ, the audio unit, and a gray cable (plugged into the organ and the audio unit) here.

>go church
Church
Before everyone left or died, you celebrated every sabbath here. The altar stands against the far wall.

On the altar is The Founder's Testament.

* * *

>asw
You walk a little ways to the next sector.

Sector 3: Forest
Trees, a house, and a church. A red pylon stretches up from the ground to the hub of the station. You can walk spinward or antispinward.

You can see the organ, the audio unit, and a gray cable (plugged into the organ and the audio unit) here.

>look under trees
Only the house and church.

* * *

>sw
You walk a little ways to the next sector.

Sector 5: Forest
The school house is nestled among the trees. A pylon stretches up from the same grove to the hub of the station. You can walk spinward or antispinward.

>x trees
The community grew trees for tradition, or maybe they help with air processing.

>sw
You walk a little ways to the next sector.

Sector 6: Hydroponics
Your people prefered to grow things the old fashioned way, but in truth the majority of your fruit and vegetables came from this sector when the machines still worked. You can walk spinward or antispinward.

There is a secured hatch in the ground.

>x hatch
There is a secured hatch in the ground.

>d
(first opening the floor hatch)
You scramble down through the hatch and close it behind yourself.

Supply Vault
This room is dim, quiet, and stuffy. There is still a crate of machine parts left.

There is a secured hatch in the ceiling.

You can also see some pair of gravity boots here.

>x boots
Black work boots with red stripes. They don't really make gravity, but they do stick to some maintenance walkways to help workers get around in low gravity or on the outside of a rotating station.

* * *

>u
An alarm sounds, and a synthesized voice says "Laser scan detects unauthorized materiel removal." The hatch seems to be locked.

>drop boots
Dropped.

>u
(first opening the ceiling hatch)
You pull yourself up through the hatch and close it behind yourself.

Sector 6: Hydroponics
Your people prefered to grow things the old fashioned way, but in truth the majority of your fruit and vegetables came from this sector when the machines still worked. You can walk spinward or antispinward.

There is a secured hatch in the ground.

>look
Sector 6: Hydroponics
Your people prefered to grow things the old fashioned way, but in truth the majority of your fruit and vegetables came from this sector when the machines still worked. You can walk spinward or antispinward.

There is a secured hatch in the ground.

>u
You can't go that way.

>look
Sector 6: Hydroponics
Your people prefered to grow things the old fashioned way, but in truth the majority of your fruit and vegetables came from this sector when the machines still worked. You can walk spinward or antispinward.

There is a secured hatch in the ground.

>look
Sector 6: Hydroponics
Your people prefered to grow things the old fashioned way, but in truth the majority of your fruit and vegetables came from this sector when the machines still worked. You can walk spinward or antispinward.

There is a secured hatch in the ground.

>s hatch
That's not a verb I recognize.

>x hatch
There is a secured hatch in the ground.

>look
Sector 6: Hydroponics
Your people prefered to grow things the old fashioned way, but in truth the majority of your fruit and vegetables came from this sector when the machines still worked. You can walk spinward or antispinward.

There is a secured hatch in the ground.

>open hatch
You open the floor hatch.

>d
You scramble down through the hatch and close it behind yourself.

Supply Vault
This room is dim, quiet, and stuffy. There is still a crate of machine parts left.

There is a secured hatch in the ceiling.

You can also see some pair of gravity boots here.

>u
(first opening the ceiling hatch)
You pull yourself up through the hatch and close it behind yourself.

Sector 6: Hydroponics
Your people prefered to grow things the old fashioned way, but in truth the majority of your fruit and vegetables came from this sector when the machines still worked. You can walk spinward or antispinward.

There is a secured hatch in the ground.

* * *

>look
Sector 6: Hydroponics
Your people prefered to grow things the old fashioned way, but in truth the majority of your fruit and vegetables came from this sector when the machines still worked. You can walk spinward or antispinward.

There is a secured hatch in the ground.

>sw
You walk a little ways to the next sector.

Sector 1: Crops
You still maintain the crops here. There is a small graveyard and the barn remains from when this was the livestock sector. A pylon stretches up from the ground to the hub of the station. You can walk spinward or antispinward.

There is a secured hatch in the ground.

>x crops
You are proud of the grain and legumes.

>x grain
You are proud of the grain and legumes.

>eat grain
You're not hungry.

>sw
You walk a little ways to the next sector.

Sector 2: Aquaculture
A deep pond serves as part of the water filtration system and for raising fish. You can walk spinward or antispinward.

>sw
You walk a little ways to the next sector.

Sector 3: Forest
Trees, a house, and a church. A red pylon stretches up from the ground to the hub of the station. You can walk spinward or antispinward.

You have walked the entire ring. Everything is as expected, much is not working. Now, it's time to leave. The pods are below Sector 1.

* * *

>out
Sector 5: Forest
The school house is nestled among the trees. A pylon stretches up from the same grove to the hub of the station. You can walk spinward or antispinward.

>sw
You walk a little ways to the next sector.

Sector 6: Hydroponics
Your people prefered to grow things the old fashioned way, but in truth the majority of your fruit and vegetables came from this sector when the machines still worked. You can walk spinward or antispinward.

There is a secured hatch in the ground.

>look
Sector 6: Hydroponics
Your people prefered to grow things the old fashioned way, but in truth the majority of your fruit and vegetables came from this sector when the machines still worked. You can walk spinward or antispinward.

There is a secured hatch in the ground.

>out
But you aren't in anything at the moment.

>i
You are carrying:
  a scanner
  a green jumpsuit (being worn)

* * *

>x scanner
The handheld voice-activated scanner you use when working on the station's machines.

[You can ask the scanner for a list of commands by typing "scanner, help" and give it voice commands by typing phrases such as "scanner, scan SOMETHING" or "scanner, open SOMETHING" where SOMETHING is a visible object.]

>asw
You walk a little ways to the next sector.

Sector 5: Forest
The school house is nestled among the trees. A pylon stretches up from the same grove to the hub of the station. You can walk spinward or antispinward.

* * *

>asw
You walk a little ways to the next sector.

Sector 3: Forest
Trees, a house, and a church. A red pylon stretches up from the ground to the hub of the station. You can walk spinward or antispinward.

>asw
You walk a little ways to the next sector.

Sector 2: Aquaculture
A deep pond serves as part of the water filtration system and for raising fish. You can walk spinward or antispinward.

>asw
You walk a little ways to the next sector.

Sector 1: Crops
You still maintain the crops here. There is a small graveyard and the barn remains from when this was the livestock sector. A pylon stretches up from the ground to the hub of the station. You can walk spinward or antispinward.

There is a secured hatch in the ground.

>d
(first opening the floor hatch)
You scramble down through the hatch and close it behind yourself.

Pod Control
This room serves as an airlock for the pod bay, and holds an old space suit and various machinery such as the atmosphere pump.

There is a secured hatch in the ceiling.

Beside the secured port hatch, a status display shows an error message.

>u
(first opening the ceiling hatch)
You pull yourself up through the hatch and close it behind yourself.

Sector 1: Crops
You still maintain the crops here. There is a small graveyard and the barn remains from when this was the livestock sector. A pylon stretches up from the ground to the hub of the station. You can walk spinward or antispinward.

There is a secured hatch in the ground.

>asw
You walk a little ways to the next sector.

Sector 6: Hydroponics
Your people prefered to grow things the old fashioned way, but in truth the majority of your fruit and vegetables came from this sector when the machines still worked. You can walk spinward or antispinward.

There is a secured hatch in the ground.

>d
(first opening the floor hatch)
You scramble down through the hatch and close it behind yourself.

Supply Vault
This room is dim, quiet, and stuffy. There is still a crate of machine parts left.

There is a secured hatch in the ceiling.

You can also see some pair of gravity boots here.

* * *

>u
An alarm sounds, and a synthesized voice says "Laser scan detects unauthorized materiel removal." The hatch seems to be locked.

>look
Supply Vault
This room is dim, quiet, and stuffy. There is still a crate of machine parts left.

There is a secured hatch in the ceiling.

>u
An alarm sounds, and a synthesized voice says "Laser scan detects unauthorized materiel removal." The hatch seems to be locked.

>out
But you aren't in anything at the moment.

>look
Supply Vault
This room is dim, quiet, and stuffy. There is still a crate of machine parts left.

There is a secured hatch in the ceiling.

>restart
Are you sure you want to restart?

>yes
You awake. You are lonely, so lonely. It was a thousand days ago today. All alone these thousand days. Your parents were the last. No, your father was the last. He held on for nearly a hundred days longer. No, you are the last. Alone. Adrift.

But maybe it isn't hopeless. There must still be other people in other worlds, and you think you know how to get there.

Today is the day.

Green
A Space Story by Thomas Insel
Release 1 / Serial number 181123 / Inform 7 build 6M62 (I6/v6.33 lib 6/12N) SD
Type "about" for credits and more information.

Home
The room where you've slept your entire life. You can go out towards the crops.

There is a secured hatch in the floor.

>analyze me
examining yourself:
As virtuous as ever.

looking under yourself:
You find nothing of interest.

searching yourself:
You find nothing of interest.

listening to yourself:
You hear nothing unexpected.

smelling yourself:
You smell nothing unexpected.

attacking yourself:
Violence isn't the answer to this one.

buying yourself:
Nothing is on sale.

climbing yourself:
Little is to be achieved by that.

pulling yourself:
You might not like that.

pushing yourself:
You might not like that.

turning yourself:
You might not like that.

pushing yourself to down:
You cannot be pushed from place to place.

opening yourself:
You aren't something you can open.

entering yourself:
You're not something you can enter.

getting off yourself:
But you aren't on yourself at the moment.

closing yourself:
You aren't something you can close.

taking yourself:
You are always self-possessed.

switching on yourself:
You aren't something you can switch.

switching off yourself:
You aren't something you can switch.

wearing yourself:
(first taking yourself)
You are always self-possessed.

taking off yourself:
You aren't wearing yourself.

throwing the scanner at yourself:
You lack the nerve when it comes to the crucial moment.

showing the scanner to yourself:
The handheld voice-activated scanner you use when working on the station's machines.

[You can ask the scanner for a list of commands by typing "scanner, help" and give it voice commands by typing phrases such as "scanner, scan SOMETHING" or "scanner, open SOMETHING" where SOMETHING is a visible object.]

giving the scanner to yourself:
You can't give the scanner to yourself.

waking yourself:
That seems unnecessary.

kissing yourself:
You don't get much from that.

touching yourself:
You achieve nothing by this.

rubbing yourself:
You rub yourself.

waving yourself:
But you aren't holding you.

squeezing yourself:
You might not like that.

burning yourself:
This dangerous act would achieve little.

cutting yourself:
Cutting you up would achieve little.

tying yourself to the floor hatch:
You would achieve nothing by this.

swinging yourself:
There's nothing sensible to swing here.

tasting yourself:
You taste nothing unexpected.

drinking yourself:
There's nothing suitable to drink here.

eating yourself:
You're plainly inedible.

dropping yourself:
You lack the dexterity.

>i
You are carrying:
  a scanner
  a green jumpsuit (being worn)

>analyze scanner
examining the scanner:
The handheld voice-activated scanner you use when working on the station's machines.

looking under the scanner:
You find nothing of interest.

searching the scanner:
You find nothing of interest.

listening to the scanner:
You hear nothing unexpected.

smelling the scanner:
You smell nothing unexpected.

attacking the scanner:
Violence isn't the answer to this one.

buying the scanner:
Nothing is on sale.

climbing the scanner:
Little is to be achieved by that.

pulling the scanner:
Nothing obvious happens.

pushing the scanner:
Nothing obvious happens.

turning the scanner:
Nothing obvious happens.

pushing the scanner to down:
The scanner cannot be pushed from place to place.

opening the scanner:
It isn't something you can open.

entering the scanner:
That's not something you can enter.

getting off the scanner:
But you aren't on the scanner at the moment.

closing the scanner:
It isn't something you can close.

taking the scanner:
You already have that.

switching on the scanner:
It isn't something you can switch.

switching off the scanner:
It isn't something you can switch.

wearing the scanner:
You can't wear that!

taking off the scanner:
You aren't wearing the scanner.

(no other people in the location; can't test throwing at.)

(no other people in the location; can't test showing to.)

(no other people in the location; can't test giving to.)

touching the scanner:
You feel nothing unexpected.

rubbing the scanner:
You rub the scanner.

waving the scanner:
You wave the scanner.

squeezing the scanner:
You achieve nothing by this.

burning the scanner:
This dangerous act would achieve little.

cutting the scanner:
Cutting it up would achieve little.

tying the scanner to yourself:
You would achieve nothing by this.

swinging the scanner:
There's nothing sensible to swing here.

tasting the scanner:
You taste nothing unexpected.

drinking the scanner:
There's nothing suitable to drink here.

eating the scanner:
That's plainly inedible.

dropping the scanner:
Dropped.

>out
Sector 4: Crops
Your home is here among the crops. You can walk spinward or antispinward.

>analyze home
examining your home:
You were told it was built to look like a log cabin on Old Earth.

looking under your home:
You find nothing of interest.

searching your home:
You find nothing of interest.

listening to your home:
You hear nothing unexpected.

smelling your home:
You smell nothing unexpected.

attacking your home:
Violence isn't the answer to this one.

buying your home:
Nothing is on sale.

climbing your home:
Little is to be achieved by that.

pulling your home:
It is fixed in place.

pushing your home:
It is fixed in place.

turning your home:
It is fixed in place.

pushing your home to inside:
your home cannot be pushed from place to place.

opening your home:
It isn't something you can open.

entering your home:
Home
The room where you've slept your entire life. You can go out towards the crops.

There is a secured hatch in the floor.

You can also see a scanner here.

getting off your home:
You can't reach into Sector 4: Crops.

closing your home:
You can't reach into Sector 4: Crops.

taking your home:
You can't reach into Sector 4: Crops.

switching on your home:
You can't reach into Sector 4: Crops.

switching off your home:
You can't reach into Sector 4: Crops.

wearing your home:
You can't reach into Sector 4: Crops.

taking off your home:
You can't reach into Sector 4: Crops.

touching your home:
You can't reach into Sector 4: Crops.

rubbing your home:
You can't reach into Sector 4: Crops.

waving your home:
You can't reach into Sector 4: Crops.

squeezing your home:
You can't reach into Sector 4: Crops.

burning your home:
You can't reach into Sector 4: Crops.

cutting your home:
You can't reach into Sector 4: Crops.

tying your home to yourself:
You can't reach into Sector 4: Crops.

swinging your home:
You can't reach into Sector 4: Crops.

tasting your home:
You can't reach into Sector 4: Crops.

drinking your home:
You can't reach into Sector 4: Crops.

eating your home:
You can't reach into Sector 4: Crops.

dropping your home:
You can't reach into Sector 4: Crops.

* * *

>play me
You don't know how to play you.

>gonear trees
Sector 3: Forest
Trees, a house, and a church. A red pylon stretches up from the ground to the hub of the station. You can walk spinward or antispinward.

>play trees
You don't know how to play those.

>x trees
The community grew trees for tradition, or maybe they help with air processing.

>pronouns
At the moment, "it" means the floor hatch, "him" is unset, "her" is unset, and "them" means the some trees.

>play those
You can't see any such thing.

>play that
You can't see any such thing.

>play trees
You don't know how to play those.

>out
But you aren't in anything at the moment.

>look
Sector 3: Forest
Trees, a house, and a church. A red pylon stretches up from the ground to the hub of the station. You can walk spinward or antispinward.

>play forest
You don't know how to play those.

>play hub
You are too far away to do that.

>scan hub
No modular technology detected.

* * *

>play me
You don't know how to play you.

>play
What do you want to play?

>me
You don't know how to play that.

>analyze me
examining yourself:
As virtuous as ever.

looking under yourself:
You find nothing of interest.

searching yourself:
You find nothing of interest.

listening to yourself:
You hear nothing unexpected.

smelling yourself:
You smell nothing unexpected.

attacking yourself:
Imperfect vessel that you are, that is not the answer.

buying yourself:
Nothing is on sale.

climbing yourself:
Little is to be achieved by that.

pulling yourself:
You might not like that.

pushing yourself:
You might not like that.

turning yourself:
You might not like that.

pushing yourself to outside:
You cannot be pushed from place to place.

opening yourself:
You aren't something you can open.

entering yourself:
You're not something you can enter.

getting off yourself:
But you aren't on yourself at the moment.

closing yourself:
You aren't something you can close.

taking yourself:
You are always self-possessed.

switching on yourself:
You aren't something you can switch.

switching off yourself:
You aren't something you can switch.

wearing yourself:
(first taking yourself)
You are always self-possessed.

taking off yourself:
You aren't wearing yourself.

throwing the scanner at yourself:
You lack the nerve when it comes to the crucial moment.

showing the scanner to yourself:
The handheld voice-activated scanner you use when working on the station's machines.

[You can ask the scanner for a list of commands by typing "scanner, help" and give it voice commands by typing phrases such as "scanner, scan SOMETHING" or "scanner, open SOMETHING" where SOMETHING is a visible object.]

giving the scanner to yourself:
You can't give the scanner to yourself.

waking yourself:
That seems unnecessary.

kissing yourself:
You don't get much from that.

touching yourself:
You achieve nothing by this.

rubbing yourself:
You rub yourself.

waving yourself:
But you aren't holding you.

squeezing yourself:
You might not like that.

burning yourself:
There is no open flame on the station.

cutting yourself:
Imperfect vessel that you are, that is not the answer.

tying yourself to the floor hatch:
You would achieve nothing by this.

swinging yourself:
There's nothing sensible to swing here.

tasting yourself:
You taste nothing unexpected.

drinking yourself:
There's nothing suitable to drink here.

eating yourself:
You're plainly inedible.

dropping yourself:
You lack the dexterity.

>play e
You must name something more substantial.

>play me
You don't know how to play that.

>gonear trees
Sector 3: Forest
Trees, a house, and a church. A red pylon stretches up from the ground to the hub of the station. You can walk spinward or antispinward.

>play me
You don't know how to play that.

>play trees
You don't know how to play that.

>x trees
The community grew trees for tradition, or maybe they help with air processing.

>showme trees
some trees - forest
location: in Sector 3: Forest
plural-named, improper-named; unlit, inedible, fixed in place, scenery
list grouping key: none
printed name: "some trees"
printed plural name: "forests"
indefinite article: none
description: "The community grew trees for tradition, or maybe they help with air processing."
initial appearance: none

>play trees
You don't know how to play that.

* * *

>testme
That's not a verb I recognize.

>analyze home
You can't see any such thing.

>x room
You can't see any such thing.

>x home
You can't see any such thing.

>analzye
That's not a verb I recognize.

>analyze
What do you want to analyze?

>nothing
You can't see any such thing.

>analyze nothing
You can't see any such thing.

>about
About Founder's Mercy
Founder's Mercy is my second released Inform project, conceived and implemented in November of 2018. It should be impossible to put this game into an unwinnable state.

The cover art is adapted from Figure 1.1 from NASA SP-413, Space Settlements: A Design Study, edited by Richard D. Johnson and Charles Holbrow, and available from The Internet Archive at https://archive.org/details/SpaceSettlementsADesignStudy1977 .

Please send your feedback, bug reports, and requests for help to tinsel@tinsel.org. You can always find the current version of this game at http://tinsel.org/IF/ .

This work is Copyright © 2018 Thomas Insel but may be freely shared according to the terms of the Creative Commons Attribution 4.0 International license (https://creativecommons.org/licenses/by/4.0/).

* * *

>turn scanner on
The scanner is always on and listening.

[You can ask the scanner for a list of commands by typing "scanner, help" and give it voice commands by typing phrases such as "scanner, scan SOMETHING" or "scanner, open SOMETHING" where SOMETHING is a visible object.]

>turn scanner on
The scanner is always on and listening.

>turn scanner on
The scanner is always on and listening.

>turn scanner off
The scanner is always on and listening.

>anayze scanner
That's not a verb I recognize.

>analyze scanner
examining the scanner:
The handheld voice-activated scanner you use when working on the station's machines.

[You can ask the scanner for a list of commands by typing "scanner, help" and give it voice commands by typing phrases such as "scanner, scan SOMETHING" or "scanner, open SOMETHING" where SOMETHING is a visible object.]

looking under the scanner:
You find nothing of interest.

searching the scanner:
You find nothing of interest.

listening to the scanner:
You hear nothing unexpected.

smelling the scanner:
You smell nothing unexpected.

attacking the scanner:
The Founder said that violence is never the answer.

buying the scanner:
Nothing is on sale.

climbing the scanner:
Little is to be achieved by that.

pulling the scanner:
Nothing obvious happens.

pushing the scanner:
Nothing obvious happens.

turning the scanner:
Nothing obvious happens.

pushing the scanner to down:
The scanner cannot be pushed from place to place.

opening the scanner:
It isn't something you can open.

entering the scanner:
That's not something you can enter.

getting off the scanner:
But you aren't on the scanner at the moment.

closing the scanner:
It isn't something you can close.

taking the scanner:
You already have that.

switching on the scanner:
The scanner is always on and listening.

switching off the scanner:
The scanner is always on and listening.

wearing the scanner:
You can't wear that!

taking off the scanner:
You aren't wearing the scanner.

(no other people in the location; can't test throwing at.)

(no other people in the location; can't test showing to.)

(no other people in the location; can't test giving to.)

touching the scanner:
You feel nothing unexpected.

rubbing the scanner:
You rub the scanner.

waving the scanner:
You wave the scanner.

squeezing the scanner:
You achieve nothing by this.

burning the scanner:
There is no open flame on the station.

cutting the scanner:
Cutting it up would achieve little.

tying the scanner to yourself:
You would achieve nothing by this.

swinging the scanner:
There's nothing sensible to swing here.

tasting the scanner:
You taste nothing unexpected.

drinking the scanner:
There's nothing suitable to drink here.

eating the scanner:
That's plainly inedible.

dropping the scanner:
Dropped.

>actions
Actions listing on.

>sell scanner
That's not a verb I recognize.

>buy scanner
That's not a verb I recognize.

>try smelling
[test-verb-trying "smelling"]
smelling the pocket:
[(1) smelling the pocket]
You smell nothing unexpected.
[(1) smelling the pocket - succeeded]

smelling yourself:
[(1) smelling yourself]
You smell nothing unexpected.
[(1) smelling yourself - succeeded]

smelling the scanner:
[(1) smelling the scanner]
You smell nothing unexpected.
[(1) smelling the scanner - succeeded]

smelling the green jumpsuit:
[(1) smelling the green jumpsuit]
You smell nothing unexpected.
[(1) smelling the green jumpsuit - succeeded]

smelling the floor hatch:
[(1) smelling the floor hatch]
You smell nothing unexpected.
[(1) smelling the floor hatch - succeeded]

[test-verb-trying "smelling" - succeeded]

>try buying
[test-verb-trying "buying"]
buying the pocket:
[(1) buying the pocket]
Nothing is on sale.
[(1) buying the pocket - failed the block buying rule]

buying yourself:
[(1) buying yourself]
Nothing is on sale.
[(1) buying yourself - failed the block buying rule]

buying the scanner:
[(1) buying the scanner]
Nothing is on sale.
[(1) buying the scanner - failed the block buying rule]

buying the green jumpsuit:
[(1) buying the green jumpsuit]
Nothing is on sale.
[(1) buying the green jumpsuit - failed the block buying rule]

buying the floor hatch:
[(1) buying the floor hatch]
Nothing is on sale.
[(1) buying the floor hatch - failed the block buying rule]

[test-verb-trying "buying" - succeeded]

>try jkjk
[test-verb-trying "jkjk"]
Unknown verb test.
[test-verb-trying "jkjk" - failed the unknown verb test label rule]

>try buy
[test-verb-trying "buy"]
Unknown verb test.
[test-verb-trying "buy" - failed the unknown verb test label rule]

>out
[exiting]
[(1) going outside]

Sector 4: Crops
Your home is here among the crops. You can walk spinward or antispinward.

[(1) going outside - succeeded]

[exiting - succeeded]

>look
[looking]
Sector 4: Crops
Your home is here among the crops. You can walk spinward or antispinward.

[looking - succeeded]

>actions off
Actions listing off.

>look
Sector 4: Crops
Your home is here among the crops. You can walk spinward or antispinward.

>asw
You walk a little ways to the next sector.

Sector 3: Forest
Trees, a house, and a church. A red pylon stretches up from the ground to the hub of the station. You can walk spinward or antispinward.

>look under trees
You find nothing of interest.

* * *

>x church
You can't see any such thing.

>gonear red
(the red circuit breaker)
Center Platform
It's a mesh platform a little below the hub. You feel much lighter here, and you are very aware of how the station rotates, but everything is okay as long as you don't look down.

You can just reach a red circuit breaker on the hub.

>d
You slide down the pylon.

Sector 3: Forest
Trees, a house, and a church. A red pylon stretches up from the ground to the hub of the station. You can walk spinward or antispinward.

>x church
A small white building with a steeple.

>drop church
church is already here.

* * *

>x organ
You can't see any such thing.

>gonear organ
Supply Vault
This room is dim, quiet, and stuffy. There is still a crate of machine parts left.

There is a secured hatch in the ceiling.

You can also see some pair of gravity boots, the organ, the communications unit, the audio unit, and a grey cable (plugged into the organ and the audio unit) here.

>x organ
You see nothing special about the organ.

The organ has a grey cable plugged into it.

>scanner, open organ
Machine is unitary.

>scan organ
Machine functional. No connection.

>look
Supply Vault
This room is dim, quiet, and stuffy. There is still a crate of machine parts left.

There is a secured hatch in the ceiling.

You can also see some pair of gravity boots, the organ, the communications unit, the audio unit, and a grey cable (plugged into the organ and the audio unit) here.

>scan audio
Machine failed.

* * *

>scanner, open audio
Opening.

The audio unit swings open.

>purloin functional power
There seems to be no such object anywhere in the model world.

>purloin all power
[Purloined.]
[Purloined.]

>x functional power
You can't see any such thing.

>scan power
Component is functional.

>put functional power in audio
You put the functional power module into the audio unit.

>close audio
You close the audio unit and it seals without any trace of a seam.

>look
Supply Vault
This room is dim, quiet, and stuffy. There is still a crate of machine parts left.

There is a secured hatch in the ceiling.

You can also see some pair of gravity boots, the organ, the communications unit, the audio unit, and a grey cable (plugged into the organ and the audio unit) here.

>scan organ
Machine functional. Output connected.

* * *

>scan audio
Machine function. Input connected.

>play organ
You play a hymn.

>disconnect usb cable
That's not a verb I recognize.

>remove usb cable
You can't see any such thing.

>remove
(the green jumpsuit)
Your nudity is pure and innocent, but still a little uncomfortable ... and cold.

>get usb cable
You can't see any such thing.

>x usb cable
You can't see any such thing.

>look
Supply Vault
This room is dim, quiet, and stuffy. There is still a crate of machine parts left.

There is a secured hatch in the ceiling.

You can also see some pair of gravity boots, the organ, the communications unit, the audio unit, and a grey cable (plugged into the organ and the audio unit) here.

>disconnect grey cable
That's not a verb I recognize.

>remove grey cable
The grey cable is plugged into more than one thing.

[Try "unplug grey cable from SOMETHING".]

>x grey
It's a USB 7.2 Type-F cable.

It is plugged into the organ and the audio unit.